Rank,Release_Group,Worldwide,Domestic,Domestic_%,Foreign,Foreign_%,Year,Filename
1,Avengers: Endgame,2797800564,858373000,0.306802783245132,1939427564,0.693197216754868,2019,2019.csv
2,Avatar,2744336793,749766139,0.27320485623792023,1994570654,0.7267951437620798,2009,2009.csv
3,Star Wars: Episode VII - The Force Awakens,2068223624,936662225,0.4528824707980417,1131561399,0.5471175292019583,2015,2015.csv
4,Avengers: Infinity War,2048359754,678815482,0.3313946589091205,1369544272,0.6686053410908794,2018,2018.csv
5,Jurassic World,1670400637,652270625,0.39048753368022093,1018130012,0.6095124663197791,2015,2015.csv
6,The Lion King,1656943394,543638043,0.32809693135479556,1113305351,0.6719030686452044,2019,2019.csv
7,The Avengers,1518812988,623357910,0.41042440045291473,895455078,0.5895755995470853,2012,2012.csv
8,Furious 7,1515047671,353007020,0.23300060239490641,1162040651,0.7669993976050936,2015,2015.csv
9,Frozen II,1450026933,477373578,0.329217042205105,972653355,0.6707829577948949,2019,2019.csv
10,Avengers: Age of Ultron,1402805868,459005868,0.3272055517235689,943800000,0.6727944482764311,2015,2015.csv
11,Black Panther,1346913161,700059566,0.5197510769589992,646853595,0.4802489230410007,2018,2018.csv
12,Harry Potter and the Deathly Hallows: Part 2,1341511219,381011219,0.2840164238686102,960500000,0.7159835761313897,2011,2011.csv
13,Star Wars: Episode VIII - The Last Jedi,1332539889,620181382,0.465412995978239,712358507,0.5345870040217611,2017,2017.csv
14,Jurassic World: Fallen Kingdom,1308467944,417719760,0.3192434036427567,890748184,0.6807565963572433,2018,2018.csv
15,Frozen,1280802282,400738009,0.31288046143565507,880064273,0.6871195385643449,2013,2013.csv
16,Beauty and the Beast,1263521126,504014165,0.3988965080430321,759506961,0.6011034919569679,2017,2017.csv
17,Incredibles 2,1242805359,608581744,0.48968387494698595,634223615,0.510316125053014,2018,2018.csv
18,The Fate of the Furious,1236005118,226008385,0.1828539232634472,1009996733,0.8171460767365528,2017,2017.csv
19,Iron Man 3,1214811252,409013994,0.33668933616363966,805797258,0.6633106638363603,2013,2013.csv
20,Minions,1159398397,336045770,0.28984494964762314,823352627,0.7101550503523768,2015,2015.csv
21,Captain America: Civil War,1153296293,408084349,0.35384172434862754,745211944,0.6461582756513724,2016,2016.csv
22,Aquaman,1148461807,335061807,0.2917483236776023,813400000,0.7082516763223977,2018,2018.csv
23,The Lord of the Rings: The Return of the King,1140444782,377027325,0.3305967381768423,763417457,0.6694032618231577,2003,2003.csv
24,Spider-Man: Far from Home,1131927996,390532085,0.345014953583673,741395911,0.654985046416327,2019,2019.csv
25,Captain Marvel,1128274794,426829839,0.3783030882811692,701444955,0.6216969117188308,2019,2019.csv
26,Transformers: Dark of the Moon,1123794079,352390543,0.3135721655639725,771403536,0.6864278344360275,2011,2011.csv
27,Skyfall,1108561013,304360277,0.2745543758356943,804200736,0.7254456241643057,2012,2012.csv
28,Transformers: Age of Extinction,1104054072,245439076,0.22230711540729683,858614996,0.7776928845927031,2014,2014.csv
29,The Dark Knight Rises,1081041287,448139099,0.4145439257399981,632902188,0.5854560742600019,2012,2012.csv
30,Joker,1074251311,335451311,0.3122652097931673,738800000,0.6877347902068327,2019,2019.csv
31,Star Wars: Episode IX - The Rise of Skywalker,1074144248,515202542,0.4796399952420543,558941706,0.5203600047579457,2019,2019.csv
32,Toy Story 4,1073394593,434038008,0.4043601587249657,639356585,0.5956398412750342,2019,2019.csv
33,Toy Story 3,1066969703,415004880,0.3889565737744289,651964823,0.6110434262255711,2010,2010.csv
34,Pirates of the Caribbean: Dead Man's Chest,1066179725,423315812,0.3970398255322291,642863913,0.602960174467771,2006,2006.csv
35,Rogue One: A Star Wars Story,1056057273,532177324,0.5039284682810948,523879949,0.49607153171890517,2016,2016.csv
36,Aladdin,1050693953,355559216,0.3384041708670612,695134737,0.6615958291329388,2019,2019.csv
37,Pirates of the Caribbean: On Stranger Tides,1045713802,241071802,0.23053325062644625,804642000,0.7694667493735537,2011,2011.csv
38,Despicable Me 3,1034799409,264624300,0.2557252136969475,770175109,0.7442747863030524,2017,2017.csv
39,Finding Dory,1028570889,486295561,0.47278759898871686,542275328,0.5272124010112832,2016,2016.csv
40,Alice in Wonderland,1025467110,334191110,0.32589159295416115,691276000,0.6741084070458389,2010,2010.csv
41,Zootopia,1023784195,341268248,0.3333400238709487,682515947,0.6666599761290513,2016,2016.csv
42,The Hobbit: An Unexpected Journey,1017003568,303003568,0.29793756633113405,714000000,0.7020624336688659,2012,2012.csv
43,The Dark Knight,1003045358,533345358,0.5317260617839378,469700000,0.4682739382160622,2008,2008.csv
44,Harry Potter and the Deathly Hallows: Part 1,976536918,295983305,0.30309484418283916,680553613,0.6969051558171608,2010,2010.csv
45,Harry Potter and the Sorcerer's Stone,974755371,317575550,0.32580025660612644,657179821,0.6741997433938736,2001,2001.csv
46,Despicable Me 2,970766005,368065385,0.3791494377679614,602700620,0.6208505622320386,2013,2013.csv
47,The Jungle Book,966550600,364001123,0.3765981036067848,602549477,0.6234018963932152,2016,2016.csv
48,Jumanji: Welcome to the Jungle,962077546,404515480,0.42046036900231326,557562066,0.5795396309976868,2017,2017.csv
49,Pirates of the Caribbean: At World's End,960996492,309420425,0.32197872476729084,651576067,0.6780212752327092,2007,2007.csv
50,The Hobbit: The Desolation of Smaug,958366855,258366855,0.2695907664711547,700000000,0.7304092335288452,2013,2013.csv
51,The Hobbit: The Battle of the Five Armies,956019788,255119788,0.26685617934092387,700900000,0.7331438206590761,2014,2014.csv
52,Harry Potter and the Order of the Phoenix,941676843,292004738,0.31009017602018274,649672105,0.6899098239798173,2007,2007.csv
53,The Lord of the Rings: The Two Towers,936689735,339789881,0.36275606351125433,596899854,0.6372439364887457,2002,2002.csv
54,Harry Potter and the Half-Blood Prince,933959197,301959197,0.32331090905248616,632000000,0.6766890909475138,2009,2009.csv
55,Shrek 2,928760770,441226247,0.47506985787093486,487534523,0.5249301421290652,2004,2004.csv
56,Bohemian Rhapsody,903655259,216428042,0.23950288546929155,687227217,0.7604971145307085,2018,2018.csv
57,Harry Potter and the Goblet of Fire,895921036,290013036,0.3237037912345659,605908000,0.6762962087654341,2005,2005.csv
58,Spider-Man 3,894983373,336530303,0.3760184972732449,558453070,0.6239815027267551,2007,2007.csv
59,Ice Age: Dawn of the Dinosaurs,886686817,196573705,0.22169462907442775,690113112,0.7783053709255723,2009,2009.csv
60,The Lord of the Rings: The Fellowship of the Ring,883726270,313364114,0.35459409167501604,570362156,0.6454059083249839,2001,2001.csv
61,Spectre,880674609,200074609,0.22718335121207064,680600000,0.7728166487879293,2015,2015.csv
62,Spider-Man: Homecoming,880166924,334201140,0.37970199843592395,545965784,0.620298001564076,2017,2017.csv
63,Harry Potter and the Chamber of Secrets,878979634,261988482,0.2980597864455185,616991152,0.7019402135544816,2002,2002.csv
64,Ice Age: Continental Drift,877244782,161321843,0.18389604168657225,715922939,0.8161039583134277,2012,2012.csv
65,The Secret Life of Pets,875457937,368384330,0.42079043941548044,507073607,0.5792095605845196,2016,2016.csv
66,Batman v Superman: Dawn of Justice,873634919,330360194,0.3781444477724682,543274725,0.6218555522275317,2016,2016.csv
67,Finding Nemo,871014978,339714978,0.3900219704373442,531300000,0.6099780295626558,2003,2003.csv
68,Wolf Warrior 2,870325439,2721100,0.003126531614572282,867604339,0.9968734683854277,2017,2017.csv
69,Star Wars: Episode III - Revenge of the Sith,868352530,380270577,0.437921885250913,488081953,0.562078114749087,2005,2005.csv
70,The Hunger Games: Catching Fire,865011746,424668047,0.490939052520103,440343699,0.5090609474798969,2013,2013.csv
71,Guardians of the Galaxy Vol. 2,863756051,389813101,0.4512999944240043,473942950,0.5487000055759956,2017,2017.csv
72,Inside Out,857611174,356461711,0.4156449004009829,501149463,0.5843550995990171,2015,2015.csv
73,Venom,856085151,213515506,0.24940919224050412,642569645,0.7505908077594958,2018,2018.csv
74,Thor: Ragnarok,853977126,315058289,0.36893059475225337,538918837,0.6310694052477467,2017,2017.csv
75,Transformers: Revenge of the Fallen,836303693,402111870,0.4808203925986968,434191823,0.5191796074013032,2009,2009.csv
76,The Twilight Saga: Breaking Dawn - Part 2,829746820,292324737,0.35230594436023266,537422083,0.6476940556397673,2012,2012.csv
77,Inception,828322032,292576195,0.35321551727118616,535745837,0.6467844827288138,2010,2010.csv
78,Wonder Woman,821847012,412563408,0.501995385973369,409283604,0.49800461402663104,2017,2017.csv
79,Spider-Man,821708551,403706375,0.4913011730359856,418002176,0.5086988269640144,2002,2002.csv
80,Fantastic Beasts and Where to Find Them,814037575,234037575,0.287502177034027,580000000,0.7124978229659731,2016,2016.csv
81,Shrek the Third,813367380,322719944,0.3967702073323865,490647436,0.6032297926676135,2007,2007.csv
82,Coco,807082196,209726015,0.2598570703695711,597356181,0.7401429296304288,2017,2017.csv
83,Jumanji: The Next Level,796575993,316831246,0.3977413941471872,479744747,0.6022586058528129,2019,2019.csv
84,Harry Potter and the Prisoner of Azkaban,795634069,249541069,0.31363798852107727,546093000,0.6863620114789227,2004,2004.csv
85,Pirates of the Caribbean: Dead Men Tell No Tales,794861794,172558876,0.21709293024593404,622302918,0.782907069754066,2017,2017.csv
86,Mission: Impossible - Fallout,791115104,220159104,0.27828959766643513,570956000,0.7217104023335649,2018,2018.csv
87,Indiana Jones and the Kingdom of the Crystal Skull,790653942,317101119,0.40106183268735285,473552823,0.5989381673126472,2008,2008.csv
88,Spider-Man 2,788976453,373585825,0.47350693874256855,415390628,0.5264930612574314,2004,2004.csv
89,Fast & Furious 6,788679850,238679850,0.30263211365169274,550000000,0.6973678863483073,2013,2013.csv
90,Deadpool,782612155,363070709,0.463921633059737,419541446,0.536078366940263,2016,2016.csv
91,Guardians of the Galaxy,772776600,333176600,0.4311421955581988,439600000,0.5688578044418011,2014,2014.csv
92,2012,769679473,166112167,0.21581992612137652,603567306,0.7841800738786235,2009,2009.csv
93,The Da Vinci Code,760006945,217536138,0.28622914491919543,542470807,0.7137708550808045,2006,2006.csv
94,Fast & Furious Presents: Hobbs & Shaw,759056935,173956935,0.22917508157671992,585100000,0.77082491842328,2019,2019.csv
95,Maleficent,758410378,241410378,0.31831101604466705,517000000,0.681688983955333,2014,2014.csv
96,The Amazing Spider-Man,757930663,262030663,0.34571851462354675,495900000,0.6542814853764533,2012,2012.csv
97,The Hunger Games: Mockingjay - Part 1,755356711,337135885,0.44632672231596815,418220826,0.5536732776840319,2014,2014.csv
98,Shrek Forever After,752600867,238736787,0.31721566831519477,513864080,0.6827843316848052,2010,2010.csv
99,Madagascar 3: Europe's Most Wanted,746921274,216391482,0.2897112313338661,530529792,0.7102887686661339,2012,2012.csv
100,Suicide Squad,746846894,325100054,0.43529678788488074,421746840,0.5647032121151193,2016,2016.csv
101,X-Men: Days of Future Past,746045700,233921534,0.3135485319465014,512124166,0.6864514680534985,2014,2014.csv
102,"The Chronicles of Narnia: The Lion, the Witch and the Wardrobe",745013115,291710957,0.39155143866158654,453302158,0.6084485613384135,2005,2005.csv
103,Monsters University,743559607,268492764,0.3610911102114238,475066843,0.6389088897885762,2013,2013.csv
104,The Matrix Reloaded,739412035,281576461,0.3808113036731949,457835574,0.6191886963268052,2003,2003.csv
105,Up,735099082,293004164,0.3985913888000203,442094918,0.6014086111999797,2009,2009.csv
106,Deadpool 2,734546611,318491426,0.43358912998919275,416055185,0.5664108700108073,2018,2018.csv
107,Ne Zha,726063471,3695533,0.005089820859476899,722367938,0.9949101791405232,2019,2019.csv
108,Gravity,723192705,274092705,0.37900369169238235,449100000,0.6209963083076177,2013,2013.csv
109,Captain America: The Winter Soldier,714421503,259766572,0.3636040781376089,454654931,0.6363959218623911,2014,2014.csv
110,The Twilight Saga: Breaking Dawn - Part 1,712205856,281287133,0.394952008089077,430918723,0.6050479919109231,2011,2011.csv
111,Dawn of the Planet of the Apes,710644566,208545589,0.29345976734028806,502098977,0.7065402326597119,2014,2014.csv
112,The Twilight Saga: New Moon,709827462,296623634,0.4178813160655089,413203828,0.5821186839344911,2009,2009.csv
113,Transformers,709709780,319246193,0.44982639664342794,390463587,0.5501736033565721,2007,2007.csv
114,The Amazing Spider-Man 2,708982323,202853933,0.28611987410580336,506128390,0.7138801258941967,2014,2014.csv
115,It,700381748,327481748,0.4675760739555994,372900000,0.5324239260444006,2017,2017.csv
116,The Wandering Earth,699856699,5971413,0.008532336703402763,693885286,0.9914676632965972,2019,2019.csv
117,The Twilight Saga: Eclipse,698491347,300531751,0.4302583736946422,397959596,0.5697416263053579,2010,2010.csv
118,Mission: Impossible - Ghost Protocol,694713380,209397903,0.3014162516921727,485315477,0.6985837483078273,2011,2011.csv
119,The Hunger Games,694394724,408010692,0.5875774655223331,286384032,0.4124225344776669,2012,2012.csv
120,Mission: Impossible - Rogue Nation,682714267,195042377,0.2856866868434727,487671890,0.7143133131565274,2015,2015.csv
121,Doctor Strange,677718395,232641920,0.3432722524817996,445076475,0.6567277475182004,2016,2016.csv
122,Interstellar,677463813,188020017,0.2775351441538915,489443796,0.7224648558461085,2014,2014.csv
123,Man of Steel,668045518,291045518,0.4356671965577052,377000000,0.5643328034422948,2013,2013.csv
124,Kung Fu Panda 2,665692281,165249063,0.24823641150196843,500443218,0.7517635884980316,2011,2011.csv
125,Ice Age: The Meltdown,660998756,195330621,0.29550830349822926,465668135,0.7044916965017707,2006,2006.csv
126,The Hunger Games: Mockingjay - Part 2,658344137,281723902,0.4279280184430351,376620235,0.5720719815569649,2015,2015.csv
127,Justice League,657924295,229024295,0.3481012887660578,428900000,0.6518987112339422,2017,2017.csv
128,Big Hero 6,657827828,222527828,0.33827670178769026,435300000,0.6617232982123098,2014,2014.csv
129,Fantastic Beasts: The Crimes of Grindelwald,654855901,159555901,0.24365039813545178,495300000,0.7563496018645482,2018,2018.csv
130,Pirates of the Caribbean: The Curse of the Black Pearl,654264015,305413918,0.4668053125312111,348850097,0.5331946874687888,2003,2003.csv
131,Star Wars: Episode II - Attack of the Clones,645256452,302191252,0.4683273620331037,343065200,0.5316726379668963,2002,2002.csv
132,Thor: The Dark World,644783140,206362140,0.32004890822672566,438421000,0.6799510917732744,2013,2013.csv
133,Moana,643331111,248757044,0.38667031602642327,394574067,0.6133296839735767,2016,2016.csv
134,Sing,634151679,270395425,0.42638919670825315,363756254,0.5736108032917469,2016,2016.csv
135,Kung Fu Panda,631744560,215434591,0.3410153480387706,416309969,0.6589846519612294,2008,2008.csv
136,The Incredibles,631442092,261441092,0.4140381126192012,370001000,0.5859618873807988,2004,2004.csv
137,The Martian,630161890,228433663,0.36249996488997455,401728227,0.6375000351100255,2015,2015.csv
138,Hancock,629443428,227946274,0.3621394137425167,401497154,0.6378605862574833,2008,2008.csv
139,Fast Five,626137675,209837675,0.33513024911014977,416300000,0.6648697508898502,2011,2011.csv
140,Men in Black 3,624026776,179020854,0.2868800841328001,445005922,0.7131199158671999,2012,2012.csv
141,Iron Man 2,623933331,312433331,0.5007479412892594,311500000,0.4992520587107407,2010,2010.csv
142,Ratatouille,623726085,206445654,0.3309876866862158,417280431,0.6690123133137842,2007,2007.csv
143,Ant-Man and the Wasp,622674139,216648740,0.3479327732285988,406025399,0.6520672267714012,2018,2018.csv
144,How to Train Your Dragon 2,621537519,177002924,0.2847823640393944,444534595,0.7152176359606056,2014,2014.csv
145,Logan,619021436,226277068,0.36553995522701094,392744368,0.6344600447729891,2017,2017.csv
146,The Passion of the Christ,611486736,370274604,0.6055317019991747,241212132,0.39446829800082533,2004,2004.csv
147,Mamma Mia!,609841637,144130063,0.23634014841790804,465711574,0.7636598515820919,2008,2008.csv
148,Life of Pi,609016565,124987023,0.20522762463776334,484029542,0.7947723753622367,2012,2012.csv
149,Casino Royale,606099584,167445960,0.27626806620609723,438653624,0.7237319337939028,2006,2006.csv
150,Transformers: The Last Knight,605425157,130168683,0.21500375644284633,475256474,0.7849962435571537,2017,2017.csv
151,Madagascar: Escape 2 Africa,603900354,180010950,0.298080550553875,423889404,0.701919449446125,2008,2008.csv
152,War of the Worlds,603873119,234280354,0.38796287933459084,369592765,0.6120371206654092,2005,2005.csv
153,Tangled,592461732,200821936,0.33896186901738995,391639796,0.66103813098261,2010,2010.csv
154,Quantum of Solace,589580482,168368427,0.2855732714028345,421212055,0.7144267285971655,2008,2008.csv
155,The Croods,587204668,187168425,0.3187447838885368,400036243,0.6812552161114632,2013,2013.csv
156,The Hangover Part II,586764305,254464305,0.43367379854505633,332300000,0.5663262014549436,2011,2011.csv
157,I Am Legend,585410052,256393010,0.4379716561477834,329017042,0.5620283438522166,2007,2007.csv
158,Iron Man,585366247,318604126,0.5442816828487209,266762121,0.45571831715127914,2008,2008.csv
159,Ready Player One,582890172,137690172,0.23621975221774713,445200000,0.7637802477822528,2018,2018.csv
160,Operation Red Sea,579330426,1543547,0.0026643637736368433,577786879,0.9973356362263631,2018,2018.csv
161,Night at the Museum,574480841,250863268,0.43667821465259277,323617573,0.5633217853474073,2006,2006.csv
162,Fifty Shades of Grey,569651467,166167230,0.2916998193212763,403484237,0.7083001806787237,2015,2015.csv
163,Kong: Skull Island,566652812,168052812,0.29657103686975084,398600000,0.7034289631302492,2017,2017.csv
164,The Smurfs,563749323,142614158,0.2529744199799243,421135165,0.7470255800200757,2011,2011.csv
165,King Kong,562363449,218080025,0.38779196156469975,344283424,0.6122080384353003,2005,2005.csv
166,Cars 2,559852396,191452396,0.3419694143811434,368400000,0.6580305856188566,2011,2011.csv
167,Puss in Boots,554987477,149260504,0.26894391348581725,405726973,0.7310560865141827,2011,2011.csv
168,The Mermaid,553810228,3232685,0.005837170995693492,550577543,0.9941628290043065,2016,2016.csv
169,The Day After Tomorrow,552639571,186740799,0.3379070352528194,365898772,0.6620929647471806,2004,2004.csv
170,Ted,549368315,218815487,0.398303799155217,330552828,0.6016962008447829,2012,2012.csv
171,American Sniper,547426372,350126372,0.639586234621521,197300000,0.3604137653784791,2014,2014.csv
172,Mission: Impossible II,546388108,215409889,0.3942433699527004,330978219,0.6057566300472996,2000,2000.csv
173,Detective Chinatown 2,544185156,1983984,0.0036457885301083076,542201172,0.9963542114698917,2018,2018.csv
174,X-Men: Apocalypse,543934105,155442489,0.285774485495812,388491616,0.7142255145041879,2016,2016.csv
175,Sherlock Holmes: A Game of Shadows,543848418,186848418,0.3435670893134785,357000000,0.6564329106865214,2011,2011.csv
176,Despicable Me,543113985,251513985,0.4630961307321151,291600000,0.5369038692678849,2010,2010.csv
177,Cinderella,542351353,201151353,0.3708875286976559,341200000,0.6291124713023442,2015,2015.csv
178,Madagascar,542063846,193595521,0.35714523746341126,348468325,0.6428547625365887,2005,2005.csv
179,World War Z,540007876,202359711,0.37473473997997764,337648165,0.6252652600200224,2013,2013.csv
180,Brave,538983207,237283207,0.4402423005360907,301700000,0.5597576994639093,2012,2012.csv
181,The Simpsons Movie,536414270,183135014,0.34140593239624295,353279256,0.658594067603757,2007,2007.csv
182,The Revenant,532950503,183637894,0.34456838480552104,349312609,0.6554316151944789,2015,2015.csv
183,The Meg,530243742,145443742,0.2742960085703378,384800000,0.7257039914296621,2016,2016.csv
184,Ralph Breaks the Internet,529323962,201091711,0.3799029052835511,328232251,0.6200970947164489,2018,2018.csv
185,"Monsters, Inc.",528773250,255873250,0.48389976232723575,272900000,0.5161002376727643,2001,2001.csv
186,Hotel Transylvania 3: Summer Vacation,528583774,167510016,0.31690343941583043,361073758,0.6830965605841696,2018,2018.csv
187,The Boss Baby,527965936,175003033,0.331466522870521,352962903,0.6685334771294791,2017,2017.csv
188,Dunkirk,525245546,188045546,0.3580145465907482,337200000,0.6419854534092517,2017,2017.csv
189,Godzilla,524976069,200676069,0.38225755582013016,324300000,0.6177424441798699,2014,2014.csv
190,Sherlock Holmes,524028679,209028679,0.39888786125005193,315000000,0.6011121387499481,2009,2009.csv
191,Meet the Fockers,522657936,279261160,0.5343096139269183,243396776,0.46569038607308166,2004,2004.csv
192,How to Train Your Dragon: The Hidden World,521799505,160799505,0.3081633912243746,361000000,0.6918366087756255,2019,2019.csv
193,WALL·E,521311860,223808164,0.4293172305728859,297503696,0.5706827694271142,2008,2008.csv
194,Kung Fu Panda 3,521170825,143528619,0.2753964959569638,377642206,0.7246035040430362,2016,2016.csv
195,Ant-Man,519311965,180202163,0.3470017545234106,339109802,0.6529982454765894,2015,2015.csv
196,The Grinch,511595957,270620950,0.5289739809261237,240975007,0.4710260190738763,2018,2018.csv
197,Rio 2,498781117,131538435,0.2637197570572825,367242682,0.7362802429427175,2014,2014.csv
198,Troy,497409852,133378256,0.268145585504004,364031596,0.731854414495996,2004,2004.csv
199,How to Train Your Dragon,494878759,217581231,0.4396657303289107,277297528,0.5603342696710892,2010,2010.csv
200,Oz The Great and Powerful,493311825,234911825,0.47619337930932426,258400000,0.5238066206906757,2013,2013.csv
201,Clash of the Titans,493214993,163214888,0.33092037005452507,330000105,0.6690796299454749,2010,2010.csv
202,Maleficent: Mistress of Evil,491730089,113929605,0.23169134358178353,377800484,0.7683086564182164,2019,2019.csv
203,War for the Planet of the Apes,490719763,146880162,0.2993157665019495,343839601,0.7006842334980505,2017,2017.csv
204,Shrek,487769799,267665011,0.5487527344840799,220104788,0.45124726551592015,2001,2001.csv
205,Mr. & Mrs. Smith,487287646,186336279,0.38239483502112015,300951367,0.6176051649788799,2005,2005.csv
206,Angels & Demons,485930816,133375846,0.2744749697043293,352554970,0.7255250302956707,2009,2009.csv
207,Teenage Mutant Ninja Turtles,485004754,191204754,0.39423274189184543,293800000,0.6057672581081546,2014,2014.csv
208,Bruce Almighty,484592874,242829261,0.5010995291688916,241763613,0.49890047083110844,2003,2003.csv
209,Rio,483866518,143619809,0.29681700150205476,340246709,0.7031829984979453,2011,2011.csv
210,Rise of the Planet of the Apes,481800873,176760185,0.3668739408863628,305040688,0.6331260591136372,2011,2011.csv
211,Charlie and the Chocolate Factory,474968763,206459076,0.43467927173981336,268509687,0.5653207282601866,2005,2005.csv
212,Hotel Transylvania 2,474800000,169700110,0.3574138795282224,305099890,0.6425861204717775,2015,2015.csv
213,San Andreas,473990832,155190832,0.32741315131597315,318800000,0.6725868486840269,2015,2015.csv
214,It Chapter Two,473093228,211593228,0.44725482310222375,261500000,0.5527451768977762,2019,2019.csv
215,Wreck-It Ralph,471222889,189422889,0.40198151113156133,281800000,0.5980184888684387,2012,2012.csv
216,The Hangover,468812793,277322503,0.5915420977003928,191490290,0.40845790229960727,2009,2009.csv
217,The Lego Movie,468060692,257760692,0.5506992926464331,210300000,0.44930070735356686,2014,2014.csv
218,Bumblebee,467989645,127195589,0.2717914602576303,340794056,0.7282085397423698,2018,2018.csv
219,Star Trek Into Darkness,467365246,228778661,0.4895072172311246,238586585,0.5104927827688753,2013,2013.csv
220,Cars,461983149,244082982,0.5283374134496841,217900167,0.47166258655031595,2006,2006.csv
221,Gladiator,460583960,187705427,0.4075379155626696,272878533,0.5924620844373304,2000,2000.csv
222,X-Men: The Last Stand,460435291,234362462,0.5090019522417538,226072829,0.49099804775824624,2006,2006.csv
223,National Treasure: Book of Secrets,459242249,219964115,0.47897186175481865,239278134,0.5210281382451813,2007,2007.csv
224,Lucy,458863600,126663600,0.27603758502526676,332200000,0.7239624149747332,2014,2014.csv
225,300,456068181,210614939,0.4618058171438187,245453242,0.5381941828561814,2007,2007.csv
226,The Last Samurai,454627263,111127263,0.24443598535356645,343500000,0.7555640146464335,2003,2003.csv
227,Ocean's Eleven,450717150,183417150,0.4069451317749946,267300000,0.5930548682250054,2001,2001.csv
228,"My People, My Country",450064993,2356683,0.005236317057878794,447708310,0.9947636829421213,2019,2019.csv
229,Thor,449326618,181030624,0.40289316668081304,268295994,0.597106833319187,2011,2011.csv
230,Pearl Harbor,449220945,198542554,0.44197083018914,250678391,0.55802916981086,2001,2001.csv
231,La La Land,446486224,151101803,0.3384243340058797,295384421,0.6615756659941203,2016,2016.csv
232,The Bourne Ultimatum,444100035,227471070,0.5122068274549899,216628965,0.48779317254501003,2007,2007.csv
233,Alvin and the Chipmunks: The Squeakquel,443140005,219614612,0.4955874205038202,223525393,0.5044125794961798,2009,2009.csv
234,Men in Black II,441818803,190418803,0.43098845433248795,251400000,0.569011545667512,2002,2002.csv
235,Les Misérables,441809770,148809770,0.33681864934765926,293000000,0.6631813506523407,2012,2012.csv
236,Terminator Genisys,440603537,89760956,0.20372273134974855,350842581,0.7962772686502514,2015,2015.csv
237,Warcraft,439048914,47365290,0.10788157877097038,391683624,0.8921184212290296,2016,2016.csv
238,A Star Is Born,436188866,215288866,0.4935679995096436,220900000,0.5064320004903564,2018,2018.csv
239,The Greatest Showman,434993183,174340174,0.4007882900546513,260653009,0.5992117099453488,2017,2017.csv
240,Terminator 3: Rise of the Machines,433371112,150371112,0.34698000821060726,283000000,0.6530199917893927,2003,2003.csv
241,The Mummy Returns,433013274,202019785,0.46654409259518453,230993489,0.5334559074048155,2001,2001.csv
242,Pokémon Detective Pikachu,433005346,144105346,0.3328026947731957,288900000,0.6671973052268043,2019,2019.csv
243,Die Another Day,431971116,160942139,0.37257615854111875,271028977,0.6274238414588812,2002,2002.csv
244,The Secret Life of Pets 2,430051293,158874395,0.36943126921374003,271176898,0.63056873078626,2019,2019.csv
245,Cast Away,429632142,233632142,0.5437957712204875,196000000,0.4562042287795125,2000,2000.csv
246,Rampage,428028233,101028233,0.2360317035441912,327000000,0.7639682964558088,2018,2018.csv
247,The Matrix Revolutions,427343298,139313948,0.32600007687496246,288029350,0.6739999231250375,2003,2003.csv
248,The Intouchables,426588510,10198820,0.023907863810021513,416389690,0.9760921361899785,2011,2011.csv
249,Django Unchained,425368238,162805434,0.38273998727662406,262562804,0.6172600127233759,2012,2012.csv
250,The King's Speech,423999102,135453143,0.3194656365097679,288545959,0.6805343634902321,2010,2010.csv
251,The Chronicles of Narnia: Prince Caspian,419665568,141621490,0.33746273413595845,278044078,0.6625372658640415,2008,2008.csv
252,Bad Boys for Life,419074646,204417855,0.48778387562009656,214656791,0.5122161243799034,2020,2020.csv
253,Sex and the City,418765321,152647258,0.3645174286053166,266118063,0.6354825713946833,2008,2008.csv
254,The Captain,416953262,706572,0.001694607200362903,416246690,0.9983053927996371,2019,2019.csv
255,The Chronicles of Narnia: The Voyage of the Dawn Treader,415686217,104386950,0.25111958427045944,311299267,0.7488804157295406,2010,2010.csv
256,Jason Bourne,415484914,162434410,0.39095140287091146,253050504,0.6090485971290885,2016,2016.csv
257,The Wolverine,414828246,132556852,0.3195463502743253,282271394,0.6804536497256747,2013,2013.csv
258,Kingsman: The Secret Service,414351546,128261724,0.3095480763573644,286089822,0.6904519236426355,2015,2015.csv
259,Night at the Museum: Battle of the Smithsonian,413106170,177243721,0.4290512557582957,235862449,0.5709487442417043,2009,2009.csv
260,Pacific Rim,411002906,101802906,0.24769388370212642,309200000,0.7523061162978736,2013,2013.csv
261,Kingsman: The Golden Circle,410902662,100234838,0.24393815681826855,310667824,0.7560618431817314,2017,2017.csv
262,The Mummy,409231607,80227895,0.196045206742792,329003712,0.803954793257208,2017,2017.csv
263,Ice Age: Collision Course,408579038,64063008,0.15679465180981703,344516030,0.843205348190183,2016,2016.csv
264,Signs,408247917,227966634,0.5584024425040728,180281283,0.44159755749592716,2002,2002.csv
265,X2: X-Men United,407711549,214949694,0.5272102164562427,192761855,0.4727897835437573,2003,2003.csv
266,Twilight,407187715,192769854,0.47341765701354716,214417861,0.5265823429864528,2008,2008.csv
267,Alita: Battle Angel,404852543,85710210,0.21170722892062951,319142333,0.7882927710793705,2019,2019.csv
268,The Mummy: Tomb of the Dragon Emperor,403449830,102491776,0.2540384661954127,300958054,0.7459615338045873,2008,2008.csv
269,Prometheus,403354469,126477084,0.3135631156227502,276877385,0.6864368843772498,2012,2012.csv
270,TRON: Legacy,400062763,172062763,0.4300894232438224,228000000,0.5699105767561776,2010,2010.csv
271,Mission: Impossible III,398479497,134029801,0.33635306711903423,264449696,0.6636469328809658,2006,2006.csv
272,Snow White and the Huntsman,396592829,155332381,0.39166714484391246,241260448,0.6083328551560876,2012,2012.csv
273,Mamma Mia! Here We Go Again,395044706,120634935,0.3053703369967449,274409771,0.6946296630032551,2018,2018.csv
274,Solo: A Star Wars Story,392924807,213767512,0.5440417815106289,179157295,0.4559582184893712,2018,2018.csv
275,The Wolf of Wall Street,392000694,116900694,0.2982155281592435,275100000,0.7017844718407565,2013,2013.csv
276,Superman Returns,391081192,200081192,0.5116103665757468,191000000,0.48838963342425323,2006,2006.csv
277,Independence Day: Resurgence,389681935,103144286,0.26468839516514925,286537649,0.7353116048348508,2016,2016.csv
278,Live Free or Die Hard,388156011,134529403,0.34658590666524547,253626608,0.6534140933347545,2007,2007.csv
279,Monster Hunt,387053506,32766,8.465496240718718e-05,387020740,0.9999153450375928,2015,2015.csv
280,Godzilla: King of the Monsters,386600138,110500138,0.2858253971963145,276100000,0.7141746028036855,2019,2019.csv
281,Home,386041607,177397510,0.45952950869360565,208644097,0.5404704913063944,2015,2015.csv
282,Star Trek,385680446,257730019,0.6682475652395403,127950427,0.3317524347604597,2009,2009.csv
283,Happy Feet,384335608,198000317,0.515175572803028,186335291,0.48482442719697205,2006,2006.csv
284,Cars 3,383930656,152901115,0.3982519046356121,231029541,0.6017480953643879,2017,2017.csv
285,Ice Age,383257136,176387405,0.4602325395449388,206869731,0.5397674604550612,2002,2002.csv
286,Fifty Shades Darker,381545846,114581250,0.3003079477898444,266964596,0.6996920522101556,2017,2017.csv
287,Monsters vs. Aliens,381509870,198351526,0.5199119121085911,183158344,0.48008808789140894,2009,2009.csv
288,Slumdog Millionaire,378410113,141319928,0.37345705927262046,237090185,0.6265429407273796,2008,2008.csv
289,Taken 2,376141306,139854287,0.3718131584304118,236287019,0.6281868415695883,2012,2012.csv
290,G.I. Joe: Retaliation,375740705,122523060,0.3260840743884802,253217645,0.6739159256115198,2013,2013.csv
291,Spider-Man: Into the Spider-Verse,375540831,190241310,0.5065795628491859,185299521,0.49342043715081413,2018,2018.csv
292,1917,375312717,159227644,0.42425326078146186,216085073,0.5757467392185381,2019,2019.csv
293,Mad Max: Fury Road,374736354,153636354,0.4099851865453118,221100000,0.5900148134546882,2015,2015.csv
294,Shark Tale,374583879,160861908,0.42944162047080514,213721971,0.5705583795291949,2004,2004.csv
295,Once Upon a Time... in Hollywood,374343626,142502728,0.38067357930651663,231840898,0.6193264206934834,2019,2019.csv
296,What Women Want,374111707,182811707,0.4886554031307018,191300000,0.5113445968692982,2000,2000.csv
297,The Adventures of Tintin,373993951,77591831,0.20746814431766036,296402120,0.7925318556823396,2011,2011.csv
298,Penguins of Madagascar,373515621,83850911,0.22449104210289508,289664710,0.775508957897105,2014,2014.csv
299,X-Men Origins: Wolverine,373062864,179883157,0.48217920988243956,193179707,0.5178207901175604,2009,2009.csv
300,The Golden Compass,372234864,70107728,0.188342723318899,302127136,0.811657276681101,2007,2007.csv
301,Fifty Shades Freed,371985018,100407760,0.26992420431298125,271577258,0.7300757956870187,2018,2018.csv
302,Batman Begins,371853783,205343774,0.552216444709398,166510009,0.44778355529060193,2005,2005.csv
303,Hitch,371594210,179495555,0.48304185094810814,192098655,0.5169581490518919,2005,2005.csv
304,Terminator Salvation,371353001,125322469,0.33747530964479805,246030532,0.6625246903552019,2009,2009.csv
305,Captain America: The First Avenger,370569774,176654505,0.4767105074252494,193915269,0.5232894925747505,2011,2011.csv
306,Edge of Tomorrow,370541256,100206256,0.2704321162013873,270335000,0.7295678837986127,2014,2014.csv
307,Gone Girl,369330363,167767189,0.4542469447604014,201563174,0.5457530552395986,2014,2014.csv
308,Jurassic Park III,368780809,181171875,0.49127251358679025,187608934,0.5087274864132098,2001,2001.csv
309,My Big Fat Greek Wedding,368744044,241438208,0.6547582582784713,127305836,0.34524174172152866,2002,2002.csv
310,Shazam!,365971656,140371656,0.3835588185550632,225600000,0.6164411814449369,2019,2019.csv
311,The Nun,365550119,117450119,0.32129689718415877,248100000,0.6787031028158412,2018,2018.csv
312,Alvin and the Chipmunks,365352546,217326974,0.5948418216305519,148025572,0.4051581783694481,2007,2007.csv
313,Night at the Museum: Secret of the Tomb,363204635,113746621,0.313175025973994,249458014,0.6868249740260061,2014,2014.csv
314,Ocean's Twelve,362744280,125544280,0.34609582265501193,237200000,0.6539041773449881,2004,2004.csv
315,Planet of the Apes,362211740,180011740,0.4969793082907804,182200000,0.5030206917092196,2001,2001.csv
316,The Hangover Part III,362000072,112200072,0.3099448886297459,249800000,0.6900551113702541,2013,2013.csv
317,Monster Hunt 2,361682618,706153,0.0019524106629862981,360976465,0.9980475893370137,2018,2018.csv
318,Fast & Furious,360364265,155064265,0.43029867292751683,205300000,0.5697013270724832,2009,2009.csv
319,Noah,359200044,101200044,0.28173728174710355,258000000,0.7182627182528964,2014,2014.csv
320,The Karate Kid,359126022,176591618,0.4917260437340294,182534404,0.5082739562659706,2010,2010.csv
321,Hotel Transylvania,358375603,148313048,0.4138480598524448,210062555,0.5861519401475552,2012,2012.csv
322,Minority Report,358372926,132072926,0.3685348875936013,226300000,0.6314651124063987,2002,2002.csv
323,Your Name.,357986087,5017246,0.014015198305737508,352968841,0.9859848016942625,2016,2016.csv
324,The Legend of Tarzan,356700357,126643061,0.3550404660794887,230057296,0.6449595339205113,2016,2016.csv
325,The Great Gatsby,353641895,144840419,0.40956804340164504,208801476,0.5904319565983549,2013,2013.csv
326,Dumbo,353284621,114766307,0.32485508900768145,238518314,0.6751449109923185,2019,2019.csv
327,"I, Robot",353133898,144801023,0.4100456620564928,208332875,0.5899543379435072,2004,2004.csv
328,Murder on the Orient Express,352789811,102826543,0.29146687289106543,249963268,0.7085331271089346,2017,2017.csv
329,X-Men: First Class,352616690,146408305,0.41520526155469273,206208385,0.5847947384453073,2011,2011.csv
330,The Angry Birds Movie,352333929,107509366,0.3051348653964007,244824563,0.6948651346035993,2016,2016.csv
331,Catch Me If You Can,352114312,164615351,0.4675054247723961,187498961,0.5324945752276039,2002,2002.csv
332,Now You See Me,351723989,117723989,0.3347056006464205,234000000,0.6652943993535795,2013,2013.csv
333,Hannibal,351692268,165092268,0.46942251229702897,186600000,0.5305774877029711,2001,2001.csv
334,Peter Rabbit,351266433,115253424,0.3281082767165515,236013009,0.6718917232834485,2018,2018.csv
335,Dinosaur,349822765,137748063,0.39376529140406286,212074702,0.6062347085959372,2000,2000.csv
336,Mary Poppins Returns,349537494,171958438,0.4919599211865952,177579056,0.5080400788134047,2018,2018.csv
337,The Lorax,348840316,214030500,0.6135486358176558,134809816,0.3864513641823441,2012,2012.csv
338,The Maze Runner,348319861,102427862,0.2940626517992323,245891999,0.7059373482007677,2014,2014.csv
339,The Smurfs 2,347545360,71017784,0.2043410506185437,276527576,0.7956589493814563,2013,2013.csv
340,National Treasure,347512318,173008894,0.4978496733459675,174503424,0.5021503266540325,2004,2004.csv
341,Rush Hour 2,347325802,226164286,0.6511588966258257,121161516,0.3488411033741743,2001,2001.csv
342,Trolls,346864462,153707064,0.44313292608223437,193157398,0.5568670739177656,2016,2016.csv
343,xXx: Return of Xander Cage,346118277,44898413,0.12971985585147242,301219864,0.8702801441485276,2017,2017.csv
344,How the Grinch Stole Christmas,345141403,260044825,0.7534443064195344,85096578,0.24655569358046564,2000,2000.csv
345,Titanic 2012 3D Release,343550770,57884114,0.1684878016719334,285666656,0.8315121983280667,2012,2012.csv
346,Star Trek Beyond,343471816,158848340,0.462478528369268,184623476,0.537521471630732,2016,2016.csv
347,Alvin and the Chipmunks: Chipwrecked,342695435,133110742,0.3884228630007867,209584693,0.6115771369992133,2011,2011.csv
348,Wanted,342463063,134508551,0.39276805452154706,207954512,0.6072319454784529,2008,2008.csv
349,A Quiet Place,340939361,188024361,0.5514891576276522,152915000,0.44851084237234784,2018,2018.csv
350,Enchanted,340487652,127807262,0.37536533630300345,212680390,0.6246346636969966,2007,2007.csv
351,Over the Hedge,339795890,155019340,0.4562131107589324,184776550,0.5437868892410677,2006,2006.csv
352,300: Rise of an Empire,337580051,106580051,0.31571785916935,231000000,0.68428214083065,2014,2014.csv
353,Prince of Persia: The Sands of Time,336365676,90759676,0.2698244276267951,245606000,0.730175572373205,2009,2009.csv
354,The Curious Case of Benjamin Button,335802786,127509326,0.3797149139793021,208293460,0.6202850860206979,2008,2008.csv
355,Journey 2: The Mysterious Island,335260290,103860290,0.30979001420060814,231400000,0.6902099857993919,2012,2012.csv
356,The Great Wall,334933831,45540830,0.13596963276008986,289393001,0.8640303672399101,2016,2016.csv
357,Now You See Me 2,334897606,65075540,0.19431473630778956,269822066,0.8056852636922105,2016,2016.csv
358,Fantastic Four,333535934,154696080,0.46380633758040596,178839854,0.5361936624195941,2005,2005.csv
359,The Good Dinosaur,332207671,123087120,0.3705125761530052,209120551,0.6294874238469947,2015,2015.csv
360,22 Jump Street,331333876,191719337,0.5786288420445123,139614539,0.4213711579554878,2014,2014.csv
361,Meet the Parents,330444045,166244045,0.5030928761327806,164200000,0.49690712386721936,2000,2000.csv
362,Black Swan,329398046,106954678,0.32469736629828094,222443368,0.6753026337017191,2010,2010.csv
363,The Perfect Storm,328718434,182618434,0.5555466779815579,146100000,0.44445332201844207,2000,2000.csv
364,John Wick: Chapter 3 - Parabellum,326709727,171015687,0.5234484096030603,155694040,0.47655159039693973,2019,2019.csv
365,The Devil Wears Prada,326705902,124740460,0.38181269219923675,201965442,0.6181873078007633,2006,2006.csv
366,Taken 3,326479141,89256424,0.27339089329446625,237222717,0.7266091067055338,2015,2015.csv
367,A Christmas Carol,325286646,137855863,0.4237981014443489,187430783,0.5762018985556512,2009,2009.csv
368,The SpongeBob Movie: Sponge Out of Water,325186032,162994032,0.5012331894993571,162192000,0.4987668105006429,2015,2015.csv
369,Megamind,321885765,148415853,0.4610823749848024,173469912,0.5389176250151976,2010,2010.csv
370,Green Book,321752656,85080171,0.26442725308847176,236672485,0.7355727469115282,2018,2018.csv
371,Robin Hood,321669741,105269730,0.327260281532045,216400011,0.672739718467955,2010,2010.csv
372,Inglourious Basterds,321455689,120540719,0.37498393441094147,200914970,0.6250160655890585,2009,2009.csv
373,The Conjuring 2,320392818,102470008,0.31982617038562955,217922810,0.6801738296143705,2016,2016.csv
374,The Last Airbender,319713881,131772187,0.4121566026093187,187941694,0.5878433973906814,2010,2010.csv
375,The Conjuring,319494638,137400141,0.4300546070510266,182094497,0.5699453929489734,2013,2013.csv
376,The Proposal,317375031,163958031,0.5166065852231456,153417000,0.4833934147768543,2009,2009.csv
377,The Expendables 2,314975955,85028192,0.26995137454222495,229947763,0.730048625457775,2012,2012.csv
378,Chicken Little,314432837,135386665,0.4305741928601433,179046172,0.5694258071398567,2005,2005.csv
379,A Beautiful Mind,313542341,170742341,0.5445591190505272,142800000,0.45544088094947277,2001,2001.csv
380,Maze Runner: The Scorch Trials,312296056,81697192,0.2616017411375826,230598864,0.7383982588624174,2015,2015.csv
381,Resident Evil: The Final Chapter,312242626,26830068,0.085926986791355,285412558,0.914073013208645,2016,2016.csv
382,The Lego Batman Movie,311950384,175750384,0.5633921066114155,136200000,0.4366078933885845,2017,2017.csv
383,Ocean's Thirteen,311312624,117154724,0.376325002483677,194157900,0.623674997516323,2007,2007.csv
384,Little Fockers,310650585,148438600,0.47783138731253316,162211985,0.5221686126874668,2010,2010.csv
385,Bolt,309979994,114053579,0.3679385160579105,195926415,0.6320614839420895,2008,2008.csv
386,Knives Out,309232797,165363234,0.5347532202413834,143869563,0.4652467797586166,2019,2019.csv
387,The Blind Side,309208309,255959475,0.8277897700349314,53248834,0.17221022996506863,2009,2009.csv
388,The Ex-File 3: The Return of The Exes,307592427,838959,0.002727502130603495,306753468,0.9972724978693965,2017,2017.csv
389,The Fault in Our Stars,307166834,124872350,0.40652940414784494,182294484,0.593470595852155,2014,2014.csv
390,The Pursuit of Happyness,307127625,163566459,0.5325683712105025,143561166,0.4674316287894975,2006,2006.csv
391,Rise of the Guardians,306941670,103412758,0.33691338813657984,203528912,0.6630866118634202,2012,2012.csv
392,Chicago,306776732,170687518,0.556390039385386,136089214,0.443609960614614,2002,2002.csv
393,Sonic the Hedgehog,306766470,146066470,0.47614874598257106,160700000,0.5238512540174289,2020,2020.csv
394,Annabelle: Creation,306515884,102092201,0.33307311734617967,204423683,0.6669268826538203,2017,2017.csv
395,Wonder,305937718,132422809,0.43284237676114196,173514909,0.5671576232388581,2017,2017.csv
396,Skyscraper,304868961,68420120,0.22442468323300382,236448841,0.7755753167669962,2018,2018.csv
397,A Good Day to Die Hard,304654182,67349198,0.22106769569964413,237304984,0.7789323043003559,2013,2013.csv
398,Dangal,303723636,12391761,0.04079946217949267,291331875,0.9592005378205073,2016,2016.csv
399,Passengers,303144152,100014699,0.3299245535173642,203129453,0.6700754464826357,2016,2016.csv
400,Battleship,303025485,65422625,0.21589809517176417,237602860,0.7841019048282358,2012,2012.csv
401,G.I. Joe: The Rise of Cobra,302469017,150201498,0.49658473945448767,152267519,0.5034152605455123,2009,2009.csv
402,Wrath of the Titans,301970083,83670083,0.27708070338875257,218300000,0.7229192966112474,2012,2012.csv
403,Fantastic 4: Rise of the Silver Surfer,301913131,131921738,0.436952634564278,169991393,0.563047365435722,2007,2007.csv
404,Resident Evil: Afterlife,300228084,60128566,0.20027628727764188,240099518,0.7997237127223581,2010,2010.csv
405,Van Helsing,300157638,120177084,0.4003798963796483,179980554,0.5996201036203517,2004,2004.csv
406,Alice Through the Looking Glass,299457024,77041381,0.257270241889534,222415643,0.7427297581104659,2016,2016.csv
407,Real Steel,299268508,85468508,0.28559138604720813,213800000,0.7144086139527919,2011,2011.csv
408,Horton Hears a Who!,298572799,154529439,0.5175603387768757,144043360,0.48243966122312437,2008,2008.csv
409,Ocean's 8,297718711,140218711,0.47097715333048046,157500000,0.5290228466695195,2018,2018.csv
410,The Divergent Series: Insurgent,297002527,130179072,0.4383096444159211,166823455,0.5616903555840789,2015,2015.csv
411,Austin Powers in Goldmember,296938801,213307889,0.7183564030084435,83630912,0.2816435969915565,2002,2002.csv
412,Miss Peregrine's Home for Peculiar Children,296482446,87242834,0.29425969455203427,209239612,0.7057403054479657,2016,2016.csv
413,X-Men,296339528,157299718,0.5308090994867212,139039810,0.46919090051327883,2000,2000.csv
414,Ferdinand,296069199,84410380,0.28510355107894897,211658819,0.7148964489210511,2017,2017.csv
415,Shutter Island,294804195,128012934,0.4342303677191568,166791261,0.5657696322808432,2010,2010.csv
416,Bee Movie,293514336,126631277,0.431431318571097,166883059,0.568568681428903,2007,2007.csv
417,Salt,293503354,118311368,0.4031005655901295,175191986,0.5968994344098705,2010,2010.csv
418,G-Force,292817841,119436770,0.4078876122852091,173381071,0.5921123877147909,2009,2009.csv
419,The Departed,291465034,132384315,0.45420307603690124,159080719,0.5457969239630988,2006,2006.csv
420,What Lies Beneath,291420351,155464351,0.533471154181679,135956000,0.46652884581832105,2000,2000.csv
421,Pacific Rim: Uprising,290930148,59874525,0.20580378283793402,231055623,0.794196217162066,2018,2018.csv
422,Sex and the City 2,290745055,95347692,0.3279426093764518,195397363,0.6720573906235482,2010,2010.csv
423,The Bourne Supremacy,290633422,176241941,0.6064063100079384,114391481,0.39359368999206157,2004,2004.csv
424,Divergent,288885818,150947895,0.5225174985917792,137937923,0.47748250140822074,2014,2014.csv
425,Wedding Crashers,288467645,209255921,0.7254051697894923,79211724,0.2745948302105077,2005,2005.csv
426,Bridesmaids,288383523,169106725,0.5863952393701772,119276798,0.4136047606298228,2011,2011.csv
427,Maze Runner: The Death Cure,288175335,58032443,0.2013789382772818,230142892,0.7986210617227182,2018,2018.csv
428,American Pie 2,287553595,145103595,0.5046140876798985,142450000,0.4953859123201016,2001,2001.csv
429,Pitch Perfect 2,287144079,184296230,0.6418249355578737,102847849,0.35817506444212627,2015,2015.csv
430,Oblivion,286168572,89107235,0.3113802273158074,197061337,0.6886197726841926,2013,2013.csv
431,Elysium,286140700,93050117,0.3251900795657521,193090583,0.6748099204342479,2013,2013.csv
432,The Polar Express,286000505,162775358,0.5691436034352457,123225147,0.43085639656475433,2004,2004.csv
433,John Carter,284139100,73078100,0.2571912841280908,211061000,0.7428087158719092,2012,2012.csv
434,Turbo,282570682,83028128,0.29383136074959115,199542554,0.7061686392504088,2013,2013.csv
435,Paddington,282370135,76271832,0.2701129565277858,206098303,0.7298870434722142,2014,2014.csv
436,Bridget Jones's Diary,281929795,71543427,0.25376327110087815,210386368,0.7462367288991218,2001,2001.csv
437,The Tourist,278780441,67631157,0.24259649191099458,211149284,0.7574035080890055,2010,2010.csv
438,Split,278454358,138291365,0.4966392553281569,140162993,0.5033607446718431,2017,2017.csv
439,Scary Movie,278019771,157019771,0.5647791537818366,121000000,0.43522084621816337,2000,2000.csv
440,xXx,277448382,142109382,0.5122011560334131,135339000,0.4877988439665869,2002,2002.csv
441,The Bourne Legacy,276144750,113203870,0.4099439514964525,162940880,0.5900560485035475,2012,2012.csv
442,Mr. Peabody & Sherman,275698039,111506430,0.4044512989807664,164191609,0.5955487010192336,2014,2014.csv
443,Scooby-Doo,275650703,153294164,0.556117442588202,122356539,0.44388255741179805,2002,2002.csv
444,Lincoln,275293450,182207973,0.6618681737614898,93085477,0.33813182623851024,2012,2012.csv
445,Spirited Away,274925095,10055859,0.03657672283426873,264869236,0.9634232771657313,2001,2001.csv
446,Lara Croft: Tomb Raider,274703340,131168070,0.4774898987394911,143535270,0.5225101012605089,2001,2001.csv
447,Tomb Raider,274650803,58250803,0.21209041577060309,216400000,0.7879095842293969,2018,2018.csv
448,The Expendables,274470394,103068524,0.3755178199656754,171401870,0.6244821800343245,2010,2010.csv
449,Cloudy With a Chance of Meatballs 2,274325949,119793567,0.43668332302023677,154532382,0.5633166769797632,2013,2013.csv
450,Bad Boys II,273339556,138608444,0.5070925190205547,134731112,0.4929074809794452,2003,2003.csv
451,Lilo & Stitch,273144151,145794338,0.5337633534023578,127349813,0.46623664659764213,2002,2002.csv
452,Grown Ups,271430189,162001186,0.5968429178671795,109429003,0.40315708213282053,2010,2010.csv
453,Neighbors,270665134,150157400,0.5547718606416444,120507734,0.44522813935835565,2014,2014.csv
454,We're the Millers,269994119,150394119,0.5570273884373015,119600000,0.4429726115626985,2012,2012.csv
455,Gran Torino,269958228,148095302,0.5485859908667055,121862926,0.4514140091332945,2008,2008.csv
456,"10,000 BC",269784201,94784201,0.35133340146927283,175000000,0.6486665985307272,2008,2008.csv
457,American Gangster,269755430,130164645,0.4825283591140315,139590785,0.5174716408859684,2007,2007.csv
458,Epic,268426634,107518682,0.4005514668861064,160907952,0.5994485331138936,2013,2013.csv
459,Exodus: Gods and Kings,268175631,65014513,0.24243259075243864,203161118,0.7575674092475614,2014,2014.csv
460,The Princess and the Frog,267045765,104400899,0.3909475928217772,162644866,0.6090524071782228,2009,2009.csv
461,Something's Gotta Give,265328738,124728738,0.4700913249736257,140600000,0.5299086750263743,2003,2003.csv
462,Bridget Jones: The Edge of Reason,265126918,40226215,0.15172437149516443,224900703,0.8482756285048355,2004,2004.csv
463,The Incredible Hulk,264770996,134806913,0.5091453181677045,129964083,0.4908546818322956,2008,2008.csv
464,Charlie's Angels,264105545,125305545,0.47445253373987284,138800000,0.5255474662601272,2000,2000.csv
465,Borat: Cultural Learnings of America for Make Benefit Glorious Nation of Kazakhstan,262552893,128505958,0.48944788431639946,134046935,0.5105521156836006,2006,2006.csv
466,Robots,262511490,128200012,0.48835962189693105,134311478,0.511640378103069,2005,2005.csv
467,Knight and Day 2010 Re-release,261930436,76423035,0.2917684411444266,185507401,0.7082315588555734,2010,2010.csv
468,This Is It,261183588,72091016,0.27601663853396485,189092572,0.7239833614660351,2009,2009.csv
469,Terminator: Dark Fate,261119292,62253077,0.23840856998034446,198866215,0.7615914300196556,2019,2019.csv
470,The Lone Ranger,260502115,89302115,0.34280763900899613,171200000,0.6571923609910039,2013,2013.csv
471,Super 8,260095986,127004179,0.4882973434276683,133091807,0.5117026565723317,2011,2011.csv
472,Mojin: The Lost Legend,259368448,1243810,0.004795533186827721,258124638,0.9952044668131723,2015,2015.csv
473,Blade Runner 2049,259239658,92054159,0.35509288860425825,167185499,0.6449071113957418,2017,2017.csv
474,Charlie's Angels: Full Throttle,259175788,100830111,0.38904139841951596,158345677,0.6109586015804841,2003,2003.csv
475,Rush Hour 3,258097122,140125968,0.542919529339037,117971154,0.457080470660963,2007,2007.csv
476,Kung Fu Yoga,257743016,362657,0.0014070487946800467,257380359,0.99859295120532,2017,2017.csv
477,Parasite,257088648,53369749,0.20759278721633792,203718899,0.7924072127836621,2019,2019.csv
478,Annabelle,257047661,84273813,0.3278528684997449,172773848,0.6721471315002551,2014,2014.csv
479,The Village,256697520,114197520,0.44487192552541993,142500000,0.55512807447458,2003,2003.csv
480,Lost in Hong Kong,256283912,1302281,0.005081399725161055,254981631,0.9949186002748389,2015,2015.csv
481,Erin Brockovich,256271286,125595205,0.4900869190627935,130676081,0.5099130809372066,2000,2000.csv
482,Marley & Me,255743093,143153751,0.5597560791211671,112589342,0.4402439208788329,2008,2008.csv
483,Halloween,255485178,159342015,0.6236839892136522,96143163,0.37631601078634785,2018,2018.csv
484,Get Out,255407969,176040665,0.6892528282858708,79367304,0.31074717171412924,2017,2017.csv
485,Us,255184580,175084580,0.6861095603817441,80100000,0.3138904396182559,2019,2019.csv
486,Baahubali 2: The Conclusion,254158390,20186659,0.07942550706274147,233971731,0.9205744929372586,2017,2017.csv
487,Men in Black: International,253890701,80001807,0.31510333653377876,173888894,0.6848966634662212,2019,2019.csv
488,Wild Hogs,253625427,168273550,0.6634727124579666,85351877,0.33652728754203337,2007,2007.csv
489,High School Musical 3,252909177,90559416,0.3580708975222358,162349761,0.6419291024777641,2008,2008.csv
490,X-Men: Dark Phoenix,252442974,65845974,0.26083504308580996,186597000,0.73916495691419,2019,2019.csv
491,True Grit,252276927,171243005,0.6787898007018296,81033922,0.32121019929817046,2010,2010.csv
492,American Hustle,251171807,150117807,0.5976698133162692,101054000,0.4023301866837308,2013,2013.csv
493,Eragon,250425512,75030163,0.2996107002069342,175395349,0.7003892997930659,2006,2006.csv
494,Brother Bear,250397798,85336277,0.34080282527085165,165061521,0.6591971747291484,2003,2003.csv
495,The Ring,249348933,129128133,0.5178611813029094,120220800,0.48213881869709063,2002,2002.csv
496,Unbreakable,248118121,95011339,0.3829278515292319,153106782,0.6170721484707681,2000,2000.csv
497,Journey to the West: The Demons Strike Back,247585244,880346,0.0035557288704976295,246704898,0.9964442711295024,2017,2017.csv
498,Glass,246999039,111048468,0.44959068848846817,135950571,0.5504093115115318,2019,2019.csv
499,Grown Ups 2,246984278,133668525,0.5412025659382255,113315753,0.4587974340617746,2013,2013.csv
500,The Peanuts Movie,246233113,130178411,0.5286795484732388,116054702,0.47132045152676116,2015,2015.csv
501,Rango,245724603,123477607,0.5025040451484624,122246996,0.4974959548515376,2011,2011.csv
502,Teenage Mutant Ninja Turtles: Out of the Shadows,245623848,82051601,0.3340538863311025,163572247,0.6659461136688974,2016,2016.csv
503,Dark Shadows,245527149,79727149,0.3247182616045446,165800000,0.6752817383954554,2012,2012.csv
504,Hulk,245285165,132177234,0.5388717006183394,113107931,0.4611282993816605,2003,2003.csv
505,The Bravest,245179562,290217,0.0011836916488169597,244889345,0.9988163083511831,2019,2019.csv
506,Welcome to the Sticks,245144417,0,0.0,245144417,1.0,2008,2008.csv
507,Love Actually,244931766,59696144,0.24372560968674026,185235622,0.7562743903132597,2003,2003.csv
508,Pixels,244874809,78747585,0.3215830379677805,166127224,0.6784169620322195,2015,2015.csv
509,Hercules,244819862,72688614,0.29690652304999665,172131248,0.7030934769500033,2014,2014.csv
510,Journey to the Center of the Earth,244232688,101704370,0.41642407014739974,142528318,0.5835759298526002,2008,2008.csv
511,After Earth,243611982,60522097,0.24843645416422908,183089885,0.7515635458357709,2013,2013.csv
512,Cloudy with a Chance of Meatballs,243006126,124870275,0.513856490185766,118135851,0.48614350981423404,2009,2009.csv
513,8 Mile,242875078,116750901,0.48070350388111865,126124177,0.5192964961188813,2002,2002.csv
514,Daddy's Home,242786137,150357137,0.6192986916711806,92429000,0.38070130832881943,2015,2015.csv
515,RoboCop,242688965,58607007,0.24149020125410317,184081958,0.7585097987458969,2014,2014.csv
516,Alien: Covenant,240891763,74262031,0.3082796608533269,166629732,0.6917203391466731,2017,2017.csv
517,Sully,240797623,125070033,0.5193989518742052,115727590,0.48060104812579485,2016,2016.csv
518,Assassin's Creed,240697856,54647948,0.2270396126835463,186049908,0.7729603873164537,2016,2016.csv
519,Click,240685326,137355633,0.570685530699948,103329693,0.42931446930005196,2006,2006.csv
520,Resident Evil: Retribution,240159255,42345531,0.17632271136084263,197813724,0.8236772886391573,2012,2012.csv
521,Planes,239258712,90288712,0.37736854489127236,148970000,0.6226314551087276,2013,2013.csv
522,Crazy Rich Asians,238532921,174532921,0.7316932198218459,64000000,0.2683067801781541,2018,2018.csv
523,Gulliver's Travels,237382724,42779261,0.1802121918526809,194603463,0.8197878081473191,2010,2010.csv
524,Gone in 60 Seconds,237202299,101648571,0.4285311374659147,135553728,0.5714688625340854,2000,2000.csv
525,Silver Linings Playbook,236412453,132092958,0.5587394247797937,104319495,0.44126057522020634,2012,2012.csv
526,2 Fast 2 Furious,236350661,127154901,0.5379925762086191,109195760,0.4620074237913809,2003,2003.csv
527,Hidden Figures,235956898,169607287,0.7188062245164792,66349611,0.2811937754835207,2016,2016.csv
528,A.I. Artificial Intelligence,235926552,78616689,0.33322527004082186,157309863,0.6667747299591782,2001,2001.csv
529,Spy,235666219,110825712,0.47026558354551445,124840507,0.5297344164544856,2015,2015.csv
530,Howl's Moving Castle,235347345,4711096,0.020017629686878344,230636249,0.9799823703131216,2004,2004.csv
531,American Reunion,234989584,57011521,0.24261297045404362,177978063,0.7573870295459564,2012,2012.csv
532,Alvin and the Chipmunks: The Road Chip,234798636,85886987,0.3657899741802589,148911649,0.6342100258197412,2015,2015.csv
533,The Imitation Game,233555708,91125683,0.39016679909188945,142430025,0.6098332009081106,2014,2014.csv
534,The Day the Earth Stood Still,233093859,79366978,0.34049364638130597,153726881,0.659506353618694,2008,2008.csv
535,American Wedding,232722935,104565114,0.4493115987902095,128157821,0.5506884012097906,2003,2003.csv
536,The Girl with the Dragon Tattoo,232617430,102515793,0.44070555246010584,130101637,0.5592944475398941,2011,2011.csv
537,Juno,232372681,143495265,0.6175220958956015,88877416,0.3824779041043986,2007,2007.csv
538,Argo,232325503,136025503,0.5854953556261105,96300000,0.4145046443738895,2012,2012.csv
539,Mr. Bean's Holiday,232225908,33302167,0.14340418468726582,198923741,0.8565958153127342,2007,2007.csv
540,Annabelle Comes Home,231252591,74152591,0.32065626023623667,157100000,0.6793437397637634,2019,2019.csv
541,Constantine,230884728,75976178,0.32906541137705736,154908550,0.6709345886229426,2005,2005.csv
542,Get Smart,230685453,130319208,0.5649216554630343,100366245,0.43507834453696564,2008,2008.csv
543,Ghostbusters,229147509,128350574,0.5601220565744837,100796935,0.43987794342551634,2016,2016.csv
544,Ghost Rider,228738393,115802596,0.5062665452930764,112935797,0.49373345470692365,2007,2007.csv
545,Goodbye Mr. Loser,228122928,1293626,0.005670740820931423,226829302,0.9943292591790686,2015,2015.csv
546,Paddington 2,227978523,40891591,0.17936597913655225,187086932,0.8206340208634477,2017,2017.csv
547,The Green Hornet,227817248,98780042,0.4335933423267408,129037206,0.5664066576732593,2011,2011.csv
548,Youth,227091290,1891956,0.00833125744276674,225199334,0.9916687425572333,2017,2017.csv
549,Baby Driver,226945087,107825862,0.47511873213628986,119119225,0.5248812678637101,2017,2017.csv
550,Immortals,226904017,83504017,0.3680147143450528,143400000,0.6319852856549473,2011,2011.csv
551,Taken,226837760,145000989,0.6392277414483374,81836771,0.3607722585516627,2008,2008.csv
552,Percy Jackson & the Olympians: The Lightning Thief,226497209,88768303,0.39191786685548075,137728906,0.6080821331445192,2010,2010.csv
553,Hansel & Gretel: Witch Hunters,226349749,55703475,0.2460947062945495,170646274,0.7539052937054505,2013,2013.csv
554,Valerian and the City of a Thousand Planets,225874228,41189488,0.18235585513545174,184684740,0.8176441448645483,2017,2017.csv
555,Better Days,225545362,1921657,0.008520046623703129,223623705,0.9914799533762969,2019,2019.csv
556,Ford v Ferrari,225508210,117624357,0.521596783549477,107883853,0.47840321645052303,2019,2019.csv
557,Jumper,225132113,80172128,0.3561114713119581,144959985,0.6438885286880419,2008,2008.csv
558,The Social Network,224920315,96962694,0.4310979824121267,127957621,0.5689020175878733,2010,2010.csv
559,Chicken Run,224834564,106834564,0.47516966297050306,118000000,0.524830337029497,2000,2000.csv
560,Dolittle,224698168,77047065,0.34289138040502404,147651103,0.6571086195949759,2020,2020.csv
561,Flightplan,223387299,89707299,0.40157743704130644,133680000,0.5984225629586936,2005,2005.csv
562,Yes Man,223241637,97690976,0.43760195146750336,125550661,0.5623980485324966,2008,2008.csv
563,Non-Stop,222809600,92168600,0.4136652998793589,130641000,0.5863347001206412,2014,2014.csv
564,Fahrenheit 9/11,222446882,119194771,0.5358347571713772,103252111,0.4641652428286228,2004,2004.csv
565,Geostorm,221600160,33700160,0.15207642449355632,187900000,0.8479235755064437,2017,2017.csv
566,Collateral,220926695,101005703,0.4571910289066697,119920992,0.5428089710933303,2004,2004.csv
567,Scary Movie 3,220673217,110003217,0.4984892072335176,110670000,0.5015107927664824,2003,2003.csv
568,Elf,220443451,173398518,0.7865895639603283,47044933,0.2134104360396717,2003,2003.csv
569,Inferno,220021259,34343574,0.15609207108482184,185677685,0.8439079289151782,2016,2016.csv
570,Knocked Up,219922417,148768917,0.6764609039377737,71153500,0.32353909606222636,2007,2007.csv
571,Green Lantern,219851172,116601172,0.5303641137742036,103250000,0.46963588622579644,2011,2011.csv
572,What Happens in Vegas,219375562,80277646,0.36593704999830384,139097916,0.6340629500016962,2008,2008.csv
573,It's Complicated,219103655,112735375,0.5145298694355418,106368280,0.4854701305644582,2009,2009.csv
574,The Terminal,219100084,77872883,0.3554215113856369,141227201,0.6445784886143631,2004,2004.csv
575,Captain Phillips,218791811,107100855,0.4895103455220269,111690956,0.5104896544779731,2013,2013.csv
576,Jack Reacher,218340595,80070736,0.3667239983476275,138269859,0.6332760016523725,2012,2012.csv
577,Kingdom of Heaven,218122627,47398413,0.2173016786561992,170724214,0.7826983213438008,2005,2005.csv
578,The Emoji Movie,217776646,86089513,0.39531104267259215,131687133,0.6046889573274078,2017,2017.csv
579,Dracula Untold,217124280,56280355,0.2592080213230874,160843925,0.7407919786769126,2014,2014.csv
580,Central Intelligence,216972543,127440871,0.5873594383783389,89531672,0.412640561621661,2016,2016.csv
581,Million Dollar Baby,216763646,100492203,0.4636026605679072,116271443,0.5363973394320928,2004,2004.csv
582,The Help,216639112,169708112,0.7833678343363962,46931000,0.21663216566360372,2011,2011.csv
583,Valentine's Day,216485654,110485654,0.5103601645585254,106000000,0.48963983544147455,2010,2010.csv
584,Bad Teacher,216197492,100292856,0.46389463204318765,115904636,0.5361053679568124,2011,2011.csv
585,Ted 2,215863606,81476385,0.37744382441197616,134387221,0.6225561755880239,2015,2015.csv
586,Vertical Limit,215663859,69243859,0.3210730778957266,146420000,0.6789269221042734,2000,2000.csv
587,The Patriot,215294342,113330342,0.5263972148418095,101964000,0.47360278515819054,2000,2000.csv
588,The Sorcerer's Apprentice,215283742,63150991,0.29333841196424393,152132751,0.7066615880357561,2010,2010.csv
589,Just Go with It,214945591,103028109,0.4793218066054679,111917482,0.5206781933945321,2011,2011.csv
590,The Expendables 3,214657577,39322544,0.18318730952599918,175335033,0.8168126904740008,2014,2014.csv
591,Creed II,214215889,115715889,0.5401835015142131,98500000,0.45981649848578693,2018,2018.csv
592,Public Enemies,214104620,97104620,0.453538181474085,117000000,0.546461818525915,2009,2009.csv
593,Smallfoot,214040103,83240103,0.3888995652370808,130800000,0.6111004347629192,2018,2018.csv
594,The Bourne Identity,214034224,121661683,0.5684216324208039,92372541,0.4315783675791961,2002,2002.csv
595,The Aviator,213719942,102610330,0.4801158424420684,111109612,0.5198841575579316,2004,2004.csv
596,"Crouching Tiger, Hidden Dragon",213525736,128078872,0.5998287344622477,85446864,0.40017126553775234,2000,2000.csv
597,Into the Woods,212902372,128002372,0.6012256735213829,84900000,0.39877432647861716,2014,2014.csv
598,Bedtime Stories,212874864,110101975,0.5172145406514506,102772889,0.4827854593485495,2008,2008.csv
599,Miss Congeniality,212742720,106807667,0.502050866887478,105935053,0.49794913311252204,2000,2000.csv
600,Bridget Jones's Baby,211952420,24252420,0.11442388815376583,187700000,0.8855761118462342,2016,2016.csv
601,Battle Los Angeles,211819354,83552429,0.3944513446113144,128266925,0.6055486553886856,2011,2011.csv
602,Fury,211817906,85817906,0.4051494400100433,126000000,0.5948505599899566,2014,2014.csv
603,Australia,211787511,49554002,0.23397981196351092,162233509,0.7660201880364891,2008,2008.csv
604,Due Date,211780824,100539043,0.47473156965335067,111241781,0.5252684303466493,2010,2010.csv
605,Master and Commander: The Far Side of the World,211622535,93927920,0.44384649300226936,117694615,0.5561535069977307,2003,2003.csv
606,Lemony Snicket's A Series of Unfortunate Events,211468235,118634549,0.5610041101444858,92833686,0.43899588985551424,2004,2004.csv
607,District 9,210888950,115646235,0.5483750334002802,95242715,0.4516249665997199,2009,2009.csv
608,The Others,209947037,96522687,0.4597477934399236,113424350,0.5402522065600764,2001,2001.csv
609,Horrible Bosses,209838559,117538559,0.5601380392628411,92300000,0.4398619607371589,2011,2011.csv
610,Red Dragon,209196298,93149898,0.44527507843374936,116046400,0.5547249215662506,2002,2002.csv
611,Little Women,209101214,108101214,0.516980327048699,101000000,0.483019672951301,2019,2019.csv
612,Tomorrowland,209035668,93436322,0.44698745861878464,115599346,0.5530125413812154,2015,2015.csv
613,Me Before You,208314186,56245075,0.2700011750519957,152069111,0.7299988249480043,2016,2016.csv
614,Safe House,208076205,126373434,0.6073420745058283,81702771,0.3926579254941717,2012,2012.csv
615,S.W.A.T.,207725639,116934650,0.562928344151104,90790989,0.43707165584889596,2003,2003.csv
616,Traffic,207515725,124115725,0.5981027461894756,83400000,0.4018972538105245,2000,2000.csv
617,The Fast and the Furious,207283925,144533925,0.697275126375574,62750000,0.302724873624426,2001,2001.csv
618,Paranormal Activity 3,207039844,104028807,0.5024579085366776,103011037,0.4975420914633224,2011,2011.csv
619,The Holiday,205841885,63224849,0.3071524971703402,142617036,0.6928475028296598,2006,2006.csv
620,London Has Fallen,205754447,62524260,0.30387804935268303,143230187,0.696121950647317,2016,2016.csv
621,The Break-Up,205668210,118703275,0.5771590806376931,86964935,0.4228409193623069,2006,2006.csv
622,Journey to the West,205637183,18058,8.781485788005567e-05,205619125,0.99991218514212,2013,2013.csv
623,White House Down,205366737,73103784,0.35596701329485503,132262953,0.644032986705145,2013,2013.csv
624,The Ugly Truth,205298907,88915214,0.43310125367593894,116383693,0.566898746324061,2009,2009.csv
625,A Dog's Purpose,205035819,64508620,0.3146212223533489,140527199,0.6853787776466511,2017,2017.csv
626,Fun with Dick and Jane,204681899,110332737,0.5390449157402043,94349162,0.46095508425979576,2005,2005.csv
627,Eat Pray Love,204594016,80574010,0.39382388388133505,124020006,0.606176116118665,2010,2010.csv
628,You Don't Mess with the Zohan,204313400,100018837,0.48953635444371246,104294563,0.5104636455562875,2008,2008.csv
629,King Arthur,203567857,51882244,0.2548646174528428,151685613,0.7451353825471573,2004,2004.csv
630,Hairspray,203552922,118871849,0.5839849795916956,84681073,0.4160150204083044,2007,2007.csv
631,Yogi Bear,203509374,100246011,0.49258670020772605,103263363,0.5074132997922739,2010,2010.csv
632,Everest,203427584,43482270,0.2137481512831613,159945314,0.7862518487168387,2015,2015.csv
633,Vanilla Sky,203388341,100618344,0.4947104809709815,102769997,0.5052895190290185,2001,2001.csv
634,Arrival,203388186,100546139,0.49435584719753584,102842047,0.5056441528024641,2016,2016.csv
635,Need for Speed,203277636,43577636,0.2143749644943726,159700000,0.7856250355056273,2014,2014.csv
636,Garfield,203172417,75369589,0.3709636874576336,127802828,0.6290363125423665,2004,2004.csv
637,The Addams Family,203044905,100044905,0.49272305059809307,103000000,0.5072769494019069,2019,2019.csv
638,Ponyo,202551810,15090399,0.07450142756068188,187461411,0.9254985724393181,2008,2008.csv
639,Birds of Prey: And the Fantabulous Emancipation of One Harley Quinn,201858461,84158461,0.41691817416561006,117700000,0.5830818258343899,2020,2020.csv
640,Straight Outta Compton,201634991,161197785,0.7994534291917617,40437206,0.20054657080823834,2015,2015.csv
641,21 Jump Street,201585328,138447667,0.6867943633278708,63137661,0.31320563667212925,2012,2012.csv
642,Valkyrie,201545517,83077833,0.41220382490571594,118467684,0.5877961750942841,2008,2008.csv
643,Open Season,200811689,85105259,0.4238063004390148,115706430,0.5761936995609852,2006,2006.csv
644,Cats & Dogs,200687492,93385515,0.46532802851510047,107301977,0.5346719714848995,2001,2001.csv
645,Percy Jackson: Sea of Monsters,199850315,68559554,0.34305452057956476,131290761,0.6569454794204352,2013,2013.csv
646,Two Weeks Notice,199043242,93354851,0.469017938323171,105688391,0.530982061676829,2002,2002.csv
647,RED,199006387,90380162,0.45415709195303366,108626225,0.5458429080469663,2010,2010.csv
648,The Pacifier,198636868,113086868,0.5693145947105851,85550000,0.43068540528941485,2005,2005.csv
649,50 First Dates,198520934,120908074,0.609044454727379,77612860,0.390955545272621,2004,2004.csv
650,Total Recall,198467168,58877969,0.296663521696445,139589199,0.703336478303555,2012,2012.csv
651,The Island,198326350,670883,0.0033827224672868736,197655467,0.9966172775327131,2018,2018.csv
652,The Impossible,198087212,19019882,0.09601771769093302,179067330,0.903982282309067,2012,2012.csv
653,Lost in Thailand,197757387,57387,0.00029018890707733716,197700000,0.9997098110929227,2012,2012.csv
654,Christopher Robin,197744377,99215042,0.5017338217409844,98529335,0.4982661782590157,2018,2018.csv
655,Jack the Giant Slayer,197687603,65187603,0.3297505863329225,132500000,0.6702494136670776,2013,2013.csv
656,Smurfs: The Lost Village,197183546,45020282,0.22831662637814618,152163264,0.7716833736218538,2017,2017.csv
657,Spy Kids 3-D: Game Over,197011982,111761982,0.567285201973147,85250000,0.43271479802685303,2003,2003.csv
658,The Other Woman,196710396,83911193,0.4265722336301941,112799203,0.5734277663698059,2014,2014.csv
659,Panic Room,196397415,96397334,0.49082791644686363,100000081,0.5091720835531364,2002,2002.csv
660,Beowulf,196393745,82280579,0.41895722799114604,114113166,0.5810427720088539,2007,2007.csv
661,The Vow,196114570,125014030,0.6374540657535032,71100540,0.36254593424649684,2012,2012.csv
662,Anger Management,195745823,135645823,0.6929691827957933,60100000,0.3070308172042067,2003,2003.csv
663,Tropic Thunder,195702811,110515313,0.564709890651494,85187498,0.435290109348506,2008,2008.csv
664,The Shape of Water,195333312,63859435,0.3269254708587545,131473877,0.6730745291412455,2017,2017.csv
665,The BFG,195243411,55483770,0.28417742609506036,139759641,0.7158225739049396,2016,2016.csv
666,Rocketman,195179299,96368160,0.4937417056713581,98811139,0.5062582943286419,2019,2019.csv
667,The Intern,194564672,75764672,0.38940610965591943,118800000,0.6105938903440805,2015,2015.csv
668,Wallace & Gromit: The Curse of the Were-Rabbit,194111171,56110897,0.2890657797329964,138000274,0.7109342202670036,2005,2005.csv
669,Gnomeo & Juliet,193967670,99967670,0.5153831563785862,94000000,0.48461684362141383,2011,2011.csv
670,The Sum of All Fears,193921372,118907036,0.6131713837090633,75014336,0.38682861629093673,2002,2002.csv
671,Gangs of New York,193772504,77812000,0.4015636810886234,115960504,0.5984363189113766,2002,2002.csv
672,The Monkey King 2,193678298,709982,0.003665779838689,192968316,0.996334220161311,2016,2016.csv
673,Paranormal Activity,193355800,107918810,0.5581358821405926,85436990,0.4418641178594074,2009,2009.csv
674,Weathering with You,193168568,7798743,0.04037273289720717,185369825,0.9596272671027928,2019,2019.csv
675,Downton Abbey,192798625,96854135,0.5023590546872416,95944490,0.4976409453127583,2019,2019.csv
676,The Equalizer,192330738,101530738,0.527896575741315,90800000,0.47210342425868507,2014,2014.csv
677,The Lego Movie 2: The Second Part,192306508,105806508,0.5501972299346208,86500000,0.44980277006537916,2019,2019.csv
678,The Longest Yard,191466556,158119460,0.8258333115888918,33347096,0.17416668841110822,2005,2005.csv
679,The Equalizer 2,190400157,102084362,0.5361569213411941,88315795,0.4638430786588059,2018,2018.csv
680,Hollow Man,190213455,73209340,0.3848799234523131,117004115,0.615120076547687,2000,2000.csv
681,Cheaper by the Dozen,190212113,138614544,0.7287366814541406,51597569,0.2712633185458594,2003,2003.csv
682,The White Storm 2: Drug Lords,189396380,609461,0.003217912612690908,188786919,0.9967820873873091,2019,2019.csv
683,Breakup Buddies,189017596,777896,0.004115468699538428,188239700,0.9958845313004616,2014,2014.csv
684,The Secret Life of Walter Mitty,188133322,58236838,0.30955089391341317,129896484,0.6904491060865868,2013,2013.csv
685,12 Years a Slave,187733202,56671993,0.30187517389704993,131061209,0.6981248261029501,2013,2013.csv
686,Mr. Popper's Penguins,187361754,68224452,0.3641322230576471,119137302,0.635867776942353,2011,2011.csv
687,The Grudge,187281115,110359362,0.5892711713084365,76921753,0.41072882869156346,2004,2004.csv
688,I Now Pronounce You Chuck & Larry,187134117,120059556,0.6415695754719061,67074561,0.3584304245280939,2007,2007.csv
689,Walk the Line,186797986,119519402,0.6398323909123945,67278584,0.3601676090876055,2005,2005.csv
690,The Final Destination,186167139,66477700,0.35708611281822406,119689439,0.6429138871817759,2009,2009.csv
691,Atlantis: The Lost Empire,186053725,84056472,0.45178602040888993,101997253,0.5482139795911101,2001,2001.csv
692,Inside Man,186003591,88513495,0.47586981801872846,97490096,0.5241301819812715,2006,2006.csv
693,Hugo,185770160,73864507,0.39761233451055866,111905653,0.6023876654894413,2011,2011.csv
694,The Lion King 2011 3D Release,185542001,94242001,0.5079281267425805,91300000,0.49207187325741947,2011,2011.csv
695,Pitch Perfect 3,185400345,104897530,0.5657892923554161,80502815,0.4342107076445839,2017,2017.csv
696,Watchmen,185382813,107509799,0.5799340147028624,77873014,0.42006598529713757,2009,2009.csv
697,Hop,183953723,108085305,0.5875679123928359,75868418,0.4124320876071641,2011,2011.csv
698,Bad Moms,183936074,113257297,0.615742711785835,70678777,0.3842572882141651,2016,2016.csv
699,Jupiter Ascending,183887723,47387723,0.25769922117095334,136500000,0.7423007788290467,2015,2015.csv
700,Knowing,183658498,79957634,0.435360382834014,103700864,0.564639617165986,2007,2007.csv
701,102 Dalmatians,183611771,66957026,0.36466630453665194,116654745,0.6353336954633481,2000,2000.csv
702,Storks,183388953,72679278,0.3963121922616571,110709675,0.6036878077383429,2016,2016.csv
703,Paul Blart: Mall Cop,183348429,146336178,0.7981316163881611,37012251,0.20186838361183884,2009,2009.csv
704,Mirror Mirror,183018522,64935167,0.3548010676209045,118083355,0.6451989323790955,2012,2012.csv
705,The Haunted Mansion,182290266,75847266,0.41607962764177436,106443000,0.5839203723582257,2003,2003.csv
706,Abominable,181714959,60716390,0.3341298390299282,120998569,0.6658701609700718,2019,2019.csv
707,Poseidon,181674817,60674817,0.33397483482809837,121000000,0.6660251651719016,2006,2006.csv
708,Scooby-Doo 2: Monsters Unleashed,181216833,84216833,0.46472963689857666,97000000,0.5352703631014234,2004,2004.csv
709,Road to Perdition,181001478,104454762,0.5770934201984804,76546716,0.42290657980151963,2002,2002.csv
710,Kill Bill: Vol. 1,180899045,70099045,0.38750367642902706,110800000,0.612496323570973,2003,2003.csv
711,Sweet Home Alabama,180622424,127223418,0.7043611484252918,53399006,0.29563885157470815,2002,2002.csv
712,Daddy's Home 2,180613180,104029443,0.5759792447040687,76583737,0.42402075529593136,2017,2017.csv
713,Deja Vu,180557550,64038616,0.35467149393642083,116518934,0.6453285060635792,2006,2006.csv
714,Hacksaw Ridge,180450918,67209615,0.3724537161955585,113241303,0.6275462838044414,2016,2016.csv
715,The Post,179769457,81903458,0.4556027445752367,97865999,0.5443972554247632,2017,2017.csv
716,The Dictator,179379533,59650222,0.3325363880839181,119729311,0.6674636119160818,2012,2012.csv
717,The League of Extraordinary Gentlemen,179265204,66465204,0.37076466886457227,112800000,0.6292353311354277,2003,2003.csv
718,Allegiant,179246868,66184051,0.36923407219589466,113062817,0.6307659278041053,2016,2016.csv
719,Moulin Rouge!,179213434,57386607,0.320213756966456,121826827,0.6797862430335441,2001,2001.csv
720,Daredevil,179179718,102543518,0.5722942258453605,76636200,0.4277057741546395,2003,2003.csv
721,He's Just Not That Into You,178866158,93953653,0.5252735008709697,84912505,0.4747264991290303,2009,2009.csv
722,The Scorpion King,178799308,91047077,0.5092138108275005,87752231,0.4907861891724995,2002,2002.csv
723,Eagle Eye,178767383,101440743,0.5674454774560301,77326640,0.43255452254396987,2008,2008.csv
724,Along Came Polly,178311729,88097164,0.4940626423963395,90214565,0.5059373576036605,2004,2004.csv
725,Flushed Away,178281554,64665672,0.36271656012152553,113615882,0.6372834398784745,2006,2006.csv
726,Scary Movie 4,178262620,90710620,0.5088594569068939,87552000,0.4911405430931061,2006,2006.csv
727,Brokeback Mountain,178062759,83043761,0.46637354978870116,95018998,0.5336264502112988,2005,2005.csv
728,Baywatch,177856751,58060186,0.32644353207599075,119796565,0.6735564679240093,2017,2017.csv
729,War Horse,177584879,79884879,0.44984054639021376,97700000,0.5501594536097862,2011,2011.csv
730,Paranormal Activity 2,177512032,84752907,0.4774488018930458,92759125,0.5225511981069543,2010,2010.csv
731,How to Lose a Guy in 10 Days,177502387,105813373,0.5961236622693981,71689014,0.4038763377306019,2003,2003.csv
732,Alien vs. Predator,177427090,80282231,0.4524801201439983,97144859,0.5475198798560017,2004,2004.csv
733,Hero,177395557,53710019,0.302769809505432,123685538,0.697230190494568,2002,2002.csv
734,The 40-Year-Old Virgin,177378645,109449237,0.6170372820245639,67929408,0.38296271797543613,2005,2005.csv
735,Lee Daniels' The Butler,177313795,116632095,0.6577722562421046,60681700,0.34222774375789544,2013,2013.csv
736,The Descendants,177243185,82584160,0.4659370119082435,94659025,0.5340629880917566,2011,2011.csv
737,The A-Team,177238796,77222099,0.4356952357090036,100016697,0.5643047642909964,2010,2010.csv
738,The Hitman's Bodyguard,176586701,75468583,0.4273741033306919,101118118,0.5726258966693081,2017,2017.csv
739,Looper,176506819,66486205,0.37667782682095696,110020614,0.623322173179043,2012,2012.csv
740,Dr. Dolittle 2,176104344,112952899,0.6413975739292382,63151445,0.35860242607076176,2001,2001.csv
741,The Italian Job,176070171,106128601,0.6027630938121824,69941570,0.3972369061878176,2003,2003.csv
742,Ip Man 4: The Finale,175695381,3956031,0.022516420053182842,171739350,0.9774835799468171,2019,2019.csv
743,The Bucket List,175372502,93466502,0.5329598479469717,81906000,0.46704015205302823,2007,2007.csv
744,Cowboys & Aliens,174822325,100240551,0.5733852984737504,74581774,0.4266147015262496,2011,2011.csv
745,The Mule,174804407,103804407,0.5938317504775494,71000000,0.40616824952245056,2018,2018.csv
746,Evan Almighty,174440724,100462298,0.5759108062404052,73978426,0.4240891937595948,2007,2007.csv
747,Identity Thief,173965010,134506920,0.7731837568945618,39458090,0.22681624310543827,2013,2013.csv
748,The Nutcracker and the Four Realms,173961069,54858851,0.3153513100106323,119102218,0.6846486899893677,2018,2018.csv
749,Big Momma's House,173959438,117559438,0.6757864899517553,56400000,0.32421351004824467,2000,2000.csv
750,In Time,173930596,37520095,0.215718774401256,136410501,0.784281225598744,2011,2011.csv
751,Amélie,173921954,33225499,0.1910368313824257,140696455,0.8089631686175743,2001,2001.csv
752,Operation Mekong,173839072,800012,0.004602026407504062,173039060,0.9953979735924959,2016,2016.csv
753,Creed,173567581,109767581,0.6324198353608442,63800000,0.3675801646391557,2015,2015.csv
754,Gemini Man,173469516,48546770,0.27985764369112553,124922746,0.7201423563088745,2019,2019.csv
755,The Girl on the Train,173185859,75395035,0.435341750390833,97790824,0.564658249609167,2016,2016.csv
756,Cold Mountain,173013509,95636509,0.5527690268394013,77377000,0.4472309731605987,2003,2003.csv
757,Black Hawk Down,172989651,108638745,0.6280071921759065,64350906,0.3719928078240935,2001,2001.csv
758,The Grand Budapest Hotel,172936941,59301324,0.342907210322403,113635617,0.657092789677597,2014,2014.csv
759,The Santa Clause 2,172855065,139236327,0.8055090951485859,33618738,0.1944909048514141,2002,2002.csv
760,Cloverfield,172394180,80048433,0.46433373214803425,92345747,0.5356662678519658,2008,2008.csv
761,Couples Retreat,171844840,109204945,0.6354857381810243,62639895,0.3645142618189758,2009,2009.csv
762,Blood Diamond,171720398,57377916,0.3341357035522361,114342482,0.6658642964477639,2006,2006.csv
763,Jackass 3D,171685792,117229692,0.6828153374508708,54456100,0.3171846625491293,2010,2010.csv
764,No Country for Old Men,171627166,74283625,0.43281973787296585,97343541,0.5671802621270341,2007,2007.csv
765,Spies in Disguise,171616764,66757013,0.3889888810629246,104859751,0.6110111189370754,2019,2019.csv
766,John Wick: Chapter 2,171539887,92029184,0.5364885427492441,79510703,0.46351145725075593,2017,2017.csv
767,Anchorman 2: The Legend Continues,171464676,125168368,0.7299950690718361,46296308,0.2700049309281639,2013,2013.csv
768,Mr. Deeds,171269535,126293452,0.7373958947223159,44976083,0.2626041052776841,2002,2002.csv
769,Superbad,170812526,121463226,0.7110908599290897,49349300,0.28890914007091023,2007,2007.csv
770,The Other Guys,170458922,119219978,0.6994059131736149,51238944,0.30059408682638505,2010,2010.csv
771,Olympus Has Fallen,170270201,98925640,0.5809920903305916,71344561,0.4190079096694083,2013,2013.csv
772,Starsky & Hutch,170268750,88237754,0.5182263568623132,82030996,0.4817736431376867,2004,2004.csv
773,Shall We Dance,170128460,57890460,0.3402749898517861,112238000,0.6597250101482138,2004,2004.csv
774,Stuart Little 2,169956806,64956806,0.3821959680743824,105000000,0.6178040319256176,2002,2002.csv
775,Zookeeper,169852759,80360843,0.47312062207950356,89491916,0.5268793779204964,2011,2011.csv
776,Dumb and Dumber To,169837010,86208010,0.5075926030492411,83629000,0.49240739695075886,2014,2014.csv
777,Ghost in the Shell,169801921,40563557,0.23888750351652382,129238364,0.7611124964834762,2017,2017.csv
778,Seven Pounds,169748929,69951824,0.412089928414217,99797105,0.587910071585783,2008,2008.csv
779,Meet the Robinsons,169333034,97822171,0.5776910074144186,71510863,0.42230899258558136,2007,2007.csv
780,The Emperor's New Groove,169327687,89302687,0.5273956585729539,80025000,0.4726043414270461,2000,2000.csv
781,Dodgeball,168423227,114326736,0.6788062313994256,54096491,0.3211937686005743,2004,2004.csv
782,Hellboy II: The Golden Army,168319243,75986503,0.4514427563104,92332740,0.5485572436896,2008,2008.csv
783,Insidious: The Last Key,167885588,67745330,0.40352081919026905,100140258,0.596479180809731,2018,2018.csv
784,Fantastic Four,167882881,56117548,0.3342660530110869,111765333,0.6657339469889131,2015,2015.csv
785,Unstoppable,167805466,81562942,0.48605652690717477,86242524,0.5139434730928253,2010,2010.csv
786,Magic Mike,167739368,113721571,0.6779658964733908,54017797,0.3220341035266092,2012,2012.csv
787,Alexander,167298192,34297191,0.20500634579481888,133001001,0.7949936542051811,2004,2004.csv
788,Up in the Air,166842739,83823381,0.5024095234974535,83019358,0.4975904765025465,2009,2009.csv
789,Nutty Professor II: The Klumps,166339890,123309890,0.7413128023590734,43030000,0.2586871976409267,2000,2000.csv
790,Bridge of Spies,165478348,72313754,0.4369982833041094,93164594,0.5630017166958906,2015,2015.csv
791,The Princess Diaries,165335153,108248956,0.6547243827814403,57086197,0.3452756172185597,2001,2001.csv
792,The Muppets,165184237,88631237,0.5365598958452676,76553000,0.4634401041547324,2011,2011.csv
793,The Huntsman: Winter's War,164989338,48390190,0.2932928308373478,116599148,0.7067071691626522,2016,2016.csv
794,Saw III,164874275,80238724,0.4866661218070557,84635551,0.5133338781929443,2006,2006.csv
795,Bringing Down the House,164729679,132716677,0.8056634226792854,32013002,0.19433657732071463,2003,2003.csv
796,Daddy Day Care,164433867,104297061,0.6342796827857853,60136806,0.3657203172142148,2003,2003.csv
797,Miami Vice,164231296,63450470,0.386348226832479,100780826,0.613651773167521,2006,2006.csv
798,The Spiderwick Chronicles,164170327,71195053,0.43366578054023125,92975274,0.5663342194597688,2008,2008.csv
799,The Pink Panther,164115897,82226474,0.5010268688352597,81889423,0.49897313116474024,2006,2006.csv
800,Four Christmases,164112721,120146040,0.7320946192830475,43966681,0.26790538071695247,2008,2008.csv
801,The Ring Two,163995949,76231249,0.46483617104468844,87764700,0.5351638289553116,2005,2005.csv
802,Burn After Reading,163728902,60355347,0.3686297670279374,103373555,0.6313702329720625,2008,2008.csv
803,The Happening,163403799,64506874,0.3947697323732357,98896925,0.6052302676267644,2008,2008.csv
804,Talladega Nights: The Ballad of Ricky Bobby,163362095,148213377,0.9072690760974876,15148718,0.09273092390251239,2006,2006.csv
805,World Trade Center,163247198,70278893,0.43050596801055047,92968305,0.5694940319894495,2006,2006.csv
806,The Island,162949164,35818913,0.21981648828833514,127130251,0.7801835117116649,2005,2005.csv
807,The Interpreter,162944923,72708161,0.4462131109172392,90236762,0.5537868890827609,2005,2005.csv
808,27 Dresses,162655351,76808654,0.47221719745328267,85846697,0.5277828025467173,2008,2008.csv
809,The Magnificent Seven,162360636,93432655,0.5754637164638847,68927981,0.4245362835361152,2016,2016.csv
810,Memoirs of a Geisha,162242962,57490508,0.35434823977141144,104752454,0.6456517602285885,2005,2005.csv
811,Jack Reacher: Never Go Back,162146076,58697076,0.36200121179620776,103449000,0.6379987882037922,2016,2016.csv
812,Insidious: Chapter 2,161919318,83586447,0.5162228203060983,78332871,0.4837771796939016,2013,2013.csv
813,Limitless,161849455,79249455,0.489649192825518,82600000,0.510350807174482,2011,2011.csv
814,Scream 3,161834276,89143175,0.5508300046400554,72691101,0.4491699953599446,2000,2000.csv
815,Flight,161772375,93772375,0.5796562917494411,68000000,0.42034370825055883,2012,2012.csv
816,Into the Storm,161502194,47602194,0.29474642307336085,113900000,0.7052535769266391,2014,2014.csv
817,Unbroken,161459297,115637895,0.7162046233856698,45821402,0.28379537661433024,2014,2014.csv
818,Freaky Friday,160846332,110230332,0.6853145522771387,50616000,0.31468544772286133,2003,2003.csv
819,Johnny English,160466000,28082366,0.1750050851893859,132383634,0.824994914810614,2003,2003.csv
820,"Three Billboards Outside Ebbing, Missouri",160192031,54513740,0.3403024461310438,105678291,0.6596975538689562,2017,2017.csv
821,Underworld Awakening,160112671,62321039,0.3892323987275186,97791632,0.6107676012724814,2012,2012.csv
822,Lara Croft Tomb Raider: The Cradle of Life,160099222,65660196,0.41012189303455826,94439026,0.5898781069654417,2003,2003.csv
823,Johnny English Reborn,160078586,8305970,0.051886827636021225,151772616,0.9481131723639787,2011,2011.csv
824,Norbit,159814490,95673607,0.5986541458161898,64140883,0.40134585418381025,2007,2007.csv
825,21,159808370,81159365,0.5078542819753433,78649005,0.4921457180246567,2008,2008.csv
826,Step Up 3D,159291809,42400223,0.26617955603731014,116891586,0.7338204439626899,2010,2010.csv
827,Happy Feet Two,159196259,64006466,0.4020601137367179,95189793,0.5979398862632821,2011,2011.csv
828,Johnny English Strikes Again,158970776,4412170,0.02775459811556811,154558606,0.9722454018844319,2018,2018.csv
829,The Fast and the Furious: Tokyo Drift,158964610,62514415,0.3932599526397731,96450195,0.6067400473602269,2006,2006.csv
830,Focus,158762963,53862963,0.3392665517334795,104900000,0.6607334482665205,2015,2015.csv
831,Sin City,158733820,74103820,0.4668432977924931,84630000,0.5331567022075069,2005,2005.csv
832,Goosebumps,158260952,80080379,0.5060021312142745,78180573,0.4939978687857255,2015,2015.csv
833,Final Destination 5,157887643,42587643,0.26973385751283907,115300000,0.7302661424871609,2011,2011.csv
834,Don't Breathe,157830487,89217875,0.565276561555563,68612612,0.4347234384444369,2016,2016.csv
835,Hustlers,157563598,104963598,0.6661665469203109,52600000,0.33383345307968915,2019,2019.csv
836,The Book of Eli,157107755,94835059,0.6036306673722122,62272696,0.39636933262778784,2010,2010.csv
837,Ip Man 3,156954938,2679437,0.01707137751855886,154275501,0.9829286224814411,2015,2015.csv
838,P.S. I Love You,156835339,53695808,0.3423705928929704,103139531,0.6576294071070297,2007,2007.csv
839,The Climbers,156759167,487157,0.0031076779069641267,156272010,0.9968923220930359,2019,2019.csv
840,Mystic River,156595191,90135191,0.5755936081076717,66460000,0.4244063918923283,2003,2003.csv
841,This Means War,156491279,54760791,0.3499287075288074,101730488,0.6500712924711926,2012,2012.csv
842,Rocky Balboa,155929020,70270943,0.45065981303544395,85658077,0.549340186964556,2006,2006.csv
843,The Hateful Eight,155760117,54117416,0.3474407765114866,101642701,0.6525592234885135,2015,2015.csv
844,Escape Room,155712077,57005601,0.36609620845273294,98706476,0.6339037915472671,2019,2019.csv
845,The Monuments Men,155641650,78031620,0.5013543611237737,77610030,0.49864563887622626,2014,2014.csv
846,Hannah Montana: The Movie,155545279,79576189,0.5115950127936701,75969090,0.4884049872063298,2009,2009.csv
847,Monster-in-Law,155457327,82931301,0.5334666599535705,72526026,0.4665333400464296,2005,2005.csv
848,Dreamgirls,155430335,103365956,0.6650307740763732,52064379,0.3349692259236268,2006,2006.csv
849,The Accountant,155160045,86260045,0.5559423819450426,68900000,0.44405761805495736,2016,2016.csv
850,Blade II,155010032,82348319,0.5312450938659248,72661713,0.4687549061340752,2002,2002.csv
851,Maid in Manhattan,154906693,94011225,0.6068893679113013,60895468,0.39311063208869873,2002,2002.csv
852,Lone Survivor,154802912,125095601,0.8080959161801814,29707311,0.19190408381981858,2013,2013.csv
853,The Phantom of the Opera,154648887,51268815,0.331517516837997,103380072,0.668482483162003,2004,2004.csv
854,Ride Along,154468902,134938200,0.8735622397315933,19530702,0.12643776026840664,2014,2014.csv
855,Kill Bill: Vol. 2,154116796,66208183,0.4295974528305143,87908613,0.5704025471694857,2004,2004.csv
856,The Town,154026136,92186262,0.598510515124524,61839874,0.4014894848754759,2010,2010.csv
857,Midnight in Paris,153959590,56817045,0.36903868735945583,97142545,0.6309613126405442,2011,2011.csv
858,Sweeney Todd: The Demon Barber of Fleet Street,153383627,52898073,0.34487431308427724,100485554,0.6551256869157227,2007,2007.csv
859,Yesterday,153089026,73286650,0.47871916044458995,79802376,0.52128083955541,2019,2019.csv
860,Tower Heist,152930623,78046570,0.5103397113604906,74884053,0.48966028863950944,2011,2011.csv
861,Duckweed,152894264,471575,0.0030843210704098096,152422689,0.9969156789295902,2017,2017.csv
862,Chocolat,152699946,71509363,0.4682998578139641,81190583,0.5317001421860359,2000,2000.csv
863,Date Night,152263880,98711404,0.6482916631311378,53552476,0.35170833686886216,2010,2010.csv
864,Vantage Point,152039882,72266306,0.4753115106995413,79773576,0.5246884893004586,2008,2008.csv
865,Surf's Up,152005713,58867694,0.3872729046703659,93138019,0.6127270953296341,2007,2007.csv
866,Jackass Presents: Bad Grandpa,151826547,102003019,0.6718391547164674,49823528,0.3281608452835327,2013,2013.csv
867,47 Ronin,151783839,38362475,0.25274413437388416,113421364,0.7472558656261158,2013,2013.csv
868,Red Sparrow,151572634,46874505,0.30925440670246584,104698129,0.6907455932975342,2018,2018.csv
869,Darkest Hour,150847207,56468410,0.37434176689794463,94378797,0.6256582331020554,2017,2017.csv
870,Step Up 2: The Streets,150816700,58017783,0.3846907073288303,92798917,0.6153092926711697,2008,2008.csv
871,Gods of Egypt,150680864,31153464,0.20675129656808977,119527400,0.7932487034319102,2015,2015.csv
872,The Taking of Pelham 123,150166126,65452312,0.4358660221413716,84713814,0.5641339778586284,2009,2009.csv
873,I Am Number Four,149878437,55100437,0.36763418476268206,94778000,0.6323658152373179,2011,2011.csv
874,Jack and Jill,149673788,74158157,0.49546522467915355,75515631,0.5045347753208465,2011,2011.csv
875,Friends with Benefits,149542245,55802754,0.37315712359407205,93739491,0.626842876405928,2011,2011.csv
876,Beverly Hills Chihuahua,149292488,94514402,0.633082101224008,54778086,0.366917898775992,2008,2008.csv
877,"Me, Myself & Irene",149270999,90570999,0.606755495754403,58700000,0.393244504245597,2000,2000.csv
878,No Strings Attached,149228077,70662220,0.473518264260686,78565857,0.526481735739314,2011,2011.csv
879,Charlotte's Web,148963822,82985708,0.5570863239532079,65978114,0.4429136760467921,2006,2006.csv
880,Lights Out,148868835,67268835,0.4518664702387172,81600000,0.5481335297612828,2016,2016.csv
881,The Secret World of Arrietty,148800274,19202743,0.12905045457107156,129597531,0.8709495454289284,2010,2010.csv
882,King Arthur: Legend of the Sword,148675066,39175066,0.2634945257061463,109500000,0.7365054742938537,2017,2017.csv
883,Seabiscuit,148336445,120277854,0.8108449275564074,28058591,0.18915507244359267,2003,2003.csv
884,RED 2,148075565,53262560,0.35969850933879605,94813005,0.640301490661204,2013,2013.csv
885,Spy Kids,147934180,112719001,0.7619537351002993,35215179,0.23804626489970065,2001,2001.csv
886,The Game Plan,147880543,90648202,0.6129826152991608,57232341,0.38701738470083924,2007,2007.csv
887,The Mexican,147845033,66845033,0.4521290410885836,81000000,0.5478709589114164,2001,2001.csv
888,The Angry Birds Movie 2,147792047,41667116,0.2819307049722371,106124931,0.7180692950277628,2016,2016.csv
889,Saw II,147748505,87039965,0.5891089388687892,60708540,0.41089106113121077,2005,2005.csv
890,Resident Evil: Extinction,147717833,50648679,0.3428745058831184,97069154,0.6571254941168816,2007,2007.csv
891,Arthur Christmas,147419472,46462469,0.31517185870805453,100957003,0.6848281412919455,2011,2011.csv
892,Source Code,147332697,54712227,0.3713515608826464,92620470,0.6286484391173536,2011,2011.csv
893,Swordfish,147080413,69772969,0.4743865452703073,77307444,0.5256134547296927,2001,2001.csv
894,Planes: Fire & Rescue,146965787,59165787,0.402582044486313,87800000,0.597417955513687,2014,2014.csv
895,The Last Witch Hunter,146936910,27367660,0.18625449521158435,119569250,0.8137455047884157,2015,2015.csv
896,Angel Has Fallen,146661977,69030436,0.470677113537069,77631541,0.529322886462931,2019,2019.csv
897,Mama,146428180,71628180,0.4891693661698179,74800000,0.5108306338301821,2013,2013.csv
898,Music and Lyrics,145896422,50572589,0.3466335109986453,95323833,0.6533664890013546,2007,2007.csv
899,Blades of Glory,145710347,118594548,0.8139061531436749,27115799,0.18609384685632518,2007,2007.csv
900,The Foreigner,145374099,34393507,0.23658620921186244,110980592,0.7634137907881375,2017,2017.csv
901,Home on the Range,145358062,50030461,0.344187727268956,95327601,0.655812272731044,2004,2004.csv
902,The Exorcism of Emily Rose,145166804,75072454,0.5171461514024929,70094350,0.4828538485975072,2005,2005.csv
903,"Crazy, Stupid, Love",145051197,84351197,0.5815270659227997,60700000,0.4184729340772003,2011,2011.csv
904,Herbie Fully Loaded,144146816,66023816,0.4580317334237893,78123000,0.5419682665762108,2005,2005.csv
905,The Beach,144056873,39785027,0.2761758336931276,104271846,0.7238241663068724,2000,2000.csv
906,Pete's Dragon,143695338,76233151,0.5305193060612725,67462187,0.4694806939387275,2016,2016.csv
907,Garfield: A Tail of Two Kitties,143325970,28426747,0.19833633081290153,114899223,0.8016636691870985,2006,2006.csv
908,Spy Game,143049560,62362560,0.435950729243767,80687000,0.564049270756233,2001,2001.csv
909,More Than Blue,142958164,722669,0.005055108290282743,142235495,0.9949448917097172,2018,2018.csv
910,Paranormal Activity 4,142802657,53885000,0.3773389174404507,88917657,0.6226610825595493,2012,2012.csv
911,The Legend of Zorro,142400065,46464023,0.32629214740878104,95936042,0.673707852591219,2005,2005.csv
912,Power Rangers,142337240,85364450,0.5997337731151735,56972790,0.4002662268848265,2017,2017.csv
913,New Year's Eve,142044638,54544638,0.3839964589159641,87500000,0.6160035410840359,2011,2011.csv
914,Monster House,141861243,73661010,0.519246895362393,68200233,0.48075310463760706,2006,2006.csv
915,Legally Blonde,141774679,96520674,0.6808033330126602,45254005,0.31919666698733984,2001,2001.csv
916,The Taking of Tiger Mountain,141654055,228984,0.0016165015537324364,141425071,0.9983834984462676,2014,2014.csv
917,Gothika,141591324,59694580,0.42159772444814486,81896744,0.5784022755518552,2003,2003.csv
918,Big Momma's House 2,141522961,70165972,0.495792142166952,71356989,0.504207857833048,2006,2006.csv
919,Mona Lisa Smile,141337989,63860942,0.4518314039405216,77477047,0.5481685960594784,2003,2003.csv
920,Scary Movie 2,141220678,71308997,0.5049472783298774,69911681,0.49505272167012254,2001,2001.csv
921,Shallow Hal,141069860,70839203,0.5021568958812321,70230657,0.4978431041187678,2001,2001.csv
922,Trainwreck,140795793,110212700,0.7827840424180856,30583093,0.2172159575819144,2015,2015.csv
923,Sausage Party,140705322,97685686,0.6942572221966131,43019636,0.3057427778033869,2016,2016.csv
924,Girls Trip,140552359,115171585,0.8194212165446473,25380774,0.18057878345535275,2017,2017.csv
925,Step Up Revolution,140470746,35074677,0.24969381881121355,105396069,0.7503061811887864,2012,2012.csv
926,Lion,140312928,51738905,0.3687394008341127,88574023,0.6312605991658873,2016,2016.csv
927,The SpongeBob SquarePants Movie,140192993,85417988,0.6092885683666087,54775005,0.3907114316333913,2004,2004.csv
928,Legend of the Guardians: The Owls of Ga'Hoole,140073390,55675313,0.3974724464082721,84398077,0.6025275535917278,2010,2010.csv
929,The Wolfman,139789765,61979680,0.4433778109577622,77810085,0.5566221890422378,2010,2010.csv
930,Saw IV,139352633,63300095,0.4542439826020367,76052538,0.5457560173979633,2007,2007.csv
931,Mr. Six,139191345,1415450,0.010169094924688026,137775895,0.989830905075312,2015,2015.csv
932,Brüno,138805831,60054530,0.4326513487751102,78751301,0.5673486512248899,2009,2009.csv
933,The Admiral: Roaring Currents,138342258,2589811,0.018720317547513212,135752447,0.9812796824524868,2014,2014.csv
934,America's Sweethearts,138307673,93607673,0.676807518842429,44700000,0.32319248115757104,2001,2001.csv
935,Let's Be Cops,138224951,82390774,0.5960629640592168,55834177,0.40393703594078323,2014,2014.csv
936,Bridge to Terabithia,137587063,82272442,0.5979664090947272,55314621,0.40203359090527285,2007,2007.csv
937,Stardust,137515140,38634938,0.28095043207606085,98880202,0.7190495679239391,2007,2007.csv
938,Escape Plan,137328301,25135965,0.18303557836923942,112192336,0.8169644216307606,2013,2013.csv
939,The First Purge,137056262,69488745,0.5070089026650968,67567517,0.49299109733490326,2018,2018.csv
940,Annie,136853506,85911262,0.6277607677804031,50942244,0.3722392322195969,2014,2014.csv
941,The Best Exotic Marigold Hotel,136836156,46412041,0.3391796609662142,90424115,0.6608203390337858,2012,2012.csv
942,How Long Will I Love U,136796719,746933,0.005460167505918033,136049786,0.994539832494082,2018,2018.csv
943,Remember the Titans,136706683,115654751,0.8460065628247304,21051932,0.15399343717526962,2000,2000.csv
944,Contagion,136515867,75658097,0.5542073508568788,60857770,0.4457926491431212,2011,2011.csv
945,The Wind Rises,136454220,5209580,0.03817822563494189,131244640,0.9618217743650581,2012,2012.csv
946,The Bounty Hunter,136333522,67061228,0.49189096721201114,69272294,0.5081090327879888,2010,2010.csv
947,17 Again,136316880,64167069,0.4707199064415207,72149811,0.5292800935584794,2009,2009.csv
948,Saw: The Final Chapter,136150434,45710178,0.3357328849939619,90440256,0.6642671150060381,2010,2010.csv
949,Unknown,135710029,63686397,0.4692829076029451,72023632,0.5307170923970549,2011,2011.csv
950,The Jungle Book 2,135703599,47901582,0.35298682093169836,87802017,0.6470131790683017,2003,2003.csv
951,Jack Ryan: Shadow Recruit,135503748,50577412,0.3732547087922616,84926336,0.6267452912077384,2014,2014.csv
952,Babel,135330182,34302837,0.2534751412659742,101027345,0.7465248587340257,2006,2006.csv
953,Perfume: The Story of a Murderer,135039924,2223293,0.016463968092873038,132816631,0.983536031907127,2006,2006.csv
954,American Made,134866593,51342000,0.3806873063072039,83524593,0.6193126936927961,2017,2017.csv
955,Wall Street: Money Never Sleeps,134748021,52474616,0.38942773044510987,82273405,0.6105722695548902,2010,2010.csv
956,The Princess Diaries 2: Royal Engagement,134734481,95170481,0.7063557917293644,39564000,0.29364420827063564,2004,2004.csv
957,Last Vegas,134402450,63914167,0.4755431690419334,70488283,0.5244568309580666,2012,2012.csv
958,The Cat in the Hat,133960541,101149285,0.7550677553623795,32811256,0.24493224463762056,2003,2003.csv
959,Pokémon the Movie 2000,133949270,43758684,0.32668101886632156,90190586,0.6733189811336785,2000,2000.csv
960,Point Break,133718711,28782481,0.21524647362178057,104936230,0.7847535263782194,2015,2015.csv
961,The Big Short,133440870,70259870,0.5265243699325401,63181000,0.47347563006745985,2015,2015.csv
962,The Artist,133432856,44671682,0.33478772274798646,88761174,0.6652122772520136,2011,2011.csv
963,1408,132963417,71985628,0.5413942392891422,60977789,0.4586057607108578,2007,2007.csv
964,Zero Dark Thirty,132820716,95720716,0.7206761029657452,37100000,0.2793238970342548,2012,2012.csv
965,A Wrinkle in Time,132675864,100478608,0.7573239394921144,32197256,0.2426760605078856,2018,2018.csv
966,Ghost Rider: Spirit of Vengeance,132563930,51774002,0.39055874399619867,80789928,0.6094412560038014,2012,2012.csv
967,V for Vendetta,132511035,70511035,0.5321144386201496,62000000,0.4678855613798504,2006,2006.csv
968,The Three Musketeers,132274484,20374484,0.1540318539439549,111900000,0.8459681460560451,2011,2011.csv
969,Blade: Trinity,131977904,52411906,0.39712637048698696,79565998,0.602873629513013,2004,2004.csv
970,2 Guns,131940411,75612460,0.5730803733815867,56327951,0.4269196266184134,2013,2013.csv
971,Save the Last Dance,131706809,91057006,0.6913614162499374,40649803,0.3086385837500626,2001,2001.csv
972,The House with a Clock in Its Walls,131457147,68549695,0.521460388912898,62907452,0.478539611087102,2018,2018.csv
973,Bewitched,131426169,63313159,0.4817393634900824,68113010,0.5182606365099176,2005,2005.csv
974,School of Rock,131095614,81261177,0.6198619047621227,49834437,0.3801380952378773,2003,2003.csv
975,Atonement,131016624,50927067,0.3887069094376909,80089557,0.6112930905623091,2007,2007.csv
976,Munich,130982129,47403685,0.36190956248695577,83578444,0.6380904375130443,2005,2005.csv
977,Man on Fire,130834852,77911774,0.595497092777695,52923078,0.404502907222305,2004,2004.csv
978,"You, Me and Dupree",130628903,75628110,0.5789538782240252,55000793,0.4210461217759748,2006,2006.csv
979,A Bad Moms Christmas,130560428,72110659,0.5523163496369665,58449769,0.4476836503630334,2017,2017.csv
980,About a Boy,130549455,41385278,0.317008431785487,89164177,0.682991568214513,2002,2002.csv
981,Cloud Atlas,130482868,27108272,0.2077534960375028,103374596,0.7922465039624972,2012,2012.csv
982,Aliens vs. Predator: Requiem,130290885,41797066,0.32079808192261494,88493819,0.6792019180773851,2007,2007.csv
983,Failure to Launch,130224158,88715192,0.6812498799185939,41508966,0.3187501200814061,2006,2006.csv
984,Cheaper by the Dozen 2,130154568,82571173,0.6344085672044949,47583395,0.3655914327955051,2005,2005.csv
985,Mean Girls,130125829,86058055,0.6613449125461479,44067774,0.3386550874538521,2004,2004.csv
986,Red Cliff,129708433,627047,0.004834280898297492,129081386,0.9951657191017025,2008,2008.csv
987,Julie & Julia,129540522,94125426,0.7266099020351331,35415096,0.2733900979648669,2009,2009.csv
988,Resident Evil: Apocalypse,129342769,51201453,0.3958586428592695,78141316,0.6041413571407305,2004,2004.csv
989,The Fighter,129190869,93617009,0.7246410657706777,35573860,0.27535893422932234,2009,2009.csv
990,The Woman in Black,128955898,54333290,0.4213323379749564,74622608,0.5786676620250436,2012,2012.csv
991,Space Cowboys,128884132,90464773,0.70190776472002,38419359,0.29809223527998,2000,2000.csv
992,The Forbidden Kingdom,128779982,52075270,0.4043739499823816,76704712,0.5956260500176184,2008,2008.csv
993,The Heartbreak Kid,128453183,36787257,0.2863864961602392,91665926,0.7136135038397609,2007,2007.csv
994,Pan,128388320,35088320,0.2732983810365304,93300000,0.7267016189634695,2015,2015.csv
995,Space Station 3D,128363881,93383953,0.7274939980974866,34979928,0.2725060019025134,2002,2002.csv
996,Step Brothers,128107642,100468793,0.7842529253641246,27638849,0.21574707463587536,2008,2008.csv
997,The Invisible Man,128097680,64914050,0.5067542987507658,63183630,0.49324570124923417,2020,2020.csv
998,Blended,127994610,46294610,0.36169187124364066,81700000,0.6383081287563593,2014,2014.csv
999,Law Abiding Citizen,127944208,73357727,0.5733571542371031,54586481,0.4266428457628969,2009,2009.csv
1000,The Adjustment Bureau,127869379,62495645,0.4887459803804944,65373734,0.5112540196195057,2010,2010.csv
1001,U-571,127666415,77122415,0.6040932143351875,50544000,0.39590678566481247,2000,2000.csv
1002,Ad Astra,127461872,50188370,0.393752023350167,77273502,0.606247976649833,2019,2019.csv
1003,March of the Penguins,127392693,77437223,0.60786235989218,49955470,0.39213764010782,2005,2005.csv
1004,Predators,127233108,52000688,0.40870406152461514,75232420,0.5912959384753849,2010,2010.csv
1005,Chronicle,126636097,64575175,0.5099270786906833,62060922,0.49007292130931673,2012,2012.csv
1006,Walking with Dinosaurs 3D,126546518,36076121,0.2850818937586256,90470397,0.7149181062413744,2012,2012.csv
1007,Sex Tape,126069509,38543473,0.30573191968249835,87526036,0.6942680803175016,2014,2014.csv
1008,This Is the End,126041322,101470202,0.8050550437736602,24571120,0.1949449562263398,2013,2013.csv
1009,The Upside,125852517,108252517,0.860153770305603,17600000,0.13984622969439697,2019,2019.csv
1010,Detective Chinatown,125842935,474252,0.003768602504383738,125368683,0.9962313974956163,2015,2015.csv
1011,Wolf Totem,125837070,210591,0.0016735211651065938,125626479,0.9983264788348934,2015,2015.csv
1012,Mechanic: Resurrection,125729635,21218403,0.1687621458536804,104511232,0.8312378541463196,2016,2016.csv
1013,Midway,125648634,56846802,0.45242674106588376,68801832,0.5475732589341162,2019,2019.csv
1014,Ender's Game,125544024,61737191,0.49175730578780874,63806833,0.5082426942121913,2013,2013.csv
1015,Happy Death Day,125479266,55683845,0.44376929173302626,69795421,0.5562307082669737,2017,2017.csv
1016,Captain Underpants: The First Epic Movie,125427681,73921000,0.5893515642691345,51506681,0.4106484357308655,2017,2017.csv
1017,Legally Blonde 2,124914842,90186328,0.7219824846754399,34728514,0.2780175153245601,2003,2003.csv
1018,The Family Man,124745083,75793305,0.6075855110056723,48951778,0.39241448899432774,2000,2000.csv
1019,Ride Along 2,124605297,91221830,0.7320862932496361,33383467,0.2679137067503639,2015,2015.csv
1020,Coraline,124596837,75286229,0.6042386854491338,49310608,0.39576131455086616,2009,2009.csv
1021,Ray,123971376,75331600,0.6076531731002163,48639776,0.39234682689978373,2004,2004.csv
1022,The Time Machine,123729176,56832494,0.4593297703687932,66896682,0.5406702296312068,2002,2002.csv
1023,The Theory of Everything,123726688,35893537,0.2901034334645731,87833151,0.7098965665354269,2014,2014.csv
1024,The Queen,123384128,56441711,0.4574470956264326,66942417,0.5425529043735674,2006,2006.csv
1025,Nanny McPhee,123276807,47144110,0.3824248141014879,76132697,0.6175751858985121,2005,2005.csv
1026,Big Fish,123218424,66809693,0.5422053848051165,56408731,0.4577946151948835,2003,2003.csv
1027,Hide and Seek,123204920,51100486,0.41476010860605245,72104434,0.5852398913939476,2005,2005.csv
1028,The Curse of la Llorona,123133739,54733739,0.4445064321485438,68400000,0.5554935678514562,2019,2019.csv
1029,The Lego Ninjago Movie,123081555,59281555,0.4816445079849698,63800000,0.5183554920150302,2017,2017.csv
1030,The Pirates! Band of Misfits,123054041,31051126,0.25233731251458863,92002915,0.7476626874854114,2012,2012.csv
1031,Looking Up,122994583,84267,0.0006851277344466463,122910316,0.9993148722655534,2019,2019.csv
1032,Zombieland: Double Tap,122810399,73123082,0.5954144160056023,49687317,0.40458558399439776,2019,2019.csv
1033,Dragon Blade,122593849,74068,0.0006041738684621934,122519781,0.9993958261315378,2015,2015.csv
1034,Spirit: Stallion of the Cimarron,122563539,73280117,0.5978949171825073,49283422,0.40210508281749274,2002,2002.csv
1035,Surrogates,122444772,38577772,0.3150626308487879,83867000,0.6849373691512121,2009,2009.csv
1036,Invictus,122233971,37491364,0.3067180399465219,84742607,0.6932819600534781,2009,2009.csv
1037,Prisoners,122126687,61002302,0.4995001788593512,61124385,0.5004998211406488,2013,2013.csv
1038,Secret Superstar,122026260,0,0.0,122026260,1.0,2017,2017.csv
1039,Peter Pan,121975011,48462608,0.3973158731668407,73512403,0.6026841268331593,2003,2003.csv
1040,Deepwater Horizon,121790373,61433527,0.5044202221139433,60356846,0.4955797778860567,2016,2016.csv
1041,Pride & Prejudice,121616555,38405088,0.31578832339067653,83211467,0.6842116766093235,2005,2005.csv
1042,Last Christmas,121550750,35150750,0.2891857927655732,86400000,0.7108142072344268,2019,2019.csv
1043,The Nut Job,120885527,64251541,0.531507307735855,56633986,0.4684926922641451,2014,2014.csv
1044,Intolerable Cruelty,120801243,35327628,0.2924442424818427,85473615,0.7075557575181574,2003,2003.csv
1045,Apocalypto,120673227,50866635,0.42152378174157884,69806592,0.5784762182584211,2006,2006.csv
1046,Instant Family,120556201,67363237,0.5587704028596588,53192964,0.4412295971403412,2018,2018.csv
1047,Eight Below,120455994,81612565,0.6775301277244866,38843429,0.3224698722755133,2006,2006.csv
1048,We Bought a Zoo,120081841,75624550,0.629775071486454,44457291,0.37022492851354605,2011,2011.csv
1049,The Pianist,120072577,32572577,0.27127407284679167,87500000,0.7287259271532084,2002,2002.csv
1050,The Omen,119974972,54607383,0.4551564554647281,65367589,0.544843544535272,2006,2006.csv
1051,The Commuter,119942387,36343858,0.3030109614210029,83598529,0.6969890385789971,2017,2017.csv
1052,Extreme Job,119932733,1565885,0.013056360518358236,118366848,0.9869436394816418,2019,2019.csv
1053,Parental Guidance,119772232,77267296,0.6451186114658028,42504936,0.35488138853419715,2012,2012.csv
1054,Road Trip,119754278,68540777,0.5723451232364325,51213501,0.4276548767635675,2000,2000.csv
1055,Spy Kids 2: Island of Lost Dreams,119723358,85846429,0.7170399363505991,33876929,0.2829600636494008,2002,2002.csv
1056,Dora and the Lost City of Gold,119682635,60477943,0.505319280445321,59204692,0.4946807195546789,2019,2019.csv
1057,Wonder Park,119559110,45216793,0.37819613244026323,74342317,0.6218038675597368,2019,2019.csv
1058,Allied,119520023,40098064,0.33549243878575896,79421959,0.664507561214241,2016,2016.csv
1059,Charlie Wilson's War,119483446,66661095,0.5579107167699198,52822351,0.44208928323008023,2007,2007.csv
1060,Sahara,119240351,68671925,0.5759117985152526,50568426,0.4240882014847474,2005,2005.csv
1061,Unfaithful,119137784,52775765,0.442980918631154,66362019,0.557019081368846,2002,2002.csv
1062,I Belonged to You,119107580,744541,0.006250995948368693,118363039,0.9937490040516314,2016,2016.csv
1063,The Shallows,119100758,55124043,0.46283536667331704,63976715,0.537164633326683,2016,2016.csv
1064,Final Destination 3,118890272,54098051,0.4550250419142787,64792221,0.5449749580857213,2006,2006.csv
1065,Lost in Translation,118685453,44585453,0.3756606380396088,74100000,0.6243393619603912,2003,2003.csv
1066,The Purge: Election Year,118587880,79213375,0.6679719293405025,39374505,0.3320280706594974,2016,2016.csv
1067,Jurassic Park 2013 Re-release,118192315,45385935,0.38400072796611184,72806380,0.6159992720338882,2013,2013.csv
1068,A Cool Fish,118153135,551876,0.004670853634141828,117601259,0.9953291463658581,2018,2018.csv
1069,Disturbia,118114220,80209692,0.6790858204879988,37904528,0.3209141795120012,2007,2007.csv
1070,Why Him?,118102725,60323786,0.5107738707976467,57778939,0.4892261292023533,2016,2016.csv
1071,Corpse Bride,118090836,53359111,0.4518480248543587,64731725,0.5481519751456413,2005,2005.csv
1072,P Storm,117991727,326711,0.0027689314183866466,117665016,0.9972310685816134,2019,2019.csv
1073,Saving Mr. Banks,117867984,83301580,0.7067362753909493,34566404,0.29326372460905076,2013,2013.csv
1074,Pompeii,117831631,23219748,0.19705869979852864,94611883,0.8029413002014714,2014,2014.csv
1075,Magic Mike XXL,117813057,66013057,0.5603203811271954,51800000,0.43967961887280455,2015,2015.csv
1076,Game Night,117679066,69179066,0.5878621266419637,48500000,0.41213787335803637,2018,2018.csv
1077,The Forgotten,117592831,67133509,0.5708979742140914,50459322,0.42910202578590867,2004,2004.csv
1078,A Knight's Tale,117487473,56569702,0.4814956059187689,60917771,0.5185043940812311,2001,2001.csv
1079,Hotel for Dogs,117252578,73034460,0.6228814858126189,44218118,0.377118514187381,2009,2009.csv
1080,Paycheck,117248958,53790451,0.4587712498050516,63458507,0.5412287501949484,2003,2003.csv
1081,Water for Elephants,117094902,58709717,0.5013857648559286,58385185,0.49861423514407144,2011,2011.csv
1082,Warm Bodies,116980662,66380662,0.5674498747493838,50600000,0.4325501252506162,2013,2013.csv
1083,Barnyard,116755080,72637803,0.6221382658467624,44117277,0.3778617341532377,2006,2006.csv
1084,Finding Neverland,116650613,51680613,0.4430376461030685,64970000,0.5569623538969315,2004,2004.csv
1085,Freddy vs. Jason,116632628,82622655,0.7084008687517527,34009973,0.29159913124824727,2003,2003.csv
1086,Abraham Lincoln: Vampire Hunter,116471580,37519139,0.32213127872052566,78952441,0.6778687212794744,2012,2012.csv
1087,Personal Tailor,116126458,375892,0.0032369195312923434,115750566,0.9967630804687077,2013,2013.csv
1088,Body of Lies,115900897,39394666,0.33989957817151323,76506231,0.6601004218284868,2008,2008.csv
1089,The Chronicles of Riddick,115900534,57761012,0.49836709121633554,58139522,0.5016329087836644,2004,2004.csv
1090,The Iron Lady,115890699,30017992,0.25901985456140875,85872707,0.7409801454385913,2011,2011.csv
1091,The Notebook,115882795,81001787,0.6989975259053771,34881008,0.30100247409462294,2004,2004.csv
1092,A Nightmare on Elm Street,115694863,63075011,0.5451841971583474,52619852,0.4548158028416525,2010,2010.csv
1093,Dragon Ball Super: Broly,115560610,30712119,0.2657663281632037,84848491,0.7342336718367963,2018,2018.csv
1094,Closer,115505027,33987757,0.2942534873395597,81517270,0.7057465126604403,2004,2004.csv
1095,Bride Wars,115375850,58715510,0.5089064132571938,56660340,0.49109358674280623,2009,2009.csv
1096,Pitch Perfect,115350426,65001093,0.5635097784554346,50349333,0.4364902215445654,2012,2012.csv
1097,The Monkey King 3,115084576,187074,0.0016255349457081026,114897502,0.998374465054292,2018,2018.csv
1098,Snow Dogs,115035090,81172560,0.7056330377104933,33862530,0.2943669622895066,2002,2002.csv
1099,The Gentlemen,114996853,36296853,0.31563344607351995,78700000,0.68436655392648,2019,2019.csv
1100,Dear John,114984666,80014842,0.6958740220195969,34969824,0.3041259779804031,2010,2010.csv
1101,So Young,114926694,11186,9.733160861653256e-05,114915508,0.9999026683913834,2013,2013.csv
1102,The Lake House,114830111,52330111,0.455717673215521,62500000,0.5442823267844791,2006,2006.csv
1103,Finding Mr Right 2,114679097,0,0.0,114679097,1.0,2016,2016.csv
1104,We Were Soldiers,114660784,78122718,0.6813377274657393,36538066,0.3186622725342607,2002,2002.csv
1105,Office Christmas Party,114501299,54767494,0.47831329843690246,59733805,0.5216867015630976,2016,2016.csv
1106,Hope Springs,114281051,63536011,0.5559627816163504,50745040,0.4440372183836496,2012,2012.csv
1107,The Score,114252154,71107711,0.6223752332931947,43144443,0.3776247667068054,2001,2001.csv
1108,Step Up,114194847,65328121,0.5720759098700837,48866726,0.4279240901299163,2006,2006.csv
1109,Seventh Son,114178613,17223265,0.15084493100297164,96955348,0.8491550689970284,2014,2014.csv
1110,Coyote Ugly,113916474,60786269,0.5336038490798092,53130205,0.4663961509201909,2000,2000.csv
1111,Saw V,113864059,56746769,0.49837296771582684,57117290,0.5016270322841732,2008,2008.csv
1112,Insomnia,113714830,67355513,0.5923195154053346,46359317,0.40768048459466544,2002,2002.csv
1113,Changeling,113398237,35739802,0.31517070234522254,77658435,0.6848292976547775,2008,2008.csv
1114,Rambo,113244290,42754105,0.37753872623511525,70490185,0.6224612737648847,2008,2008.csv
1115,The Dark Tower,113231078,50701325,0.44776863291895885,62529753,0.5522313670810411,2017,2017.csv
1116,Pet Sematary,113118226,54724696,0.4837831880425706,58393530,0.5162168119574294,2019,2019.csv
1117,White Chicks,113100873,70831760,0.6262706743209666,42269113,0.37372932567903344,2004,2004.csv
1118,Insidious: Chapter 3,112983889,52218558,0.46217702773534375,60765331,0.5378229722646563,2015,2015.csv
1119,Final Destination,112880294,53331147,0.47245754870199047,59549147,0.5275424512980096,2000,2000.csv
1120,Cats & Dogs: The Revenge of Kitty Galore,112483764,43585753,0.3874848373672844,68898011,0.6125151626327155,2010,2010.csv
1121,Tooth Fairy,112462508,60022256,0.5337090295016362,52440252,0.46629097049836377,2010,2010.csv
1122,How to Be Single,112343513,46843513,0.4169667811616324,65500000,0.5830332188383677,2016,2016.csv
1123,The Exorcist 2000 Director's Cut,112053066,39671011,0.3540377110252387,72382055,0.6459622889747613,2000,2000.csv
1124,The Purge: Anarchy,111928365,71962800,0.6429362208587609,39965565,0.35706377914123916,2014,2014.csv
1125,Get Hard,111711453,90411453,0.809330203591569,21300000,0.19066979640843093,2015,2015.csv
1126,Underworld: Evolution,111476513,62318875,0.5590314347202446,49157638,0.44096856527975536,2006,2006.csv
1127,Fool's Gold,111231041,70231041,0.6313978577257044,41000000,0.36860214227429555,2008,2008.csv
1128,The Dukes of Hazzard,111069515,80270227,0.7227025975579348,30799288,0.27729740244206524,2005,2005.csv
1129,Good Boys,111026990,83140306,0.7488296854665699,27886684,0.25117031453343014,2019,2019.csv
1130,Mission to Mars,110983407,60883407,0.5485811676334643,50100000,0.4514188323665357,2000,2000.csv
1131,The Santa Clause 3: The Escape Clause,110768122,84500122,0.7628559595873622,26268000,0.23714404041263784,2006,2006.csv
1132,Free Birds,110387072,55750480,0.5050453734292364,54636592,0.49495462657076367,2013,2013.csv
1133,The Kid,110317580,69691949,0.6317392839835682,40625631,0.36826071601643184,2000,2000.csv
1134,10 Cloverfield Lane,110216998,72082998,0.6540098107190326,38134000,0.34599018928096736,2016,2016.csv
1135,Moneyball,110206216,75605492,0.6860365480654921,34600724,0.3139634519345079,2011,2011.csv
1136,Buddies in India,110155128,293194,0.002661646401064506,109861934,0.9973383535989355,2017,2017.csv
1137,Hoodwinked!,110013167,51386611,0.46709509780770153,58626556,0.5329049021922985,2005,2005.csv
1138,The 5th Wave,109906372,34916787,0.3176957474312772,74989585,0.6823042525687227,2015,2015.csv
1139,Peter Pan 2: Return to Never Land,109862682,48430258,0.4408253750805028,61432424,0.5591746249194972,2002,2002.csv
1140,Sideways,109706931,71503593,0.6517691484779572,38203338,0.34823085152204286,2004,2004.csv
1141,The Prestige,109676311,53089891,0.4840597802382321,56586420,0.5159402197617678,2006,2006.csv
1142,Treasure Planet,109578115,38176783,0.3483978803614207,71401332,0.6516021196385793,2002,2002.csv
1143,Along With the Gods: The Two Worlds,109383972,1908823,0.017450664526974757,107475149,0.9825493354730253,2017,2017.csv
1144,Billy Elliot,109280263,21995263,0.20127388419627065,87285000,0.7987261158037293,2000,2000.csv
1145,Transporter 3,108979549,31715062,0.2910184735669993,77264487,0.7089815264330007,2008,2008.csv
1146,Earth,108975160,32011576,0.293751126403485,76963584,0.706248873596515,2007,2007.csv
1147,The Reader,108902486,34194407,0.3139910598551442,74708079,0.6860089401448558,2008,2008.csv
1148,The Hours,108846072,41675994,0.382889278723811,67170078,0.617110721276189,2002,2002.csv
1149,Onward,108624752,61555145,0.566676966958691,47069607,0.43332303304130904,2020,2020.csv
1150,Sanctum,108609310,23209310,0.2136954005140075,85400000,0.7863045994859925,2010,2010.csv
1151,Cinderella Man,108539911,61649911,0.5679930122662437,46890000,0.4320069877337563,2005,2005.csv
1152,Confessions of a Shopaholic,108394089,44277350,0.40848491286273,64116739,0.59151508713727,2009,2009.csv
1153,The Boxtrolls,108255770,50837305,0.4696036525351027,57418465,0.5303963474648973,2014,2014.csv
1154,Hidalgo,108040622,67303450,0.6229457842254925,40737172,0.3770542157745075,2004,2004.csv
1155,Neighbors 2: Sorority Rising,108007109,55455765,0.5134455084803723,52551344,0.48655449151962765,2016,2016.csv
1156,Arthur and the Invisibles,107944236,15132763,0.14019056098558147,92811473,0.8598094390144185,2006,2006.csv
1157,Horrible Bosses 2,107645357,54445357,0.5057845365313806,53200000,0.49421546346861944,2014,2014.csv
1158,The Call of the Wild,107604626,62342368,0.579365128781731,45262258,0.420634871218269,2020,2020.csv
1159,Paul Blart: Mall Cop 2,107588225,71038190,0.6602784830774929,36550035,0.33972151692250707,2015,2015.csv
1160,The Amityville Horror,107516369,65233369,0.6067296506265013,42283000,0.39327034937349864,2005,2005.csv
1161,Vacation,107228221,58884188,0.5491482321617552,48344033,0.45085176783824477,2015,2015.csv
1162,Shaft,107196498,70334258,0.656124587204332,36862240,0.343875412795668,2000,2000.csv
1163,ParaNorman,107139399,56003051,0.5227120137196215,51136348,0.4772879862803785,2012,2012.csv
1164,The Texas Chainsaw Massacre,107071655,80571655,0.7525021911728179,26500000,0.24749780882718214,2003,2003.csv
1165,The Man from U.N.C.L.E.,107045109,45445109,0.42454166682197503,61600000,0.575458333178025,2015,2015.csv
1166,The Breakup Guru,106980263,208959,0.00195324814260365,106771304,0.9980467518573963,2014,2014.csv
1167,Hereafter,106956330,32746941,0.30617113545313307,74209389,0.693828864546867,2010,2010.csv
1168,Made of Honor,106407672,46012734,0.43241932780937076,60394938,0.5675806721906292,2008,2008.csv
1169,Race to Witch Mountain,106387141,67172594,0.6313976799132143,39214547,0.3686023200867857,2009,2009.csv
1170,The Whole Nine Yards,106371651,57262492,0.5383247459419428,49109159,0.46167525405805726,2000,2000.csv
1171,Shaun the Sheep Movie,106209378,19375982,0.18243193176406702,86833396,0.817568068235933,2015,2015.csv
1172,About Schmidt,105834556,65016287,0.6143200241705554,40818269,0.3856799758294446,2002,2002.csv
1173,Forgetting Sarah Marshall,105833257,63172463,0.5969055927287582,42660794,0.4030944072712418,2008,2008.csv
1174,Life as We Know It,105734416,53374681,0.50479950634049,52359735,0.4952004936595101,2010,2010.csv
1175,First Man,105697415,44936545,0.4251432733714443,60760870,0.5748567266285557,2018,2018.csv
1176,Planet 51,105647102,42194060,0.39938681895883904,63453042,0.600613181041161,2009,2009.csv
1177,The Brothers Grimm,105316267,37916267,0.36002289181024616,67400000,0.6399771081897538,2005,2005.csv
1178,Gangster Squad,105200903,46000903,0.4372671877160598,59200000,0.5627328122839402,2013,2013.csv
1179,Along Came a Spider,105178561,74078174,0.7043086851131192,31100387,0.2956913148868808,2001,2001.csv
1180,Sisters,105011053,87044645,0.8289093625220576,17966408,0.17109063747794245,2015,2015.csv
1181,The Campaign,104907746,86907746,0.8284206773444546,18000000,0.17157932265554537,2012,2012.csv
1182,Training Day,104876233,76631907,0.7306889731632523,28244326,0.2693110268367477,2001,2001.csv
1183,Let the Bullets Fly,104723314,63012,0.0006016998277957476,104660302,0.9993983001722042,2010,2010.csv
1184,Scary Stories to Tell in the Dark,104545505,68947075,0.6594934425922951,35598430,0.3405065574077049,2019,2019.csv
1185,The Hitchhiker's Guide to the Galaxy,104478416,51085416,0.48895664727535687,53393000,0.5110433527246432,2005,2005.csv
1186,Book Club,104438188,68566296,0.6565251400187065,35871892,0.34347485998129346,2018,2018.csv
1187,The Girl with the Dragon Tattoo,104414200,10095170,0.09668388016189369,94319030,0.9033161198381063,2009,2009.csv
1188,The Tuxedo,104391623,50547998,0.4842150792118636,53843625,0.5157849207881364,2002,2002.csv
1189,The Cell,104155843,61334059,0.5888681540410555,42821784,0.4111318459589444,2000,2000.csv
1190,Little Man,104003322,58645052,0.5638767192455642,45358270,0.4361232807544359,2006,2006.csv
1191,The Water Horse,103967384,40946255,0.3938375038848722,63021129,0.6061624961151278,2007,2007.csv
1192,Ouija,103590271,50856010,0.49093423068658637,52734261,0.5090657693134136,2014,2014.csv
1193,The Stepford Wives,103370127,59484742,0.5754538929801257,43885385,0.42454610701987433,2004,2004.csv
1194,Rugrats in Paris: The Movie,103291131,76507756,0.7407001478181123,26783375,0.2592998521818877,2000,2000.csv
1195,Birdman or (The Unexpected Virtue of Ignorance),103215094,42340598,0.41021711417518064,60874496,0.5897828858248194,2014,2014.csv
1196,Cold War II,103197501,560824,0.00543447268165922,102636677,0.9945655273183408,2016,2016.csv
1197,Guess Who,103121466,68915888,0.6682981795468268,34205578,0.33170182045317315,2005,2005.csv
1198,Night School,103105878,77339130,0.75009428657404,25766748,0.24990571342596005,2018,2018.csv
1199,Saw,103096345,55185045,0.5352764445723076,47911300,0.4647235554276924,2004,2004.csv
1200,Transcendence,103039258,23022309,0.22343240282262125,80016949,0.7765675971773788,2014,2014.csv
1201,Jimmy Neutron: Boy Genius,102992536,80936232,0.7858456072972123,22056304,0.21415439270278772,2001,2001.csv
1202,Resident Evil,102984862,40119709,0.3895689931594024,62865153,0.6104310068405976,2002,2002.csv
1203,Jigsaw,102952888,38052832,0.3696140316141496,64900056,0.6303859683858505,2017,2017.csv
1204,Just Like Heaven,102854431,48318130,0.4697719828910434,54536301,0.5302280171089566,2005,2005.csv
1205,Love & Other Drugs,102820008,32367005,0.31479286599549766,70453003,0.6852071340045023,2010,2010.csv
1206,Chappie,102811889,31569268,0.3070585348354022,71242621,0.6929414651645979,2015,2015.csv
1207,Star Wars: Episode I - The Phantom Menace 2012 3D Release,102739593,43456382,0.4229759991359903,59283211,0.5770240008640096,2012,2012.csv
1208,Project X,102731865,54731865,0.5327642499238187,48000000,0.46723575007618134,2012,2012.csv
1209,Zombieland,102392080,75590286,0.7382434852383114,26801794,0.2617565147616886,2009,2009.csv
1210,Ghosts of Girlfriends Past,102366815,55250026,0.5397259453661815,47116789,0.4602740546338186,2009,2009.csv
1211,The Wild,102338515,37384046,0.36529791349815854,64954469,0.6347020865018415,2006,2006.csv
1212,Dawn of the Dead,102278712,59020957,0.5770600337634287,43257755,0.4229399662365713,2004,2004.csv
1213,John Q,102244770,71756802,0.7018139118509436,30487968,0.29818608814905645,2002,2002.csv
1214,Railroad Tigers,102205175,218044,0.002133394908819441,101987131,0.9978666050911805,2016,2016.csv
1215,Heaven Is for Real,101888019,91443253,0.8974877900020806,10444766,0.10251220999791938,2014,2014.csv
1216,The Devil Inside,101758490,53261944,0.5234152354265477,48496546,0.4765847645734523,2012,2012.csv
1217,Pineapple Express,101624843,87341380,0.8594491014367422,14283463,0.1405508985632578,2008,2008.csv
1218,Just Married,101564935,56127162,0.5526234226408947,45437773,0.4473765773591053,2003,2003.csv
1219,Miss Congeniality 2: Armed & Fabulous,101393569,48478006,0.4781171673718281,52915563,0.5218828326281719,2005,2005.csv
1220,The Time Traveler's Wife,101344412,63414846,0.625735990258644,37929566,0.37426400974135604,2009,2009.csv
1221,Hitman,101276318,39687694,0.3918753641892866,61588624,0.6081246358107134,2007,2007.csv
1222,The Recruit,101191884,52802140,0.5218021239727091,48389744,0.47819787602729086,2003,2003.csv
1223,Joy,101134059,56451232,0.5581822044737669,44682827,0.4418177955262332,2015,2015.csv
1224,Little Miss Sunshine,101058954,59891098,0.5926352453638101,41167856,0.4073647546361899,2006,2006.csv
1225,Kung Fu Hustle,100912445,17108591,0.16953896023429024,83803854,0.8304610397657097,2004,2004.csv
1226,My Bloody Valentine,100734718,51545952,0.5116999682274387,49188766,0.48830003177256126,2009,2009.csv
1227,"Alexander and the Terrible, Horrible, No Good, Very Bad Day",100654149,66954149,0.665190155251325,33700000,0.334809844748675,2014,2014.csv
1228,Silent Hill,100605135,46982632,0.46700033750762326,53622503,0.5329996624923767,2006,2006.csv
1229,Ladder 49,100572044,74541707,0.7411772102394578,26030337,0.2588227897605422,2004,2004.csv
1230,Life,100541806,30234022,0.30071095003008,70307784,0.69928904996992,2017,2017.csv
1231,Instructions Not Included,100486616,44467206,0.44251869323572407,56019410,0.557481306764276,2013,2013.csv
1232,Tammy,100375432,84525432,0.8420928340313395,15850000,0.15790716596866053,2014,2014.csv
1233,PK,100370104,10616104,0.10576958254422054,89754000,0.8942304174557795,2014,2014.csv
1234,Aftershock,100293273,62962,0.0006277788940041871,100230311,0.9993722211059958,2010,2010.csv
1235,The Good Shepherd,100266865,59952835,0.5979326769616263,40314030,0.40206732303837367,2006,2006.csv
1236,Where the Wild Things Are,100140096,77233467,0.7712541737527394,22906629,0.22874582624726064,2009,2009.csv
1237,Philomena,100129872,37709979,0.376610678180034,62419893,0.623389321819966,2013,2013.csv
1238,Nim's Island,100104565,48006762,0.4795661616430779,52097803,0.520433838356922,2008,2008.csv
1239,Don't Say a Word,100020092,55001642,0.5499059328999617,45018450,0.45009406710003824,2001,2001.csv
1240,Atomic Blonde,100014025,51687870,0.5168062179279356,48326155,0.48319378207206437,2017,2017.csv
1241,The Book of Life,99783556,50151543,0.5026032846534353,49632013,0.4973967153465647,2014,2014.csv
1242,Black Mass,99775678,62575678,0.6271636460340565,37200000,0.3728363539659435,2015,2015.csv
1243,Insidious,99557032,54009150,0.5424945773795266,45547882,0.45750542262047345,2011,2011.csv
1244,Line Walker 2: Invisible Spy,99482027,296751,0.002982960932229497,99185276,0.9970170390677705,2019,2019.csv
1245,The Lucky One,99357138,60457138,0.6084830865397914,38900000,0.39151691346020856,2012,2012.csv
1246,Hellboy,99318987,59623958,0.600327890980201,39695029,0.399672109019799,2004,2004.csv
1247,Shanghai Noon,99274467,56937502,0.5735362145031713,42336965,0.42646378549682873,2000,2000.csv
1248,Nacho Libre,99255460,80197993,0.8079957817937673,19057467,0.19200421820623267,2006,2006.csv
1249,Blue Jasmine,99104804,33405481,0.3370722674553698,65699323,0.6629277325446302,2013,2013.csv
1250,Ode To My Father,99085291,2300121,0.023213546398122804,96785170,0.9767864536018772,2014,2014.csv
1251,Justin Bieber: Never Say Never,99036827,73013910,0.7372399965923787,26022917,0.2627600034076213,2011,2011.csv
1252,Young Detective Dee: Rise of the Sea Dragon,98774891,87783,0.0008887177612780155,98687108,0.999111282238722,2013,2013.csv
1253,Spotlight,98690254,45055776,0.45653723821604514,53634478,0.5434627617839549,2015,2015.csv
1254,Devil and Angel,98599942,131058,0.0013291894228497619,98468884,0.9986708105771502,2015,2015.csv
1255,The Visit,98450062,65206105,0.6623267032579421,33243957,0.3376732967420579,2015,2015.csv
1256,Crash,98410061,54580300,0.5546211377716757,43829761,0.4453788622283244,2005,2005.csv
1257,Evolution,98376292,38345494,0.38978389224102894,60030798,0.6102161077589711,2001,2001.csv
1258,Riddick,98337295,42025135,0.4273570368190421,56312160,0.572642963180958,2013,2013.csv
1259,Deep Sea,98230905,46412757,0.47248630153616117,51818148,0.5275136984638389,2006,2006.csv
1260,Alpha,98203196,35857181,0.36513252582940375,62346015,0.6348674741705962,2018,2018.csv
1261,Killers,98159963,47059963,0.4794211566685289,51100000,0.5205788433314711,2010,2010.csv
1262,Once Upon a Time in Mexico,98096026,56359780,0.5745368318997958,41736246,0.4254631681002042,2003,2003.csv
1263,Paul,97984015,37412945,0.3818270255612612,60571070,0.6181729744387388,2011,2011.csv
1264,Along With the Gods: The Last 49 Days,97962238,1200246,0.012252129233715547,96761992,0.9877478707662845,2018,2018.csv
1265,Are We There Yet?,97918663,82674398,0.8443170634386623,15244265,0.15568293656133764,2005,2005.csv
1266,Fred Claus,97838349,72006777,0.7359770247145114,25831572,0.2640229752854885,2007,2007.csv
1267,Phone Booth,97837138,46566212,0.4759564001146477,51270926,0.5240435998853523,2003,2003.csv
1268,I Am Sam,97818139,40311852,0.4121101915463757,57506287,0.5878898084536244,2001,2001.csv
1269,A Simple Favor,97644617,53548586,0.5484028474401206,44096031,0.4515971525598795,2018,2018.csv
1270,Safe Haven,97594140,71349120,0.7310799603336839,26245020,0.26892003966631606,2013,2013.csv
1271,The Little Prince,97571250,1339152,0.013724862600407395,96232098,0.9862751373995926,2015,2015.csv
1272,Evil Dead,97542952,54239856,0.5560612518677925,43303096,0.44393874813220746,2013,2013.csv
1273,42,97470701,95020213,0.9748592348792074,2450488,0.025140765120792555,2013,2013.csv
1274,Scream 4,97138686,38180928,0.39305584183010256,58957758,0.6069441581698974,2011,2011.csv
1275,Jarhead,97076152,62658220,0.6454543027210226,34417932,0.35454569727897745,2005,2005.csv
1276,Enemy at the Gates,96976270,51401758,0.530044700626246,45574512,0.469955299373754,2001,2001.csv
1277,The Shack,96942115,57386418,0.5919658138261168,39555697,0.40803418617388326,2017,2017.csv
1278,The Butterfly Effect,96822421,57938693,0.5984016140228512,38883728,0.4015983859771488,2004,2004.csv
1279,Old Dogs,96753696,49492060,0.5115262986956075,47261636,0.48847370130439255,2009,2009.csv
1280,Christmas with the Kranks,96572480,73780539,0.7639913461888935,22791941,0.23600865381110644,2004,2004.csv
1281,The Rite,96560591,33047633,0.34224762563849676,63512958,0.6577523743615032,2011,2011.csv
1282,13 Going on 30,96455697,57231747,0.5933475033620875,39223950,0.4066524966379124,2004,2004.csv
1283,Vicky Cristina Barcelona,96409300,23216709,0.24081399823461014,73192591,0.7591860017653899,2008,2008.csv
1284,Contraband,96262212,66528000,0.6911123131057907,29734212,0.3088876868942093,2012,2012.csv
1285,Red Eye,96258201,57891803,0.6014220336405415,38366398,0.3985779663594586,2005,2005.csv
1286,Kick-Ass,96188903,48071303,0.4997593433413,48117600,0.5002406566587,2010,2010.csv
1287,The Tigger Movie,96159800,45554533,0.4737378093548448,50605267,0.5262621906451552,2000,2000.csv
1288,Assassination,96119773,1904682,0.019815714712518098,94215091,0.9801842852874819,2015,2015.csv
1289,The Manchurian Candidate,96105910,65955630,0.6862806876288877,30150280,0.3137193123711122,2004,2004.csv
1290,The 6th Day,96085477,34604280,0.36014058607420973,61481197,0.6398594139257903,2000,2000.csv
1291,Think Like a Man,96070507,91547205,0.9529168509540602,4523302,0.04708314904593977,2012,2012.csv
1292,Dolphin Tale,95932565,72286779,0.7535165874069978,23645786,0.2464834125930022,2011,2011.csv
1293,The Favourite,95918706,34366783,0.35829072798375744,61551923,0.6417092720162426,2018,2018.csv
1294,TMNT,95802916,54149098,0.5652134638574049,41653818,0.43478653614259505,2007,2007.csv
1295,Be Cool,95763716,56046979,0.5852632013569733,39716737,0.41473679864302676,2005,2005.csv
1296,Some Like It Hot,95721320,100026,0.001044970963626494,95621294,0.9989550290363735,2016,2016.csv
1297,My Sister's Keeper,95714875,49200230,0.5140290890000118,46514645,0.48597091099998824,2009,2009.csv
1298,Underworld,95708457,51970690,0.5430104259229673,43737767,0.4569895740770327,2003,2003.csv
1299,Shooter,95696996,47003582,0.49117092452933425,48693414,0.5088290754706658,2007,2007.csv
1300,Poltergeist,95437994,47425125,0.49692080703205055,48012869,0.5030791929679495,2015,2015.csv
1301,The Mortal Instruments: City of Bones,95396573,31165421,0.32669329746258285,64231152,0.6733067025374172,2013,2013.csv
1302,Truth or Dare,95330493,41411015,0.43439421843753606,53919478,0.565605781562464,2018,2018.csv
1303,Rush,95224595,26947624,0.28299016656358583,68276971,0.7170098334364142,2013,2013.csv
1304,40 Days and 40 Nights,95146283,37950822,0.3988681512655623,57195461,0.6011318487344377,2002,2002.csv
1305,The Hustle,95017038,35417038,0.3727440756467277,59600000,0.6272559243532723,2017,2017.csv
1306,The Guardian,94973540,55011732,0.5792321945670341,39961808,0.4207678054329659,2006,2006.csv
1307,Changing Lanes,94935764,66818548,0.7038290438153528,28117216,0.2961709561846471,2002,2002.csv
1308,Green Zone,94882549,35053660,0.36944264640276475,59828889,0.6305573535972353,2009,2009.csv
1309,The Wedding Planner,94728529,60400856,0.6376205419594344,34327673,0.3623794580405656,2001,2001.csv
1310,I Feel Pretty,94539426,48795601,0.5161402291568811,45743825,0.48385977084311893,2018,2018.csv
1311,Veteran,94393020,1200627,0.01271944684045494,93192393,0.9872805531595451,2015,2015.csv
1312,Masquerade,94268432,922921,0.009790350602203715,93345511,0.9902096493977963,2012,2012.csv
1313,Police Story: Lockdown,94249025,0,0.0,94249025,1.0,2013,2013.csv
1314,Fleet of Time,94244191,569280,0.006040478399353017,93674911,0.9939595216006469,2014,2014.csv
1315,Dirty Grandpa,94073028,35593113,0.378356195784407,58479915,0.6216438042155931,2016,2016.csv
1316,Ben-Hur,94061311,26410477,0.2807793844166174,67650834,0.7192206155833827,2016,2016.csv
1317,Blockers,94017294,60311495,0.6414936277574634,33705799,0.35850637224253656,2018,2018.csv
1318,The Skeleton Key,93983911,47907715,0.5097437900833899,46076196,0.49025620991661006,2005,2005.csv
1319,Syriana,93974620,50824620,0.540833471845909,43150000,0.459166528154091,2005,2005.csv
1320,Speed Racer,93945766,43945766,0.46777803695804665,50000000,0.5322219630419533,2008,2008.csv
1321,In the Heart of the Sea,93920758,25020758,0.26640285420183685,68900000,0.7335971457981632,2015,2015.csv
1322,Nothing to Declare,93811164,0,0.0,93811164,1.0,2011,2011.csv
1323,Kill Zone 2,93638358,11998,0.00012813125151126635,93626360,0.9998718687484888,2015,2015.csv
1324,The Lovely Bones,93621340,44114232,0.47119846821248235,49507108,0.5288015317875177,2009,2009.csv
1325,The Internship,93492844,44672764,0.4778201420421011,48820080,0.5221798579578989,2013,2013.csv
1326,BlacKkKlansman,93400823,49275340,0.5275685847008008,44125483,0.47243141529919924,2018,2018.csv
1327,Calendar Girls,93400759,31041759,0.3323501792956522,62359000,0.6676498207043479,2003,2003.csv
1328,Goosebumps 2: Haunted Halloween,93320380,46700633,0.5004333780038187,46619747,0.49956662199618135,2018,2018.csv
1329,Money Monster,93282604,41012075,0.43965405382551287,52270529,0.5603459461744872,2016,2016.csv
1330,Nanny McPhee Returns,93251121,29011215,0.3111084852266816,64239906,0.6888915147733183,2010,2010.csv
1331,Michael Clayton,92991835,49033882,0.5272923370100181,43957953,0.47270766298998185,2007,2007.csv
1332,Secret Window,92913171,48022900,0.5168578306298469,44890271,0.48314216937015314,2004,2004.csv
1333,The Family Stone,92884429,60062868,0.646640870236711,32821561,0.353359129763289,2005,2005.csv
1334,House of Flying Daggers,92863945,11050094,0.11899229566437222,81813851,0.8810077043356278,2004,2004.csv
1335,Train to Busan,92688375,2129768,0.022977725092278294,90558607,0.9770222749077218,2016,2016.csv
1336,Role Models,92649419,67294270,0.7263323475347427,25355149,0.2736676524652572,2008,2008.csv
1337,No Reservations,92601050,43107979,0.4655236522696017,49493071,0.5344763477303983,2007,2007.csv
1338,Four Brothers,92374674,74494381,0.806437281716415,17880293,0.19356271828358496,2005,2005.csv
1339,Downfall,92181574,5509040,0.059762919648128375,86672534,0.9402370803518716,2004,2004.csv
1340,Underworld: Rise of the Lycans,92158961,45802315,0.4969925279431047,46356646,0.5030074720568952,2009,2009.csv
1341,Fracture,92011561,39015018,0.42402299858818826,52996543,0.5759770014118117,2007,2007.csv
1342,"I Love You, Man",91980359,71440011,0.7766876730715957,20540348,0.22331232692840436,2009,2009.csv
1343,Southpaw,91970827,52421953,0.5699845778270538,39548874,0.4300154221729462,2015,2015.csv
1344,Finding Nemo 2012 3D Release,91844526,41128283,0.44780331274179586,50716243,0.5521966872582041,2003,2003.csv
1345,Behind Enemy Lines,91753202,58856790,0.6414685124558378,32896412,0.3585314875441622,2001,2001.csv
1346,Get Him to the Greek,91720255,60974475,0.6647874561622185,30745780,0.33521254383778154,2010,2010.csv
1347,Shadow,91708374,521396,0.005685369582498541,91186978,0.9943146304175015,2018,2018.csv
1348,Season of the Witch,91627228,24827228,0.2709590647007241,66800000,0.7290409352992759,2011,2011.csv
1349,Crawl,91542097,39014193,0.4261885436161682,52527904,0.5738114563838318,2019,2019.csv
1350,Five Feet Apart,91522094,45729221,0.49965225883052894,45792873,0.500347741169471,2019,2019.csv
1351,Friday the 13th,91509154,65002019,0.7103335148306583,26507135,0.2896664851693416,2009,2009.csv
1352,Rambo: Last Blood,91490353,44819352,0.4898806325514997,46671001,0.5101193674485003,2019,2019.csv
1353,Overboard,91244913,50316123,0.551440308787406,40928790,0.448559691212594,2018,2018.csv
1354,White Noise,91196419,56386759,0.6183001440001717,34809660,0.38169985599982825,2005,2005.csv
1355,Romeo Must Die,91036760,55973336,0.6148432347548397,35063424,0.3851567652451603,2000,2000.csv
1356,Final Destination 2,90941129,46961214,0.5163913678705264,43979915,0.4836086321294736,2003,2003.csv
1357,Paranormal Activity: The Marked Ones,90894962,32462372,0.35714159823291414,58432590,0.6428584017670859,2014,2014.csv
1358,Fantasia 2000,90874570,60655420,0.667463075753756,30219150,0.33253692424624404,2000,2000.csv
1359,Drag Me to Hell,90842646,42100625,0.4634456046117371,48742021,0.5365543953882629,2009,2009.csv
1360,Racing Stripes,90754475,49772522,0.5484304988817356,40981953,0.45156950111826444,2005,2005.csv
1361,Autumn in New York,90726668,37761915,0.4162162662030088,52964753,0.5837837337969912,2000,2000.csv
1362,Anchorman: The Legend of Ron Burgundy,90649730,85288303,0.9408555657032845,5361427,0.0591444342967155,2004,2004.csv
1363,My Big Fat Greek Wedding 2,90632641,59689605,0.6585883887020351,30943036,0.34141161129796493,2016,2016.csv
1364,Madea Goes to Jail,90508336,90508336,1.0,0,0.0,2009,2009.csv
1365,Sherlock Gnomes,90497778,43242871,0.4778335110062039,47254907,0.522166488993796,2018,2018.csv
1366,Bring It On,90449929,68379000,0.7559873264245459,22070929,0.24401267357545411,2000,2000.csv
1367,Bedazzled,90383208,37886980,0.4191816249761792,52496228,0.5808183750238208,2000,2000.csv
1368,Jojo Rabbit,90335025,33370906,0.369412705647671,56964119,0.630587294352329,2019,2019.csv
1369,Red Riding Hood,90260376,37662162,0.4172613019028416,52598214,0.5827386980971584,2011,2011.csv
1370,Identity,90259536,52159536,0.5778839368285695,38100000,0.42211606317143047,2003,2003.csv
1371,Detective Dee: The Four Heavenly Kings,90040771,262963,0.0029204880975530517,89777808,0.9970795119024469,2018,2018.csv
1372,Sucker Punch,89792502,36392502,0.4052955557469598,53400000,0.5947044442530401,2011,2011.csv
1373,Burlesque,89519773,39440655,0.4405803732321797,50079118,0.5594196267678203,2010,2010.csv
1374,The Hundred-Foot Journey,89514453,54240821,0.6059448411085079,35273632,0.39405515889149206,2014,2014.csv
1375,The Host,89431890,2201923,0.024621228512558553,87229967,0.9753787714874415,2006,2006.csv
1376,The Purge,89328627,64473115,0.7217519978226017,24855512,0.2782480021773983,2013,2013.csv
1377,The Last Song,89137047,62950384,0.7062202094265025,26186663,0.29377979057349746,2010,2010.csv
1378,Transporter 2,89083229,43095856,0.4837706994208753,45987373,0.5162293005791248,2005,2005.csv
1379,Rumor Has It...,88933562,43000262,0.4835099486963088,45933300,0.5164900513036912,2005,2005.csv
1380,Kangaroo Jack,88929111,66934963,0.7526777480098727,21994148,0.24732225199012728,2003,2003.csv
1381,The Inbetweeners,88823111,36000,0.00040529992244923735,88787111,0.9995947000775508,2011,2011.csv
1382,Collateral Beauty,88528280,31016021,0.350351559976089,57512259,0.649648440023911,2016,2016.csv
1383,Shanghai Knights,88323487,60476872,0.6847201582971922,27846615,0.31527984170280776,2003,2003.csv
1384,This Is 40,88215156,67544505,0.7656791424820469,20670651,0.23432085751795304,2012,2012.csv
1385,Dhoom 3,88031955,8031955,0.09123908471645324,80000000,0.9087609152835467,2013,2013.csv
1386,Chasing the Dragon,87965942,456854,0.005193532742478902,87509088,0.9948064672575211,2017,2017.csv
1387,Deliver Us from Evil,87937815,30577122,0.3477130060600209,57360693,0.652286993939979,2014,2014.csv
1388,The Illusionist,87892388,39868642,0.45360745005585695,48023746,0.5463925499441431,2006,2006.csv
1389,State of Play,87812371,37017955,0.42155740220247556,50794416,0.5784425977975245,2009,2009.csv
1390,Gosford Park,87754044,41308615,0.47073175339930773,46445429,0.5292682466006923,2001,2001.csv
1391,Ali,87713825,58203105,0.6635567996265127,29510720,0.3364432003734873,2001,2001.csv
1392,RV,87528173,71726025,0.819462151917646,15802148,0.180537848082354,2006,2006.csv
1393,Tiger Zinda Hai,87320000,5560921,0.06368439074667888,81759079,0.9363156092533211,2017,2017.csv
1394,Pain & Gain,87305549,49875291,0.5712728637672274,37430258,0.42872713623277253,2013,2013.csv
1395,Sultan,87280000,6200000,0.07103574702108158,81080000,0.9289642529789184,2016,2016.csv
1396,Epic Movie,87238158,39739367,0.4555273507723535,47498791,0.5444726492276465,2007,2007.csv
1397,A Million Ways to Die in the West,87189756,43139300,0.49477486781818725,44050456,0.5052251321818128,2014,2014.csv
1398,Old School,87135520,75585093,0.8674429555249111,11550427,0.13255704447508893,2003,2003.csv
1399,The Shaggy Dog,87134280,61123569,0.701487049643378,26010711,0.298512950356622,2006,2006.csv
1400,The Thieves,87126367,685839,0.007871773191231536,86440528,0.9921282268087684,2012,2012.csv
1401,About Time,87100449,15322921,0.17592241114623874,71777528,0.8240775888537613,2013,2013.csv
1402,Max Payne,87066930,40689393,0.46733464703533245,46377537,0.5326653529646675,2008,2008.csv
1403,The Kingdom,87019158,47536778,0.5462794526235246,39482380,0.45372054737647544,2007,2007.csv
1404,The Tale of Despereaux,86957280,50877145,0.5850820655843881,36080135,0.4149179344156119,2008,2008.csv
1405,Dinner for Schmucks,86855739,73026337,0.8407773376955552,13829402,0.15922266230444485,2010,2010.csv
1406,Snowpiercer,86758912,4563650,0.052601512568530136,82195262,0.9473984874314698,2013,2013.csv
1407,The Lincoln Lawyer,86752352,58009200,0.6686758187259292,28743152,0.3313241812740708,2011,2011.csv
1408,Robin Hood,86489031,30824628,0.35639927564918605,55664403,0.643600724350814,2018,2018.csv
1409,Tears of the Sun,86468162,43734876,0.5057916693082941,42733286,0.49420833069170594,2003,2003.csv
1410,Sky High,86369815,63946815,0.7403838366447815,22423000,0.2596161633552185,2005,2005.csv
1411,La Vie En Rose,86274793,10301706,0.11940574577791221,75973087,0.8805942542220878,2007,2007.csv
1412,A Taxi Driver,86252940,1527829,0.01771335562590678,84725111,0.9822866443740932,2017,2017.csv
1413,War Dogs,86234523,43034523,0.4990405408747956,43200000,0.5009594591252045,2016,2016.csv
1414,Step Up All In,86165646,14904384,0.1729736233858213,71261262,0.8270263766141787,2014,2014.csv
1415,Hall Pass,86157237,45060734,0.523005792305062,41096503,0.47699420769493805,2011,2011.csv
1416,I Can Only Imagine,86075110,83482352,0.9698779589128611,2592758,0.030122041087138895,2018,2018.csv
1417,John Wick,86013056,43037835,0.5003639796265348,42975221,0.49963602037346516,2014,2014.csv
1418,The Second Best Exotic Marigold Hotel,85978266,33078266,0.38472822887588826,52900000,0.6152717711241118,2015,2015.csv
1419,Meet the Spartans,85897593,38233676,0.4451076527837049,47663917,0.5548923472162951,2008,2008.csv
1420,Date Movie,85749034,48548426,0.5661687803969897,37200608,0.43383121960301035,2006,2006.csv
1421,Match Point,85638656,23151529,0.2703397050042448,62487127,0.7296602949957552,2005,2005.csv
1422,Volver,85585177,12899867,0.15072548135292166,72685310,0.8492745186470784,2006,2006.csv
1423,Spy Kids 4-D: All the Time in the World,85564310,38538188,0.45040026618574963,47026122,0.5495997338142503,2011,2011.csv
1424,Paper Towns,85512300,32000304,0.37421872642882953,53511996,0.6257812735711704,2015,2015.csv
1425,Rat Race,85498534,56618055,0.6622108280827365,28880479,0.33778917191726354,2001,2001.csv
1426,The Possession,85446075,49130154,0.5749843278348362,36315921,0.42501567216516384,2012,2012.csv
1427,Did You Hear About the Morgans?,85280250,29580087,0.34685741423131383,55700163,0.6531425857686862,2009,2009.csv
1428,Nerve,85251425,38583626,0.4525862881470896,46667799,0.5474137118529103,2016,2016.csv
1429,Final Fantasy: The Spirits Within,85131830,32131830,0.3774361481481133,53000000,0.6225638518518867,2001,2001.csv
1430,J. Edgar,84920539,37306030,0.4393051485459837,47614509,0.5606948514540163,2011,2011.csv
1431,Going in Style,84918541,45018541,0.5301379471416025,39900000,0.46986205285839755,2017,2017.csv
1432,Sicario,84872444,46889293,0.5524678068655593,37983151,0.44753219313444065,2015,2015.csv
1433,Carrie,84790678,35266619,0.41592566343201076,49524059,0.5840743365679892,2013,2013.csv
1434,Zodiac,84785914,33080084,0.39016013910046426,51705830,0.6098398608995358,2007,2007.csv
1435,The Animal,84772742,57743062,0.6811512832745223,27029680,0.31884871672547765,2001,2001.csv
1436,Jackass Number Two,84645164,72778712,0.8598094511341486,11866452,0.14019054886585133,2006,2006.csv
1437,The Judge,84419388,47119388,0.5581583699706517,37300000,0.44184163002934823,2014,2014.csv
1438,What to Expect When You're Expecting,84384002,41152203,0.4876777828100639,43231799,0.5123222171899361,2012,2012.csv
1439,Nights in Rodanthe,84375346,41850659,0.4960057763792755,42524687,0.5039942236207244,2008,2008.csv
1440,Leap!,84197417,2844490,0.0337835779451524,81352927,0.9662164220548476,2016,2016.csv
1441,Premonition,84146832,47852604,0.5686798048439898,36294228,0.43132019515601017,2007,2007.csv
1442,Finding Mr. Right,84112033,6945,8.256844772733052e-05,84105088,0.9999174315522726,2013,2013.csv
1443,Pan's Labyrinth,83850267,37634615,0.4488311885757024,46215652,0.5511688114242975,2006,2006.csv
1444,Marmaduke,83761844,33644788,0.40167200712534457,50117056,0.5983279928746554,2010,2010.csv
1445,In Her Shoes,83697473,32880591,0.3928504627612831,50816882,0.6071495372387169,2005,2005.csv
1446,Mortal Engines,83672673,15951040,0.19063619492591088,67721633,0.8093638050740891,2018,2018.csv
1447,Snatch,83557872,30328156,0.3629598896439105,53229716,0.6370401103560895,2000,2000.csv
1448,Blow,83282296,52990775,0.6362789877935162,30291521,0.36372101220648384,2001,2001.csv
1449,Piranha 3D,83188165,25003155,0.30056144404675833,58185010,0.6994385559532417,2010,2010.csv
1450,Rings,83080890,27793018,0.33452961324800445,55287872,0.6654703867519955,2017,2017.csv
1451,Savages,82966152,47382068,0.5711011883496778,35584084,0.4288988116503222,2012,2012.csv
1452,Once Upon A Time,82886178,485728,0.005860180933906736,82400450,0.9941398190660933,2017,2017.csv
1453,Firewall,82751189,48751189,0.5891297706912707,34000000,0.41087022930872935,2006,2006.csv
1454,28 Days Later...,82719885,45064915,0.5447893816583521,37654970,0.45521061834164783,2002,2002.csv
1455,"Big Mommas: Like Father, Like Son",82686066,37915414,0.4585465947793429,44770652,0.5414534052206571,2011,2011.csv
1456,Oceans 2010 Re-release,82651439,19422319,0.2349906938704358,63229120,0.7650093061295642,2010,2010.csv
1457,Sinister,82515113,48086903,0.5827647960683275,34428210,0.4172352039316725,2012,2012.csv
1458,Act of Valor,82497035,70012847,0.8486710704208945,12484188,0.1513289295791055,2012,2012.csv
1459,The Constant Gardener,82466670,33579797,0.4071923481328881,48886873,0.5928076518671119,2005,2005.csv
1460,The Strangers,82410456,52597610,0.6382395214510159,29812846,0.36176047854898413,2008,2008.csv
1461,Hitman: Agent 47,82347656,22467450,0.2728365455842483,59880206,0.7271634544157517,2015,2015.csv
1462,Men of Honor,82343495,48818921,0.5928691877846575,33524574,0.4071308122153426,2000,2000.csv
1463,Hannibal Rising,82169884,27670986,0.33675337791641524,54498898,0.6632466220835848,2007,2007.csv
1464,Reign of Fire,82150183,43061982,0.5241860751545739,39088201,0.4758139248454261,2002,2002.csv
1465,Catwoman,82102379,40202379,0.48966156023323026,41900000,0.5103384397667697,2004,2004.csv
1466,Abduction,82087155,28087155,0.34216260753585626,54000000,0.6578373924641437,2011,2011.csv
1467,The Chorus,82032134,2087128,0.025442810009063035,79945006,0.974557189990937,2004,2004.csv
1468,Hostel,81979826,47326473,0.5772941381944382,34653353,0.4227058618055618,2006,2006.csv
1469,Ouija: Origin of Evil,81705746,35144505,0.43013504827432825,46561241,0.5698649517256718,2016,2016.csv
1470,One Piece: Stampede,81562741,1298528,0.01592060276640286,80264213,0.9840793972335972,2019,2019.csv
1471,Frankenweenie,81491068,35291068,0.43306670124877983,46200000,0.5669332987512202,2012,2012.csv
1472,Tinker Tailor Soldier Spy,81244605,24149393,0.297243035399089,57095212,0.7027569646009111,2011,2011.csv
1473,Edge of Darkness,81126522,43313890,0.5339054224461884,37812632,0.46609457755381156,2010,2010.csv
1474,Underworld: Blood Wars,81093313,30353973,0.37430919858953104,50739340,0.625690801410469,2016,2016.csv
1475,Sinbad: Legend of the Seven Seas,80773077,26483452,0.32787474469989547,54289625,0.6721252553001045,2003,2003.csv
1476,Hot Fuzz,80743363,23637265,0.292745609320236,57106098,0.707254390679764,2007,2007.csv
1477,A Dog's Way Home,80708134,42004346,0.5204474929379485,38703788,0.4795525070620515,2019,2019.csv
1478,The Rookie,80693537,75600072,0.9368788977486512,5093465,0.06312110225134883,2002,2002.csv
1479,The Rundown,80657921,47726342,0.5917130197293332,32931579,0.4082869802706668,2003,2003.csv
1480,Go Away Mr. Tumor,80606893,286639,0.0035560110225312867,80320254,0.9964439889774687,2015,2015.csv
1481,Vampires Suck,80547866,36661504,0.4551517727359779,43886362,0.5448482272640222,2010,2010.csv
1482,Den of Thieves,80509622,44947622,0.5582888216764947,35562000,0.44171117832350526,2018,2018.csv
1483,Halloween,80460948,58272029,0.7242274724379335,22188919,0.2757725275620665,2007,2007.csv
1484,Muppets Most Wanted,80383113,51183113,0.6367396221641727,29200000,0.36326037783582726,2014,2014.csv
1485,Hereditary,80200936,44069456,0.5494880508626483,36131480,0.4505119491373517,2018,2018.csv
1486,Runaway Jury,80154140,49443628,0.6168568211199073,30710512,0.3831431788800928,2003,2003.csv
1487,Finding Forrester,80049764,51804714,0.6471563613854002,28245050,0.3528436386145998,2000,2000.csv
1488,Exit Wounds,79958599,51758599,0.6473174823886046,28200000,0.35268251761139535,2001,2001.csv
1489,The Wedding Ringer,79799880,64460211,0.8077732823658381,15339669,0.19222671763416185,2015,2015.csv
1490,The Grey,79781695,51580236,0.6465171741462751,28201459,0.353482825853725,2012,2012.csv
1491,Jackass: The Movie,79493831,64255312,0.8083056407232405,15238519,0.19169435927675949,2002,2002.csv
1492,Good Bye Lenin!,79316957,4064200,0.05123998894713018,75252757,0.9487600110528698,2003,2003.csv
1493,Letters to Juliet,79293444,53032453,0.6688125817816666,26260991,0.3311874182183334,2010,2010.csv
1494,Stealth,79268322,32116746,0.40516495353591564,47151576,0.5948350464640844,2005,2005.csv
1495,Manchester by the Sea,78988148,47695371,0.603829463124012,31292777,0.396170536875988,2016,2016.csv
1496,Lady Bird,78965611,48958273,0.6199948608008617,30007338,0.3800051391991382,2017,2017.csv
1497,Paranormal Activity: The Ghost Dimension,78903124,18300124,0.2319315519116835,60603000,0.7680684480883165,2015,2015.csv
1498,The Boss,78844582,63285885,0.8026662504216207,15558697,0.1973337495783794,2016,2016.csv
1499,The Sentinel,78810595,36280697,0.4603530400956876,42529898,0.5396469599043123,2006,2006.csv
1500,The Orphanage,78638987,7161284,0.09106531344306355,71477703,0.9089346865569364,2007,2007.csv
1501,Curse of the Golden Flower,78568977,6566773,0.08357971874827898,72002204,0.916420281251721,2006,2006.csv
1502,The Attorney,78547586,557236,0.007094247301247424,77990350,0.9929057526987526,2013,2013.csv
1503,Righteous Kill,78460699,40081410,0.5108469655617012,38379289,0.48915303443829883,2008,2008.csv
1504,The Family,78418811,36918811,0.47079024189744473,41500000,0.5292097581025552,2013,2013.csv
1505,Collateral Damage,78382433,40077257,0.5113040698800457,38305176,0.4886959301199543,2002,2002.csv
1506,Scary Movie V,78378744,32015787,0.4084753769465864,46362957,0.5915246230534136,2013,2013.csv
1507,R.I.P.D.,78324220,33618855,0.4292268087700075,44705365,0.5707731912299925,2013,2013.csv
1508,Priest,78309505,29137000,0.37207488414082046,49172505,0.6279251158591795,2011,2011.csv
1509,If I Stay,78274843,50474843,0.6448411911857811,27800000,0.3551588088142189,2014,2014.csv
1510,The Other Boleyn Girl,78199679,26814957,0.3429036709984449,51384722,0.6570963290015551,2008,2008.csv
1511,Duplicity,78176181,40572825,0.518992159517232,37603356,0.481007840482768,2009,2009.csv
1512,Tag,78130625,54730625,0.7005015638874001,23400000,0.2994984361125999,2018,2018.csv
1513,Exorcist: The Beginning,78110021,41821986,0.5354240783010416,36288035,0.46457592169895845,2004,2004.csv
1514,Mirrors,78094714,30691439,0.3930027709685959,47403275,0.6069972290314041,2008,2008.csv
1515,Shin Godzilla,77947607,1918403,0.024611441888139043,76029204,0.975388558111861,2016,2016.csv
1516,Orphan,77912251,41596251,0.5338858840055847,36316000,0.4661141159944153,2009,2009.csv
1517,Showtime,77741732,38082712,0.4898618929663157,39659020,0.5101381070336843,2002,2002.csv
1518,Tiny Times,77717014,23462,0.0003018901369525082,77693552,0.9996981098630475,2013,2013.csv
1519,The Number 23,77677553,35193167,0.4530674003080401,42484386,0.54693259969196,2007,2007.csv
1520,Windtalkers,77628265,40914068,0.5270511713742411,36714197,0.47294882862575893,2002,2002.csv
1521,Next,77621983,18211013,0.23461154039313836,59410970,0.7653884596068616,2007,2007.csv
1522,Hostage,77608617,34639939,0.4463414030429121,42968678,0.5536585969570879,2005,2005.csv
1523,Serendipity,77516304,50294317,0.6488224335360468,27221987,0.3511775664639532,2001,2001.csv
1524,The Back-up Plan,77477008,37490007,0.48388558060992753,39987001,0.5161144193900725,2010,2010.csv
1525,The Lives of Others,77356942,11286112,0.14589656349135413,66070830,0.8541034365086458,2006,2006.csv
1526,Diary of a Wimpy Kid: Dog Days,77229695,49008662,0.6345831354118386,28221033,0.3654168645881613,2012,2012.csv
1527,Fame,77211836,22455510,0.2908298929713315,54756326,0.7091701070286686,2009,2009.csv
1528,The Haunting in Connecticut 2009 Re-release,77099821,55389516,0.7184130297786294,21710305,0.2815869702213706,2009,2009.csv
1529,Mike and Dave Need Wedding Dates,77068246,46009673,0.596999093504736,31058573,0.40300090649526393,2016,2016.csv
1530,Barbershop,77063924,75782105,0.983366808573101,1281819,0.01663319142689905,2002,2002.csv
1531,Drive,76976666,35061555,0.45548289919441304,41915111,0.544517100805587,2011,2011.csv
1532,"I, Frankenstein",76801179,19075290,0.248372358971208,57725889,0.751627641028792,2014,2014.csv
1533,United 93,76700659,31483450,0.4104717014230608,45217209,0.5895282985769392,2006,2006.csv
1534,Sanju,76693052,7909317,0.10312951165380665,68783735,0.8968704883461933,2018,2018.csv
1535,Coach Carter,76669554,67264877,0.8773349196735903,9404677,0.12266508032640962,2005,2005.csv
1536,The Ladykillers,76665191,39799191,0.519129874730241,36866000,0.480870125269759,2004,2004.csv
1537,The Book Thief,76586316,21488481,0.28057859578987976,55097835,0.7194214042101202,2013,2013.csv
1538,Bend It Like Beckham,76583333,32543449,0.4249416645264055,44039884,0.5750583354735945,2002,2002.csv
1539,The Unborn,76514050,42670410,0.5576807135421533,33843640,0.4423192864578466,2009,2009.csv
1540,Bad Santa,76488889,60060328,0.7852163730604061,16428561,0.2147836269395938,2003,2003.csv
1541,The Road to El Dorado,76432727,50863742,0.665470721723693,25568985,0.33452927827630696,2000,2000.csv
1542,Cold Pursuit,76419755,32138862,0.42055698817668286,44280893,0.5794430118233171,2019,2019.csv
1543,The Ides of March,76338111,40962534,0.5365934978401549,35375577,0.4634065021598452,2011,2011.csv
1544,Kubo and the Two Strings,76249438,48023088,0.6298156322148892,28226350,0.37018436778511077,2016,2016.csv
1545,Diary of a Wimpy Kid,76196538,64003625,0.8399807482066968,12192913,0.16001925179330326,2010,2010.csv
1546,Tae Guk Gi: The Brotherhood of War,76194339,1111061,0.014581936329941782,75083278,0.9854180636700582,2004,2004.csv
1547,There Will Be Blood,76181545,40222514,0.5279823873354105,35959031,0.4720176126645896,2007,2007.csv
1548,The Mechanic,76130093,29121498,0.38252282182290254,47008595,0.6174771781770975,2011,2011.csv
1549,If You Are the One 2,76085443,426894,0.005610718465554574,75658549,0.9943892815344454,2010,2010.csv
1550,Vice,76073488,47836282,0.6288167304751426,28237206,0.3711832695248573,2018,2018.csv
1551,The Pink Panther 2,76025134,35922978,0.4725144976396885,40102156,0.5274855023603116,2009,2009.csv
1552,Kate & Leopold,76019048,47121859,0.6198691017546023,28897189,0.38013089824539764,2001,2001.csv
1553,Death Race,76014335,36316032,0.47775241340991803,39698303,0.522247586590082,2008,2008.csv
1554,Widows,75984700,42402632,0.5580417110286676,33582068,0.4419582889713324,2018,2018.csv
1555,Revolutionary Road,75981180,22911480,0.3015415133063214,53069700,0.6984584866936786,2008,2008.csv
1556,Sicario: Day of the Soldado,75837743,50072235,0.6602548153364743,25765508,0.33974518466352566,2018,2018.csv
1557,Elizabeth: The Golden Age,75782758,16383509,0.21619045588179833,59399249,0.7838095441182017,2007,2007.csv
1558,Dreamcatcher,75715436,33715436,0.44529144625146183,42000000,0.5547085537485381,2003,2003.csv
1559,A Dog's Journey,75617580,22782371,0.30128405325851476,52835209,0.6987159467414853,2019,2019.csv
1560,Bajrangi Bhaijaan,75547184,8178001,0.10825024265629808,67369183,0.8917497573437019,2015,2015.csv
1561,30 Days of Night,75513170,39569000,0.5240013099701681,35944170,0.47599869002983186,2007,2007.csv
1562,Stomp the Yard,75511123,61356221,0.8125454709500215,14154902,0.1874545290499785,2007,2007.csv
1563,Der Schuh des Manitu,75482094,0,0.0,75482094,1.0,2001,2001.csv
1564,Searching,75462037,26020957,0.3448218208050758,49441080,0.6551781791949242,2018,2018.csv
1565,The Change-Up,75450437,37081475,0.49146799507602584,38368962,0.5085320049239741,2011,2011.csv
1566,The Count of Monte Cristo,75395048,54234062,0.719331885033086,21160986,0.280668114966914,2002,2002.csv
1567,The Spy Who Dumped Me,75320680,33562069,0.4455890334500432,41758611,0.5544109665499568,2018,2018.csv
1568,Dragon Wars: D-War,75108817,10977721,0.1461575543121655,64131096,0.8538424456878345,2007,2007.csv
1569,Larry Crowne,75055070,35608245,0.47442824315532584,39446825,0.5255717568446742,2011,2011.csv
1570,Easy A,75026216,58401464,0.7784140946146078,16624752,0.22158590538539222,2010,2010.csv
1571,The Kite Runner,75011029,15800078,0.21063673183312817,59210951,0.7893632681668719,2007,2007.csv
1572,Tyler Perry's Boo! A Madea Halloween,74827344,73206343,0.9783367828744529,1621001,0.021663217125547047,2016,2016.csv
1573,A Madea Family Funeral,74747725,73257045,0.9800571856869222,1490680,0.019942814313077754,2019,2019.csv
1574,Crimson Peak,74679822,31090320,0.4163148648104705,43589502,0.5836851351895295,2014,2014.csv
1575,Escape from Planet Earth,74597643,57012977,0.7642731687916735,17584666,0.23572683120832652,2013,2013.csv
1576,From Hell,74558115,31602566,0.4238648737297074,42955549,0.5761351262702926,2001,2001.csv
1577,Hubble 3D,74249729,52522904,0.7073817602755156,21726825,0.29261823972448436,2010,2010.csv
1578,August: Osage County,74188937,37738810,0.5086851426379111,36450127,0.4913148573620889,2013,2013.csv
1579,Eternal Sunshine of the Spotless Mind,74036715,34400301,0.4646384027168142,39636414,0.5353615972831858,2004,2004.csv
1580,Miracles from Heaven,73983003,61705123,0.8340445845378837,12277880,0.16595541546211634,2016,2016.csv
1581,Divine Secrets of the Ya-Ya Sisterhood,73839240,69599016,0.94257492357722,4240224,0.05742507642278008,2002,2002.csv
1582,Obsessed,73830347,68261644,0.9245743352662287,5568703,0.07542566473377132,2009,2009.csv
1583,Cats,73736144,27166770,0.36843220334385807,46569374,0.6315677966561419,2019,2019.csv
1584,Perfect Stranger,73534117,23984949,0.3261744341065522,49549168,0.6738255658934478,2007,2007.csv
1585,The Core,73498611,31186896,0.4243195289772211,42311715,0.575680471022779,2003,2003.csv
1586,Charlie's Angels,73279888,17803077,0.24294629107511737,55476811,0.7570537089248827,2019,2019.csv
1587,War Room,73267874,67790117,0.9252365777666758,5477757,0.07476342223332426,2015,2015.csv
1588,To Rome With Love,73244881,16685867,0.22780932636097806,56559014,0.7721906736390219,2012,2012.csv
1589,"Dude, Where's My Car?",73180723,46729800,0.6385534070222291,26450923,0.36144659297777093,2000,2000.csv
1590,Here Comes the Boom,73100172,45290318,0.6195651359069305,27809854,0.3804348640930694,2012,2012.csv
1591,Without a Paddle,73029190,58169327,0.7965215963644127,14859863,0.20347840363558736,2004,2004.csv
1592,The Best Man Holiday,72835710,70525195,0.9682777170703766,2310515,0.0317222829296234,2013,2013.csv
1593,Lady in the Water,72785169,42285169,0.580958587868361,30500000,0.4190414121316391,2006,2006.csv
1594,The One,72689126,43905746,0.6040208269941229,28783380,0.3959791730058771,2001,2001.csv
1595,"Yours, Mine & Ours",72662923,53412862,0.7350772552874043,19250061,0.26492274471259575,2005,2005.csv
1596,The Transporter Refueled,72629670,16029670,0.22070415575342694,56600000,0.779295844246573,2015,2015.csv
1597,Lord of War,72617068,24149632,0.3325613752403223,48467436,0.6674386247596777,2005,2005.csv
1598,Diary of a Wimpy Kid: Rodrick Rules,72526996,52698535,0.7266057868989914,19828461,0.27339421310100864,2011,2011.csv
1599,Doctor Sleep,72381712,31581712,0.4363217051290525,40800000,0.5636782948709476,2019,2019.csv
1600,Second Act,72282227,39282227,0.5434562357908536,33000000,0.45654376420914644,2018,2018.csv
1601,What Men Want,72216294,54611903,0.7562268841987377,17604391,0.24377311580126224,2019,2019.csv
1602,Around the World in 80 Days,72178895,24008137,0.33261990225813237,48170758,0.6673800977418676,2004,2004.csv
1603,Babylon A.D.,72109200,22532572,0.3124784632196724,49576628,0.6875215367803276,2008,2008.csv
1604,The Adventures of Sharkboy and Lavagirl 3-D,71992655,39177684,0.5441900149397185,32814971,0.4558099850602815,2005,2005.csv
1605,"O Brother, Where Art Thou?",71868327,45512588,0.6332774102282915,26355739,0.36672258977170846,2000,2000.csv
1606,Rules of Engagement,71732303,61335230,0.8550573093965769,10397073,0.14494269060342313,2000,2000.csv
1607,Funny People,71585235,51855045,0.7243818505310488,19730190,0.27561814946895125,2009,2009.csv
1608,Superhero Movie,71571300,25881068,0.3616123781459887,45690232,0.6383876218540113,2008,2008.csv
1609,Run All Night,71561644,26461644,0.3697741208963841,45100000,0.6302258791036159,2015,2015.csv
1610,The Royal Tenenbaums,71441250,52364010,0.7329660385281612,19077240,0.2670339614718387,2001,2001.csv
1611,Brick Mansions,71416730,20396829,0.28560295325759105,51019901,0.714397046742409,2014,2014.csv
1612,Holes,71406573,67406573,0.9439827479187385,4000000,0.05601725208126148,2003,2003.csv
1613,Down to Earth,71186502,64186502,0.9016667513737365,7000000,0.09833324862626344,2001,2001.csv
1614,xXx: State of the Union,71022693,26873932,0.37838514515353566,44148761,0.6216148548464644,2005,2005.csv
1615,The Counselor,71009334,16973715,0.23903498376706364,54035619,0.7609650162329363,2013,2013.csv
1616,Anacondas: The Hunt for the Blood Orchid,70992898,32238923,0.45411476229636377,38753975,0.5458852377036362,2004,2004.csv
1617,Son of God,70829270,59700064,0.842872784090532,11129206,0.15712721590946793,2014,2014.csv
1618,I Am Not Madame Bovary,70826207,436798,0.006167180461887504,70389409,0.9938328195381125,2016,2016.csv
1619,Taxi 2004 Re-release,70778329,36611066,0.5172637799911891,34167263,0.4827362200088109,2004,2004.csv
1620,Brotherhood of the Wolf,70752904,11260096,0.15914676802523894,59492808,0.840853231974761,2001,2001.csv
1621,The Grudge 2,70711175,39143839,0.5535735900301473,31567336,0.4464264099698527,2006,2006.csv
1622,Hannah Montana and Miley Cyrus: Best of Both Worlds Concert,70642966,65281781,0.9241087215958628,5361185,0.07589127840413722,2008,2008.csv
1623,Children of Men,70455770,35552383,0.5046056980145133,34903387,0.4953943019854868,2006,2006.csv
1624,Departures,70442129,1498210,0.021268664381225617,68943919,0.9787313356187743,2008,2008.csv
1625,The House Bunny,70439696,48237389,0.6848040485580744,22202307,0.3151959514419256,2008,2008.csv
1626,Spirited Away 2018 Re-release,70186029,1175067,0.016742178133485795,69010962,0.9832578218665142,2018,2018.csv
1627,Think Like a Man Too,70181428,65182182,0.9287668241803231,4999246,0.07123317581967696,2014,2014.csv
1628,License to Wed,70181325,43799818,0.6240950566265313,26381507,0.37590494337346864,2007,2007.csv
1629,A Cinderella Story,70067909,51438175,0.7341188817265832,18629734,0.2658811182734167,2004,2004.csv
1630,3:10 to Yuma,70016220,53606916,0.7656356769902746,16409304,0.23436432300972546,2007,2007.csv
1631,The Hills Have Eyes,70008952,41778863,0.5967645823351276,28230089,0.40323541766487236,2006,2006.csv
1632,The Cabin in the Woods 2012 Re-release,69935600,42073277,0.6016002865493397,27862323,0.39839971345066033,2012,2012.csv
1633,Curious George,69865924,58360760,0.8353251006885702,11505164,0.1646748993114297,2006,2006.csv
1634,The Brave One,69787394,36793804,0.5272270805813439,32993590,0.472772919418656,2007,2007.csv
1635,After,69733482,12138565,0.17407082870177054,57594917,0.8259291712982294,2019,2019.csv
1636,The Dilemma,69721966,48475290,0.6952656785380952,21246676,0.3047343214619048,2011,2011.csv
1637,Exit,69501772,470699,0.006772474808268198,69031073,0.9932275251917319,2019,2019.csv
1638,Because I Said So,69485490,42674040,0.6141431829868366,26811450,0.3858568170131635,2007,2007.csv
1639,Mr. Magorium's Wonder Emporium,69474661,32061555,0.46148559112796533,37413106,0.5385144088720346,2007,2007.csv
1640,The Last Exorcism,69432527,41034350,0.5909960615433167,28398177,0.40900393845668326,2010,2010.csv
1641,A Very Long Engagement,69424389,6524389,0.0939783423949183,62900000,0.9060216576050817,2004,2004.csv
1642,13 Hours,69411370,52853219,0.7614490104431018,16558151,0.23855098955689824,2015,2015.csv
1643,The X Files: I Want to Believe,69363381,20982478,0.302500796493758,48380903,0.697499203506242,2008,2008.csv
1644,E.T. the Extra-Terrestrial 20th Anniversary,69177751,35306015,0.5103666206205518,33871736,0.4896333793794482,2002,2002.csv
1645,The Men Who Stare at Goats,69095771,32428195,0.4693224278516264,36667576,0.5306775721483736,2009,2009.csv
1646,Takers,69055695,57744720,0.8362050371080908,11310975,0.1637949628919092,2010,2010.csv
1647,Anna Karenina,68929150,12816367,0.18593536986891612,56112783,0.8140646301310839,2012,2012.csv
1648,John Tucker Must Die,68844775,41011711,0.5957127610628403,27833064,0.40428723893715973,2006,2006.csv
1649,Running Man,68782475,310978,0.004521180722269735,68471497,0.9954788192777303,2015,2015.csv
1650,Land of the Lost,68777554,49438370,0.718815472850343,19339184,0.28118452714965697,2009,2009.csv
1651,House of Wax,68766121,32064800,0.46628775236573256,36701321,0.5337122476342675,2005,2005.csv
1652,The Nut Job 2: Nutty by Nature,68743485,28370522,0.41270124725273966,40372963,0.5872987527472603,2017,2017.csv
1653,The Sweetest Thing,68696770,24718164,0.35981551971075204,43978606,0.6401844802892479,2002,2002.csv
1654,Letters from Iwo Jima,68673228,13756082,0.20031215075545888,54917146,0.7996878492445412,2006,2006.csv
1655,Playing with Fire,68631669,44451847,0.6476871049136224,24179822,0.3523128950863777,2019,2019.csv
1656,The Call,68572631,51872378,0.7564589143444124,16700253,0.24354108565558757,2013,2013.csv
1657,One Direction: This Is Us,68532898,28873374,0.4213067715303678,39659524,0.5786932284696322,2013,2013.csv
1658,Looney Tunes: Back in Action,68514844,20991364,0.3063768779799017,47523480,0.6936231220200983,2003,2003.csv
1659,Dan in Real Life,68471669,47642963,0.6958054870840085,20828706,0.3041945129159916,2007,2007.csv
1660,Thir13en Ghosts,68467960,41867960,0.6114971148548898,26600000,0.3885028851451102,2001,2001.csv
1661,Pokémon 3 the Movie: Spell of the Unown,68411275,17052128,0.24925902930474544,51359147,0.7507409706952546,2001,2001.csv
1662,Ghost Ship,68349884,30113491,0.4405785238786945,38236393,0.5594214761213054,2002,2002.csv
1663,Stalingrad,68316452,1013945,0.014841886109659207,67302507,0.9851581138903408,2013,2013.csv
1664,Open Range,68296293,58331254,0.8540910705065646,9965039,0.1459089294934353,2003,2003.csv
1665,Star Wars: The Clone Wars,68282844,35161554,0.514939799519774,33121290,0.485060200480226,2008,2008.csv
1666,The Watch,68267862,35353000,0.5178571433802922,32914862,0.4821428566197078,2012,2012.csv
1667,Moonrise Kingdom,68263166,45512466,0.6667207026407185,22750700,0.3332792973592816,2012,2012.csv
1668,Saw VI,68234154,27693292,0.40585675027201185,40540862,0.5941432497279882,2009,2009.csv
1669,Frequency,68106245,45010278,0.6608832714239348,23095967,0.33911672857606523,2000,2000.csv
1670,Fearless,68072848,24633730,0.3618730628105937,43439118,0.6381269371894063,2006,2006.csv
1671,Shoplifters,67999335,3313513,0.04872860889007223,64685822,0.9512713911099278,2018,2018.csv
1672,Prime,67937494,22827153,0.33600228174445174,45110341,0.6639977182555482,2005,2005.csv
1673,Legion,67918658,40168080,0.591414512342102,27750578,0.4085854876578981,2010,2010.csv
1674,The American,67876281,35606376,0.5245775913975016,32269905,0.4754224086024984,2010,2010.csv
1675,A Beautiful Day in the Neighborhood,67760877,61704055,0.9106147637374882,6056822,0.08938523626251177,2019,2019.csv
1676,Jersey Boys,67647013,47047013,0.6954780545890474,20600000,0.30452194541095257,2014,2014.csv
1677,Bandits,67631903,41575141,0.614726765857823,26056762,0.38527323414217696,2001,2001.csv
1678,12 Strong,67450815,45819713,0.6793055502739292,21631102,0.32069444972607075,2018,2018.csv
1679,The Next Three Days,67448651,21148651,0.3135518751887269,46300000,0.6864481248112732,2010,2010.csv
1680,Star Trek: Nemesis,67336470,43254409,0.6423622889646576,24082061,0.35763771103534236,2002,2002.csv
1681,American Assassin,67234188,36249674,0.5391553773208356,30984514,0.4608446226791644,2017,2017.csv
1682,Boogeyman,67192859,46752382,0.6957939086949702,20440477,0.3042060913050299,2005,2005.csv
1683,War,67179155,4654000,0.06927744178979328,62525155,0.9307225582102068,2019,2019.csv
1684,The Girl Who Played with Fire,67153225,7638241,0.11374347248400951,59514984,0.8862565275159905,2009,2009.csv
1685,"Lust, Caution",67091915,4604982,0.06863691400074062,62486933,0.9313630859992593,2007,2007.csv
1686,When a Stranger Calls,67062123,47860214,0.7136698311802625,19201909,0.2863301688197375,2006,2006.csv
1687,Skyline,66984887,21393620,0.31937980279044137,45591267,0.6806201972095586,2010,2010.csv
1688,The Giver,66980456,45090374,0.6731870263767687,21890082,0.32681297362323125,2014,2014.csv
1689,Madea's Witness Protection,66899242,65653242,0.9813749758181116,1246000,0.018625024181888338,2012,2012.csv
1690,Selma,66787908,52076908,0.779735577284439,14711000,0.22026442271556101,2014,2014.csv
1691,Thirteen Days,66579890,34592089,0.5195576171723925,31987801,0.48044238282760754,2000,2000.csv
1692,Victoria & Abdul,66558465,22245070,0.33421849497280326,44313395,0.6657815050271968,2017,2017.csv
1693,Take the Lead,66499627,34742066,0.5224400130845847,31757561,0.47755998691541535,2006,2006.csv
1694,Street Kings,66476363,26418667,0.39741444639502915,40057696,0.6025855536049708,2008,2008.csv
1695,Not Another Teen Movie,66468332,38252284,0.5754963732202577,28216048,0.4245036267797423,2001,2001.csv
1696,"Love, Simon",66316289,40826341,0.615630663531248,25489948,0.38436933646875204,2018,2018.csv
1697,Mile 22,66308758,36108758,0.5445548836851989,30200000,0.4554451163148011,2018,2018.csv
1698,One Piece Film: Gold,66207073,423593,0.00639800221949096,65783480,0.9936019977805091,2016,2016.csv
1699,August Rush,66122026,31664162,0.47887464912221533,34457864,0.5211253508777847,2007,2007.csv
1700,Barbershop 2: Back in Business,65991448,65111277,0.9866623475211516,880171,0.013337652478848471,2004,2004.csv
1701,Bad Company,65977295,30160161,0.45712939580199524,35817134,0.5428706041980048,2002,2002.csv
1702,Flags of Our Fathers,65900249,33602376,0.50989755744322,32297873,0.49010244255678004,2006,2006.csv
1703,Life of the Party,65859911,53059911,0.8056480823364611,12800000,0.1943519176635389,2018,2018.csv
1704,Beijing Love Story,65842375,428318,0.0065052027664554936,65414057,0.9934947972335445,2014,2014.csv
1705,Stuck on You,65784503,33832741,0.5142965205650334,31951762,0.4857034794349666,2003,2003.csv
1706,Sweet November,65754228,25288103,0.384585201121972,40466125,0.6154147988780281,2001,2001.csv
1707,The Widowmaker,65716126,35168966,0.5351649304464478,30547160,0.4648350695535522,2002,2002.csv
1708,16 Blocks,65664721,36895141,0.5618715870276827,28769580,0.43812841297231736,2006,2006.csv
1709,The Age of Adaline,65663276,42629776,0.6492179281460158,23033500,0.35078207185398425,2015,2015.csv
1710,Matchstick Men,65565672,36906460,0.5628930334154129,28659212,0.43710696658458714,2003,2003.csv
1711,Taxi 3,65497208,497208,0.007591285417845597,65000000,0.9924087145821544,2003,2003.csv
1712,Taking Lives,65470529,32682342,0.4991916591967662,32788187,0.5008083408032338,2004,2004.csv
1713,Moonlight,65336603,27854932,0.42632966394044086,37481671,0.5736703360595592,2016,2016.csv
1714,Underdog,65270477,43760605,0.6704502098245735,21509872,0.32954979017542646,2007,2007.csv
1715,Something Borrowed,65100369,39046489,0.5997890580312993,26053880,0.40021094196870066,2011,2011.csv
1716,Space Chimps,65097693,30105968,0.4624736547883502,34991725,0.5375263452116498,2008,2008.csv
1717,Zathura: A Space Adventure,65079104,29258869,0.44958930288898874,35820235,0.5504106971110112,2005,2005.csv
1718,28 Weeks Later,65048678,28638916,0.440268993629663,36409762,0.559731006370337,2007,2007.csv
1719,K-PAX,65001485,50338485,0.7744205382384726,14663000,0.22557946176152746,2001,2001.csv
1720,The Benchwarmers,64962629,59843754,0.921202773366823,5118875,0.07879722663317705,2006,2006.csv
1721,The Pirates,64858224,415775,0.006410520892462304,64442449,0.9935894791075377,2014,2014.csv
1722,The Bank Job,64822796,30060660,0.4637359363517735,34762136,0.5362640636482264,2008,2008.csv
1723,Lions for Lambs,64811540,15002854,0.2314843004810563,49808686,0.7685156995189437,2007,2007.csv
1724,Hot Tub Time Machine,64735752,50287556,0.7768127262969,14448196,0.22318727370309996,2010,2010.csv
1725,God's Not Dead,64667874,60755732,0.9395040882277961,3912142,0.060495911772203925,2014,2014.csv
1726,The Darkest Hour,64626786,21443494,0.3318050506178661,43183292,0.6681949493821339,2011,2011.csv
1727,Happy Death Day 2U,64600152,28148130,0.43572854131984085,36452022,0.5642714586801592,2019,2019.csv
1728,Monster Trucks,64493915,33370166,0.5174157282900255,31123749,0.4825842717099745,2016,2016.csv
1729,Miracle,64445708,64378093,0.9989508222952567,67615,0.0010491777047433478,2004,2004.csv
1730,Baby Mama,64444713,60494212,0.9386993778682823,3950501,0.061300622131717775,2008,2008.csv
1731,Kiss of the Dragon,64437847,36845124,0.5717932195965517,27592723,0.4282067804034483,2001,2001.csv
1732,Fences,64414761,57682904,0.8954920130806664,6731857,0.10450798691933359,2016,2016.csv
1733,Capernaum,64413178,1661096,0.02578813919102082,62752082,0.9742118608089791,2018,2018.csv
1734,Zhongkui: Snow Girl and the Dark Crystal,64325947,165428,0.002571714956641058,64160519,0.9974282850433589,2015,2015.csv
1735,Isle of Dogs,64241499,32015231,0.49835747139088393,32226268,0.5016425286091161,2018,2018.csv
1736,Thunder and the House of Magic,64197205,4091,6.372551577595941e-05,64193114,0.9999362744842241,2013,2013.csv
1737,The Danish Girl,64191523,11114018,0.1731384064528271,53077505,0.8268615935471729,2015,2015.csv
1738,The Boy,64188367,35819556,0.5580381255064488,28368811,0.4419618744935511,2015,2015.csv
1739,The Grandmaster,64076736,6594959,0.10292282990194757,57481777,0.8970771700980524,2013,2013.csv
1740,Hanna,63782078,40259119,0.6311979832328448,23522959,0.3688020167671552,2011,2011.csv
1741,High Crimes,63781810,41543917,0.651344278251119,22237893,0.34865572174888104,2002,2002.csv
1742,Precious,63649529,47566524,0.7473193399435839,16083005,0.25268066005641615,2009,2009.csv
1743,"Hail, Caesar!",63647656,30498085,0.4791705919225054,33149571,0.5208294080774947,2016,2016.csv
1744,Elite Squad 2: The Enemy Within,63618850,100119,0.0015737316848701288,63518731,0.9984262683151298,2010,2010.csv
1745,Footloose 2011 Re-release,63543328,51802742,0.815234952755386,11740586,0.18476504724461396,2011,2011.csv
1746,Conan the Barbarian,63523283,21295021,0.33523174487061697,42228262,0.664768255129383,2011,2011.csv
1747,Begin Again,63464861,16170632,0.25479661887229216,47294229,0.7452033811277078,2014,2014.csv
1748,Colombiana,63458440,36665854,0.5777931824356224,26792586,0.42220681756437756,2011,2011.csv
1749,Side Effects,63414135,32172757,0.5073436229950941,31241378,0.49265637700490594,2013,2013.csv
1750,Madea's Family Reunion,63368939,63318000,0.9991961519191602,50939,0.0008038480808397313,2006,2006.csv
1751,The Host,63365859,26627201,0.42021368320754554,36738658,0.5797863167924544,2013,2013.csv
1752,Jeepers Creepers 2,63102666,35667218,0.5652252156826464,27435448,0.43477478431735356,2003,2003.csv
1753,The Longest Ride,62944815,37446117,0.5949039170263667,25498698,0.4050960829736333,2015,2015.csv
1754,Unfriended,62882090,32482090,0.5165555088897331,30400000,0.4834444911102668,2015,2015.csv
1755,Piglet's Big Movie,62870546,23103423,0.36747609922140645,39767123,0.6325239007785936,2003,2003.csv
1756,The Mountain Between Us,62832209,30348555,0.48300951825519933,32483654,0.5169904817448007,2017,2017.csv
1757,The Star,62812974,40852824,0.65038830990553,21960150,0.34961169009446996,2017,2017.csv
1758,Inkheart,62803180,17303424,0.27551827789611927,45499756,0.7244817221038807,2008,2008.csv
1759,The Nice Guys,62788218,36261763,0.5775249585837904,26526455,0.4224750414162097,2016,2016.csv
1760,The Reaping,62771059,25126214,0.4002834172353218,37644845,0.5997165827646782,2007,2007.csv
1761,Beauty and the Beast 2012 3D Release,62767829,47617067,0.7586221757008674,15150762,0.2413778242991326,2012,2012.csv
1762,Proof of Life,62761005,32598931,0.5194137824912141,30162074,0.4805862175087859,2000,2000.csv
1763,Devil,62695489,33601190,0.5359427055429777,29094299,0.46405729445702226,2010,2010.csv
1764,Runner Runner,62675095,19316646,0.3082028994132358,43358449,0.6917971005867641,2013,2013.csv
1765,After the Sunset,62657868,28331233,0.45215762847213375,34326635,0.5478423715278662,2004,2004.csv
1766,How to Be a Latin Lover,62547032,32149404,0.5140036700702281,30397628,0.4859963299297719,2017,2017.csv
1767,Snow Day,62464731,60020107,0.9608639313599221,2444624,0.03913606864007787,2000,2000.csv
1768,Year One,62357900,43337279,0.6949765627129842,19020621,0.30502343728701575,2009,2009.csv
1769,Like Mike,62274780,51432760,0.8259003082788892,10842020,0.17409969172111087,2002,2002.csv
1770,Honey,62228395,30308417,0.4870512408362774,31919978,0.5129487591637226,2003,2003.csv
1771,28 Days,62198945,37170488,0.5976064063466028,25028457,0.40239359365339716,2000,2000.csv
1772,47 Meters Down,62187529,44307191,0.7124771109654477,17880338,0.28752288903455225,2017,2017.csv
1773,Two Brothers,62172050,19176754,0.30844654470939914,42995296,0.6915534552906009,2004,2004.csv
1774,Captain Corelli's Mandolin,62112895,25543895,0.41124946760250025,36569000,0.5887505323974997,2001,2001.csv
1775,Brooklyn,62076141,38322743,0.6173506017392415,23753398,0.3826493982607585,2015,2015.csv
1776,Snakes on a Plane,62022014,34020814,0.5485280436072263,28001200,0.4514719563927737,2006,2006.csv
1777,Friday Night Lights,61950770,61255921,0.9887838520812574,694849,0.011216147918742576,2004,2004.csv
1778,The Imaginarium of Doctor Parnassus,61808775,7689607,0.12440963277463435,54119168,0.8755903672253657,2009,2009.csv
1779,"Dragon Ball Z: Resurrection ""F""",61768190,8008363,0.1296518968744268,53759827,0.8703481031255732,2015,2015.csv
1780,Valiant,61746888,19478106,0.3154508126790131,42268782,0.6845491873209869,2005,2005.csv
1781,White Snake,61631776,34730,0.000563508018980339,61597046,0.9994364919810197,2019,2019.csv
1782,"Everything, Everything",61621140,34121140,0.5537245821807256,27500000,0.4462754178192744,2017,2017.csv
1783,Woman in Gold,61619773,33307793,0.540537418078447,28311980,0.459462581921553,2015,2015.csv
1784,Ninja Assassin,61601280,38122883,0.6188651112444417,23478397,0.38113488875555834,2009,2009.csv
1785,The Face Reader,61559184,515876,0.008380163063889865,61043308,0.9916198369361101,2013,2013.csv
1786,Krampus,61548707,42725475,0.694173396688902,18823232,0.305826603311098,2015,2015.csv
1787,From Up on Poppy Hill,61459425,1002895,0.0163180016734618,60456530,0.9836819983265382,2011,2011.csv
1788,A History of Violence,61385065,31504633,0.5132296104923894,29880432,0.4867703895076107,2005,2005.csv
1789,In Good Company,61315215,45806659,0.7470683907738072,15508556,0.2529316092261929,2004,2004.csv
1790,The Legend of Hercules,61279452,18848538,0.30758333152195944,42430914,0.6924166684780406,2013,2013.csv
1791,Ashfall,61255955,372562,0.0060820535734035985,60883393,0.9939179464265964,2019,2019.csv
1792,The Walk,61181942,10137502,0.16569434817874856,51044440,0.8343056518212515,2014,2014.csv
1793,Crossroads,61141030,37191304,0.6082871682076668,23949726,0.39171283179233324,2002,2002.csv
1794,My Super Ex-Girlfriend,61108981,22530295,0.36869040575230666,38578686,0.6313095942476933,2006,2006.csv
1795,Ma,61105672,45896028,0.7510927627144007,15209644,0.24890723728559927,2019,2019.csv
1796,Marie Antoinette,60917189,15962471,0.2620355807947737,44954718,0.7379644192052263,2006,2006.csv
1797,Snatched,60845711,45852178,0.7535811028652455,14993533,0.24641889713475448,2017,2017.csv
1798,Kick-Ass 2,60795985,28795985,0.4736494523445915,32000000,0.5263505476554085,2013,2013.csv
1799,Zoolander,60780981,45172250,0.7431971195068404,15608731,0.2568028804931595,2001,2001.csv
1800,127 Hours,60738797,18335230,0.301870153931432,42403567,0.698129846068568,2010,2010.csv
1801,Taxi 2,60726164,626164,0.010311272090231156,60100000,0.9896887279097688,2000,2000.csv
1802,500 Days of Summer,60722734,32391374,0.5334307575808428,28331360,0.4665692424191572,2009,2009.csv
1803,The Wild Thornberrys,60694737,40108697,0.660826605114048,20586040,0.339173394885952,2002,2002.csv
1804,Why Did I Get Married Too?,60673972,60095852,0.9904716968257822,578120,0.009528303174217769,2010,2010.csv
1805,Evangelion: 3.0 You Can (Not) Redo,60488344,174945,0.002892210109107963,60313399,0.997107789890892,2012,2012.csv
1806,21 Grams,60427839,16290476,0.2695856126842464,44137363,0.7304143873157536,2003,2003.csv
1807,The Ghost Writer,60331447,15541549,0.2576027888076346,44789898,0.7423972111923653,2010,2010.csv
1808,My Little Pony: The Movie,60330833,21885107,0.3627516132588456,38445726,0.6372483867411544,2017,2017.csv
1809,Secretariat,60321861,59713955,0.9899222936772458,607906,0.0100777063227542,2010,2010.csv
1810,The Perfect Guy,60273173,57027435,0.9461495415215655,3245738,0.05385045847843451,2015,2015.csv
1811,3 Idiots,60262836,6532874,0.10840634848316796,53729962,0.891593651516832,2009,2009.csv
1812,The International,60253843,25450527,0.42238844416944493,34803316,0.5776115558305551,2009,2009.csv
1813,A Haunted House,60159584,40041683,0.6655910885288037,20117901,0.33440891147119634,2013,2013.csv
1814,The Crimson Rivers,60094966,594966,0.009900429929521884,59500000,0.9900995700704781,2001,2001.csv
1815,Beautiful Creatures,60052138,19452138,0.323920823601651,40600000,0.676079176398349,2013,2013.csv
1816,Morning Glory,60040976,31011732,0.5165094584738262,29029244,0.4834905415261737,2010,2010.csv
1817,Forever Young,59981902,149761,0.0024967697756566637,59832141,0.9975032302243433,2015,2015.csv
1818,Son of the Mask,59981548,17018422,0.28372762236813226,42963126,0.7162723776318677,2005,2005.csv
1819,Keeping the Faith,59945183,37047880,0.6180293085434404,22897303,0.3819706914565596,2000,2000.csv
1820,Adrift,59945012,31445012,0.5245642790095696,28500000,0.47543572099043035,2018,2018.csv
1821,Next Friday,59827328,57328603,0.9582343874692181,2498725,0.04176561253078192,2000,2000.csv
1822,Good Luck Chuck,59768495,35017297,0.5858821942898177,24751198,0.41411780571018225,2007,2007.csv
1823,Bombshell,59636523,31762808,0.5326066377142745,27873715,0.4673933622857255,2019,2019.csv
1824,Quartet,59520298,18390117,0.3089721929819639,41130181,0.6910278070180361,2012,2012.csv
1825,The Flintstones in Viva Rock Vegas,59468275,35268275,0.5930603334298834,24200000,0.4069396665701166,2000,2000.csv
1826,Rock of Ages,59418613,38518613,0.6482583664482373,20900000,0.35174163355176263,2012,2012.csv
1827,Miss Granny,59396311,234573,0.003949285671967069,59161738,0.9960507143280329,2015,2015.csv
1828,One Day,59389433,13843771,0.23310158559688557,45545662,0.7668984144031145,2011,2011.csv
1829,Molly's Game,59284015,28780744,0.48547224745152634,30503271,0.5145277525484736,2017,2017.csv
1830,Jeepers Creepers,59217789,37904175,0.6400808885316539,21313614,0.3599191114683461,2001,2001.csv
1831,The Devotion of Suspect X,59035664,686435,0.011627463019641822,58349229,0.9883725369803582,2017,2017.csv
1832,The Gift,58978653,43787265,0.742425653566554,15191388,0.257574346433446,2015,2015.csv
1833,Under the Tuscan Sun,58878723,43610723,0.7406873107624974,15268000,0.25931268923750267,2003,2003.csv
1834,A Walk Among the Tombstones,58834384,26307600,0.44714668891578774,32526784,0.5528533110842122,2014,2014.csv
1835,Shock Wave,58815633,0,0.0,58815633,1.0,2017,2017.csv
1836,Agent Cody Banks,58795814,47938330,0.8153357652298172,10857484,0.1846642347701828,2003,2003.csv
1837,Invincible,58480828,57806952,0.98847697573639,673876,0.011523024263609948,2006,2006.csv
1838,Monster,58469210,34469210,0.5895275479179555,24000000,0.4104724520820445,2003,2003.csv
1839,The Tree of Life,58409247,13303319,0.22776049484082547,45105928,0.7722395051591745,2011,2011.csv
1840,The Ninth Gate,58401898,18661336,0.31953303983373965,39740562,0.6804669601662604,2000,2000.csv
1841,Are We Done Yet?,58388068,49662533,0.8505596211883565,8725535,0.14944037881164352,2007,2007.csv
1842,Beginning of the Great Revival,58309289,151000,0.0025896388481087464,58158289,0.9974103611518913,2011,2011.csv
1843,Little Nicky,58292295,39464775,0.6770152899281114,18827520,0.32298471007188856,2000,2000.csv
1844,Must Love Dogs,58231520,43894863,0.7537990249953976,14336657,0.2462009750046023,2005,2005.csv
1845,Huo guo ying xiong,58106427,779818,0.013420511985705126,57326609,0.9865794880142948,2016,2016.csv
1846,L.O.R.D: Legend of Ravaging Dynasties,58089494,350456,0.0060330358532646195,57739038,0.9939669641467354,2016,2016.csv
1847,Doom,58072119,28212337,0.4858155253470258,29859782,0.5141844746529741,2005,2005.csv
1848,The Eye,58010320,31418697,0.5416053040217672,26591623,0.45839469597823285,2008,2008.csv
1849,Bowling for Columbine,58008423,21576018,0.3719462947648137,36432405,0.6280537052351862,2002,2002.csv
1850,Sky Captain and the World of Tomorrow,57947036,37762677,0.6516757302306195,20184359,0.3483242697693804,2004,2004.csv
1851,Aliens in the Attic,57881056,25200412,0.4353827269495567,32680644,0.5646172730504433,2009,2009.csv
1852,Snitch,57824674,42930462,0.7424246265530179,14894212,0.25757537344698217,2013,2013.csv
1853,Dolphin Tale 2,57824533,42024533,0.7267595745217692,15800000,0.27324042547823085,2014,2014.csv
1854,Nine Lives,57814445,19700032,0.3407458464748732,38114413,0.6592541535251268,2016,2016.csv
1855,Heartbreakers,57756408,40336607,0.6983918909915589,17419801,0.3016081090084411,2001,2001.csv
1856,That's My Boy,57719093,36931089,0.6398418110970663,20788004,0.3601581889029337,2012,2012.csv
1857,Cellular,57678321,32003620,0.5548639323256306,25674701,0.44513606767436936,2004,2004.csv
1858,The Motorcycle Diaries,57663224,16781387,0.2910240849523086,40881837,0.7089759150476914,2004,2004.csv
1859,Goldbuster,57628292,186135,0.0032299239408310073,57442157,0.996770076059169,2017,2017.csv
1860,Ready or Not,57615777,28714231,0.4983744469852416,28901546,0.5016255530147584,2019,2019.csv
1861,Drumline,57588485,56399184,0.9793482846440569,1189301,0.02065171535594312,2002,2002.csv
1862,Derailed,57479076,36024076,0.6267337352465443,21455000,0.3732662647534557,2005,2005.csv
1863,The Mist,57470220,25594957,0.4453603448881873,31875263,0.5546396551118127,2007,2007.csv
1864,Smokin' Aces,57232879,35787686,0.6252994192376728,21445193,0.3747005807623272,2007,2007.csv
1865,Walking Tall,57223890,46437717,0.8115092664969124,10786173,0.18849073350308762,2004,2004.csv
1866,Prom Night,57197876,43869350,0.766975158308326,13328526,0.233024841691674,2008,2008.csv
1867,She's the Man,57194667,33741133,0.5899349497043143,23453534,0.4100650502956858,2006,2006.csv
1868,Killer Elite,57084522,25124966,0.44013622466699465,31959556,0.5598637753330054,2011,2011.csv
1869,The 15:17 to Paris,57076286,36276286,0.6355754472181319,20800000,0.36442455278186814,2018,2018.csv
1870,The Descent,57051053,26024456,0.45616083545381714,31026597,0.5438391645461829,2005,2005.csv
1871,All the Money in the World,56996304,25113707,0.44061992160053043,31882597,0.5593800783994696,2017,2017.csv
1872,Elektra,56995646,24409722,0.4282734509229003,32585924,0.5717265490770996,2005,2005.csv
1873,Zoolander 2,56722693,28848693,0.5085917377018754,27874000,0.4914082622981247,2016,2016.csv
1874,Murder by Numbers,56714147,31945749,0.5632765489711059,24768398,0.4367234510288941,2002,2002.csv
1875,Into the Wild,56674477,18354356,0.32385576315066833,38320121,0.6761442368493317,2007,2007.csv
1876,Cradle 2 the Grave,56489558,34712347,0.6144913897184325,21777211,0.3855086102815674,2003,2003.csv
1877,The Big Sick,56411585,42873127,0.7600057151381228,13538458,0.2399942848618772,2017,2017.csv
1878,15 Minutes,56359980,24403552,0.43299433392275866,31956428,0.5670056660772413,2001,2001.csv
1879,Lucky Number Slevin,56308881,22495466,0.3995012083440266,33813415,0.6004987916559734,2006,2006.csv
1880,Frida,56298474,25885000,0.4597815564237141,30413474,0.5402184435762859,2002,2002.csv
1881,Eastern Promises,56106607,17266000,0.30773559342128814,38840607,0.6922644065787118,2007,2007.csv
1882,Kicking & Screaming,56070433,52842724,0.9424347409623178,3227709,0.05756525903768212,2005,2005.csv
1883,Remember Me,56032889,19068240,0.3403044237108674,36964649,0.6596955762891327,2010,2010.csv
1884,The Odd Life of Timothy Green,56012642,51854875,0.9257709179295631,4157767,0.07422908207043688,2012,2012.csv
1885,"Definitely, Maybe",55990299,32241649,0.5758434867440161,23748650,0.42415651325598386,2008,2008.csv
1886,Confidential Assignment,55972241,475618,0.008497390697649572,55496623,0.9915026093023505,2017,2017.csv
1887,Under the Sea 3D,55902624,36262926,0.6486802122204496,19639698,0.35131978777955036,2009,2009.csv
1888,Why Did I Get Married?,55862886,55204525,0.9882146976796007,658361,0.011785302320399272,2007,2007.csv
1889,Dallas Buyers Club,55736588,27298285,0.4897731630073947,28438303,0.5102268369926053,2013,2013.csv
1890,Dragonball Evolution,55720772,9362785,0.16803042499124024,46357987,0.8319695750087598,2009,2009.csv
1891,Pay It Forward,55707411,33519628,0.6017085949300355,22187783,0.3982914050699646,2000,2000.csv
1892,All Eyez on Me,55668698,44922302,0.806958014358446,10746396,0.1930419856415539,2017,2017.csv
1893,Cop Out,55611001,44875481,0.8069533040773713,10735520,0.19304669592262869,2010,2010.csv
1894,The Lizzie McGuire Movie,55534455,42734455,0.7695124585268731,12800000,0.23048754147312692,2003,2003.csv
1895,Out of Time,55495563,41088845,0.7403987414273101,14406718,0.25960125857268984,2003,2003.csv
1896,Spanglish,55470154,42726869,0.7702677191053048,12743285,0.2297322808946952,2004,2004.csv
1897,Lawless,55404159,37400127,0.6750418682467502,18004032,0.3249581317532498,2012,2012.csv
1898,Silent Hill: Revelation,55362705,17529157,0.31662392579986837,37833548,0.6833760742001317,2011,2011.csv
1899,Rugrats Go Wild,55250496,39402572,0.7131623216558997,15847924,0.2868376783441003,2003,2003.csv
1900,Extremely Loud & Incredibly Close,55247881,31847881,0.5764543440136646,23400000,0.4235456559863355,2011,2011.csv
1901,The Ant Bully,55181129,28142535,0.5100028852254908,27038594,0.48999711477450925,2006,2006.csv
1902,The Mothman Prophecies,55157539,35746370,0.6480776816384066,19411169,0.3519223183615933,2002,2002.csv
1903,End of Watch,55078146,41003371,0.744458083247755,14074775,0.2555419167522451,2012,2012.csv
1904,We Own the Night,55033767,28563179,0.5190118822867422,26470588,0.4809881177132578,2007,2007.csv
1905,Barbershop: The Next Cut,55030051,54030051,0.9818281106081476,1000000,0.018171889391852464,2016,2016.csv
1906,The Messengers,55010659,35374833,0.6430541579223764,19635826,0.35694584207762353,2007,2007.csv
1907,Downsizing,55003890,24449754,0.44450954287051336,30554136,0.5554904571294866,2017,2017.csv
1908,Analyze That,55003135,32130627,0.5841599210663174,22872508,0.4158400789336826,2002,2002.csv
1909,St. Vincent,54837234,44137712,0.8048858190039272,10699522,0.19511418099607286,2014,2014.csv
1910,The Three Stooges,54819301,44338224,0.8088068105793614,10481077,0.19119318942063854,2012,2012.csv
1911,The Crazies,54806823,39123589,0.7138452268981181,15683234,0.28615477310188187,2010,2010.csv
1912,Driven,54744738,32720065,0.5976842011738187,22024673,0.40231579882618124,2001,2001.csv
1913,The Punisher,54700105,33810189,0.6181009890200394,20889916,0.38189901097996065,2004,2004.csv
1914,Open Water,54683487,30610863,0.5597825720221536,24072624,0.4402174279778464,2004,2004.csv
1915,"Good Night, and Good Luck.",54641191,31558003,0.5775496914040545,23083188,0.4224503085959455,2005,2005.csv
1916,The Hot Chick,54639553,35081594,0.6420549231067099,19557959,0.3579450768932901,2002,2002.csv
1917,Early Man,54622814,8267544,0.15135697695838227,46355270,0.8486430230416178,2018,2018.csv
1918,Milk,54589558,31841299,0.5832855250449179,22748259,0.41671447495508207,2008,2008.csv
1919,The Age of Shadows,54491162,541719,0.009941410315309481,53949443,0.9900585896846905,2016,2016.csv
1920,No Escape,54418872,27288872,0.5014597141962075,27130000,0.4985402858037925,2015,2015.csv
1921,No Good Deed,54323210,52543632,0.9672409270365282,1779578,0.03275907296347178,2014,2014.csv
1922,Domestic Disturbance,54249294,45246095,0.8340402549754841,9003199,0.1659597450245159,2001,2001.csv
1923,The Five-Year Engagement,54169363,28835528,0.5323217110749484,25333835,0.4676782889250516,2012,2012.csv
1924,Tyler Perry's Madea's Big Happy Family,54161287,53345287,0.9849338882955274,816000,0.015066111704472605,2011,2011.csv
1925,Nine,54004950,19676965,0.36435484154693226,34327985,0.6356451584530677,2009,2009.csv
1926,"I, Tonya",53939297,30014539,0.5564503185868366,23924758,0.4435496814131634,2017,2017.csv
1927,Peppermint,53918723,35418723,0.6568909838610235,18500000,0.34310901613897643,2018,2018.csv
1928,Long Shot,53873809,30316271,0.5627274470234692,23557538,0.4372725529765308,2019,2019.csv
1929,Stranger Than Fiction,53653224,40660952,0.7578473196689913,12992272,0.24215268033100862,2006,2006.csv
1930,Bounce,53425292,36805288,0.6889113118932508,16620004,0.31108868810674917,2000,2000.csv
1931,Tyler Perry's A Madea Christmas,53396635,52543354,0.9840199480735069,853281,0.01598005192649312,2013,2013.csv
1932,Sinister 2,53329150,27740955,0.5201837081596088,25588195,0.4798162918403912,2015,2015.csv
1933,Æon Flux,53321673,25874337,0.48524990954428604,27447336,0.514750090455714,2005,2005.csv
1934,Little White Lies,53319615,206088,0.003865144187556493,53113527,0.9961348558124435,2010,2010.csv
1935,Radio,53293628,52333738,0.9819886535028165,959890,0.01801134649718349,2003,2003.csv
1936,3 Days to Kill,53260230,30697999,0.5763775147046868,22562231,0.4236224852953132,2014,2014.csv
1937,Pitch Black,53187659,39240659,0.7377775171492319,13947000,0.26222248285076805,2000,2000.csv
1938,Temptation: Confessions of a Marriage Counselor,53143144,51975354,0.9780255756038823,1167790,0.021974424396117777,2013,2013.csv
1939,Delivery Man,53120346,30664106,0.5772572716299702,22456240,0.4227427283700298,2013,2013.csv
1940,Big Fat Liar,52970014,48360547,0.91297969073597,4609467,0.08702030926403002,2002,2002.csv
1941,Untraceable,52933513,28687835,0.5419597788644785,24245678,0.45804022113552145,2008,2008.csv
1942,Pooh's Heffalump Movie,52858433,18098433,0.34239442928624086,34760000,0.6576055707137591,2005,2005.csv
1943,From Paris with Love,52830951,24077427,0.4557447205521627,28753524,0.5442552794478374,2010,2010.csv
1944,Found a Treasure Called Love,52715771,4364639,0.08279569694617575,48351132,0.9172043030538243,2015,2015.csv
1945,Wild,52501541,37880356,0.7215094124570554,14621185,0.2784905875429447,2014,2014.csv
1946,Teo-neol,52444295,568876,0.010847242774452398,51875419,0.9891527572255476,2016,2016.csv
1947,The Boy Next Door,52425855,35423380,0.6756853083273511,17002475,0.3243146916726489,2015,2015.csv
1948,The Night Before,52395996,43047372,0.8215775113808315,9348624,0.17842248861916854,2015,2015.csv
1949,Dragonfly,52323400,30323400,0.5795380269630797,22000000,0.4204619730369204,2002,2002.csv
1950,One Hour Photo,52223306,31597131,0.6050388881929459,20626175,0.3949611118070541,2002,2002.csv
1951,Patriots Day,52185751,31886361,0.6110166163940038,20299390,0.3889833836059962,2016,2016.csv
1952,Elizabethtown,52164016,26850426,0.51473080600236,25313590,0.48526919399764007,2005,2005.csv
1953,The Finest Hours,52099090,27569558,0.5291754232175648,24529532,0.47082457678243517,2016,2016.csv
1954,Teen Titans GO! to the Movies,52090236,29790236,0.5718967370391641,22300000,0.4281032629608359,2018,2018.csv
1955,Detective Dee: Mystery of the Phantom Flame,51899269,459836,0.008860163329082727,51439433,0.9911398366709173,2010,2010.csv
1956,Hanging Up,51880044,36050230,0.6948766273212875,15829814,0.3051233726787125,2000,2000.csv
1957,Blue Crush,51843679,40390647,0.7790852767219703,11453032,0.22091472327802972,2002,2002.csv
1958,Enough,51806184,40007742,0.7722580377663022,11798442,0.2277419622336978,2002,2002.csv
1959,The Texas Chainsaw Massacre: The Beginning,51764406,39517763,0.7634157532880799,12246643,0.23658424671192016,2006,2006.csv
1960,Slender Man,51738549,30569484,0.5908454061979975,21169065,0.4091545938020025,2018,2018.csv
1961,I Can Do Bad All by Myself,51733921,51733921,1.0,0,0.0,2009,2009.csv
1962,Doubt,51699984,33446470,0.6469338559176343,18253514,0.3530661440823657,2008,2008.csv
1963,Master,51636415,597251,0.011566469128424194,51039164,0.9884335308715758,2016,2016.csv
1964,College Road Trip,51549674,45610425,0.8847859057265813,5939249,0.11521409427341868,2008,2008.csv
1965,Daybreakers,51416464,30101577,0.5854462687282423,21314887,0.4145537312717576,2010,2010.csv
1966,Breaking In,51411620,46840590,0.9110895552406246,4571030,0.08891044475937541,2018,2018.csv
1967,I Spy,51386477,33561137,0.6531122380699498,17825340,0.3468877619300502,2002,2002.csv
1968,Hot Pursuit,51380201,34580201,0.6730258022929883,16800000,0.3269741977070117,2015,2015.csv
1969,Meet Dave,51339567,11803254,0.22990560087894782,39536313,0.7700943991210522,2008,2008.csv
1970,Defiance,51262751,28644813,0.5587841549900433,22617938,0.44121584500995664,2008,2008.csv
1971,Once Upon a Deadpool 2018 Re-release,51247568,6100309,0.11903606820912946,45147259,0.8809639317908705,2018,2018.csv
1972,The 100 Year-Old Man Who Climbed Out the Window and Disappeared,51167572,944193,0.018452956884489263,50223379,0.9815470431155108,2013,2013.csv
1973,Hollywood Homicide,51142659,30940691,0.6049879221180111,20201968,0.3950120778819889,2003,2003.csv
1974,Magic in the Moonlight,51029361,10539326,0.20653454782629946,40490035,0.7934654521737006,2014,2014.csv
1975,Talk to Her 2002 Re-release,51001550,9285469,0.1820624863361996,41716081,0.8179375136638004,2002,2002.csv
1976,Red Dawn,50950296,44806783,0.8794214463444923,6143513,0.12057855365550771,2012,2012.csv
1977,Just Friends,50912434,32619671,0.6407014640077903,18292763,0.3592985359922097,2005,2005.csv
1978,Unleashed,50871113,24537621,0.4823488135594753,26333492,0.5176511864405247,2005,2005.csv
1979,Team America: World Police,50826898,32786074,0.64505360921298,18040824,0.3549463907870199,2004,2004.csv
1980,Coco Before Chanel,50812934,6113834,0.12032042865306695,44699100,0.8796795713469331,2009,2009.csv
1981,The Skulls,50802120,35046120,0.6898554627247839,15756000,0.31014453727521607,2000,2000.csv
1982,What a Girl Wants,50732139,36105433,0.7116875754046168,14626706,0.2883124245953832,2003,2003.csv
1983,Sea Monsters: A Prehistoric Adventure,50652463,23746066,0.46880377761689496,26906397,0.531196222383105,2007,2007.csv
1984,Diary of a Mad Black Woman,50652203,50633099,0.9996228397015624,19104,0.0003771602984375625,2005,2005.csv
1985,Fever Pitch,50605163,42071069,0.8313592231685925,8534094,0.1686407768314075,2005,2005.csv
1986,War of the Arrows,50587661,251200,0.004965637766885486,50336461,0.9950343622331145,2011,2011.csv
1987,You Got Served,50576805,40363810,0.7980695894096118,10212995,0.20193041059038822,2004,2004.csv
1988,The Himalayas,50544493,696717,0.013784231647154914,49847776,0.9862157683528451,2015,2015.csv
1989,Alpha and Omega,50507267,25107267,0.49710207048027366,25400000,0.5028979295197263,2010,2010.csv
1990,Dragon Ball Z: Battle of Gods,50461371,2553002,0.05059319533747904,47908369,0.9494068046625209,2013,2013.csv
1991,About Last Night,50445860,48637684,0.9641561071612219,1808176,0.03584389283877805,2014,2014.csv
1992,Breakthrough,50444358,40713082,0.8070889117074302,9731276,0.1929110882925698,2019,2019.csv
1993,Just Mercy,50401502,36001502,0.7142942287711981,14400000,0.28570577122880186,2019,2019.csv
1994,Red Tails,50365498,49876377,0.9902885701636466,489121,0.009711429836353449,2012,2012.csv
1995,"Monsters, Inc. 2012 3D Release",50207820,34043006,0.6780419066193274,16164814,0.32195809338067255,2012,2012.csv
1996,The Closet,50104745,6678894,0.13329863269436856,43425851,0.8667013673056314,2001,2001.csv
1997,National Security,50097949,36381186,0.7262011065562783,13716763,0.2737988934437216,2003,2003.csv
1998,The Replacements,50054511,44737059,0.8937667775837427,5317452,0.10623322241625735,2000,2000.csv
1999,Uncut Gems,50023780,50023780,1.0,0,0.0,2019,2019.csv
2000,The Women,50007546,26902075,0.5379603110298594,23105471,0.46203968897014064,2008,2008.csv
2001,Drillbit Taylor,49944325,32862104,0.6579747348672748,17082221,0.3420252651327253,2008,2008.csv
2002,21 Bridges,49939757,28539757,0.5714836978481894,21400000,0.42851630215181064,2019,2019.csv
2003,Winnie the Pooh,49871429,26692846,0.535233229430823,23178583,0.464766770569177,2011,2011.csv
2004,The Wailing,49851770,786633,0.015779439727014708,49065137,0.9842205602729853,2016,2016.csv
2005,The Switch,49830607,27779426,0.5574771746208108,22051181,0.44252282537918913,2010,2010.csv
2006,Notes on a Scandal,49814392,17510118,0.35150721100841703,32304274,0.648492788991583,2006,2006.csv
2007,An Inconvenient Truth,49782012,24146161,0.4850378686984367,25635851,0.5149621313015633,2006,2006.csv
2008,She's Out of My League,49779728,32010860,0.6430501187149917,17768868,0.3569498812850082,2010,2010.csv
2009,This Christmas,49778552,49121934,0.9868092185566185,656618,0.01319078144338148,2007,2007.csv
2010,Raising Helen,49718611,37486512,0.7539734366271817,12232099,0.24602656337281828,2004,2004.csv
2011,The Boy and the Beast,49714378,490643,0.009869237426645467,49223735,0.9901307625733545,2015,2015.csv
2012,Surprise,49567466,0,0.0,49567466,1.0,2015,2015.csv
2013,Death Wish,49562710,34017028,0.6863431801852643,15545682,0.3136568198147357,2018,2018.csv
2014,CJ7,49529913,207378,0.004186924374367466,49322535,0.9958130756256325,2008,2008.csv
2015,The Grudge,49511319,21221803,0.4286252806151256,28289516,0.5713747193848744,2019,2019.csv
2016,Andhadhun,49391206,1193046,0.024155028731227983,48198160,0.975844971268772,2018,2018.csv
2017,The Black Dahlia,49332692,22545080,0.45700080587534125,26787612,0.5429991941246588,2006,2006.csv
2018,Capote,49327405,28750530,0.5828510540945748,20576875,0.4171489459054252,2005,2005.csv
2019,Entourage,49263404,32363404,0.6569461582476112,16900000,0.34305384175238884,2015,2015.csv
2020,The Hurt Locker,49230772,17017811,0.3456742664933225,32212961,0.6543257335066774,2008,2008.csv
2021,Death at a Funeral,49050886,42739347,0.8713267075338863,6311539,0.12867329246611367,2010,2010.csv
2022,Little,48987096,40860481,0.8341070268790786,8126615,0.16589297312092147,2019,2019.csv
2023,Whiplash,48982041,13092000,0.2672816349159481,35890041,0.732718365084052,2014,2014.csv
2024,So Young 2: Never Gone,48980792,96421,0.0019685471806989156,48884371,0.9980314528193011,2016,2016.csv
2025,The Berlin File,48972848,665210,0.013583241064518036,48307638,0.986416758935482,2013,2013.csv
2026,Trouble with the Curve,48963137,35763137,0.7304094302617906,13200000,0.2695905697382094,2012,2012.csv
2027,Luck-Key,48913975,466505,0.00953725392385305,48447470,0.9904627460761469,2016,2016.csv
2028,Florence Foster Jenkins,48902953,27383770,0.559961481262696,21519183,0.44003851873730404,2016,2016.csv
2029,Push,48858618,31811527,0.6510934672773594,17047091,0.34890653272264066,2009,2009.csv
2030,The Woman in Black 2: Angel of Death,48854305,26501323,0.5424562482262311,22352982,0.457543751773769,2015,2015.csv
2031,Isn't It Romantic,48791187,48791187,1.0,0,0.0,2019,2019.csv
2032,Mother's Day,48782670,32492859,0.6660738126879894,16289811,0.33392618731201057,2016,2016.csv
2033,How Do You Know,48668907,30212620,0.6207786831950017,18456287,0.3792213168049983,2010,2010.csv
2034,Concussion,48623572,34542474,0.7104059323325732,14081098,0.28959406766742685,2015,2015.csv
2035,The Last King of Scotland,48618191,17606684,0.36214189869795854,31011507,0.6378581013020415,2006,2006.csv
2036,Shutter,48555306,25928550,0.534000341795807,22626756,0.465999658204193,2008,2008.csv
2037,Fat Albert,48551322,48116322,0.9910404087452037,435000,0.008959591254796317,2004,2004.csv
2038,Her,48517427,25568251,0.5269910747740189,22949176,0.47300892522598115,2013,2013.csv
2039,Logan Lucky,48453605,27780977,0.5733521169374292,20672628,0.4266478830625709,2017,2017.csv
2040,Homefront,48449416,20158898,0.4160813414138986,28290518,0.5839186585861015,2013,2013.csv
2041,Mr. Brooks,48443734,28549298,0.5893290141507259,19894436,0.41067098584927414,2007,2007.csv
2042,9,48428063,31749894,0.6556094139053218,16678169,0.3443905860946782,2009,2009.csv
2043,Chef,48428048,31424003,0.6488802315550691,17004045,0.3511197684449309,2014,2014.csv
2044,Boo 2! A Madea Halloween,48333932,47319572,0.979013501322425,1014360,0.020986498677575,2017,2017.csv
2045,The Last Stand,48330757,12050299,0.24932982117370933,36280458,0.7506701788262907,2013,2013.csv
2046,Secondhand Lions,48249017,42070939,0.8719543239606311,6178078,0.12804567603936884,2003,2003.csv
2047,Charlie St. Cloud,48190704,31162545,0.6466505448851713,17028159,0.3533494551148288,2010,2010.csv
2048,Arthur,48147945,33035397,0.6861226787560715,15112548,0.3138773212439285,2011,2011.csv
2049,Boyhood,48137666,25352281,0.5266620321807874,22785385,0.4733379678192125,2014,2014.csv
2050,21 & Over,48065672,25682380,0.5343185465086184,22383292,0.4656814534913815,2013,2013.csv
2051,Countdown,48021766,25621766,0.5335448513076341,22400000,0.4664551486923659,2019,2019.csv
2052,"Yo-kai Watch Movie: It's the Secret of Birth, Meow! 2016 Re-release",47899805,257343,0.005372527090663521,47642462,0.9946274729093365,2016,2016.csv
2053,Midsommar,47863365,27426361,0.5730136399728686,20437004,0.4269863600271314,2019,2019.csv
2054,The Nanny Diaries,47817020,25930652,0.5422891681664813,21886368,0.4577108318335187,2007,2007.csv
2055,Phantom Thread,47756590,21198205,0.4438802058522185,26558385,0.5561197941477815,2017,2017.csv
2056,Book of Shadows: Blair Witch 2,47737094,26437094,0.5538061030694496,21300000,0.4461938969305505,2000,2000.csv
2057,The Fourth Kind,47709193,25486040,0.5341955794557246,22223153,0.4658044205442754,2009,2009.csv
2058,Scott Pilgrim vs. the World,47664559,31524275,0.6613776705665104,16140284,0.3386223294334896,2010,2010.csv
2059,Queen & Slim,47659440,43808310,0.9191948121925059,3851130,0.08080518780749417,2019,2019.csv
2060,Man on a Ledge,47636031,18620000,0.3908805920459662,29016031,0.6091194079540337,2012,2012.csv
2061,Coming Home,47587984,377607,0.007934923236084135,47210377,0.9920650767639159,2014,2014.csv
2062,A Walk to Remember,47494916,41281092,0.8691686495455639,6213824,0.130831350454436,2002,2002.csv
2063,Darkness Falls,47488536,32551396,0.685457980848262,14937140,0.314542019151738,2003,2003.csv
2064,Beauty and the Beast,47430624,0,0.0,47430624,1.0,2014,2014.csv
2065,Crazy Heart,47405566,39464306,0.8324825401304142,7941260,0.16751745986958577,2009,2009.csv
2066,Nightcrawler,47398992,32381217,0.683162565988745,15017775,0.3168374340112549,2014,2014.csv
2067,Almost Famous,47383689,32534850,0.6866255179076496,14848839,0.31337448209235036,2000,2000.csv
2068,Rough Night,47347283,22105643,0.466883031070653,25241640,0.533116968929347,2017,2017.csv
2069,Texas Chainsaw,47340586,34341945,0.7254228961170865,12998641,0.2745771038829135,2013,2013.csv
2070,Broken Flowers,47329961,13744960,0.29040716936149596,33585001,0.709592830638504,2005,2005.csv
2071,Fantasy Island,47315959,26441782,0.5588343247993769,20874177,0.4411656752006231,2020,2020.csv
2072,A Monster Calls,47309313,3740823,0.07907159843982516,43568490,0.9209284015601749,2016,2016.csv
2073,Tiny Times 2.0,47289937,43788,0.0009259475224084143,47246149,0.9990740524775916,2013,2013.csv
2074,Golden Job,47287851,285795,0.006043729921243407,47002056,0.9939562700787566,2018,2018.csv
2075,Mortdecai,47275695,7696134,0.16279261468287246,39579561,0.8372073853171276,2015,2015.csv
2076,The Watcher,47267829,28946615,0.612395695177792,18321214,0.3876043048222079,2000,2000.csv
2077,Deck the Halls,47232776,35093569,0.7429918791984617,12139207,0.25700812080153834,2006,2006.csv
2078,High Fidelity,47126295,27287137,0.5790214783487647,19839158,0.4209785216512353,2000,2000.csv
2079,Soul Surfer,47120948,43853424,0.9306566582658736,3267524,0.0693433417341264,2011,2011.csv
2080,The Wedding Date,47096206,31726995,0.6736635006225342,15369211,0.3263364993774658,2005,2005.csv
2081,Land of the Dead,47074133,20700082,0.4397336855890686,26374051,0.5602663144109313,2005,2005.csv
2082,Dracula 2000,47053625,33022767,0.7018113269700262,14030858,0.29818867302997376,2000,2000.csv
2083,The Place Beyond the Pines,47052899,21403519,0.45488204669387106,25649380,0.5451179533061289,2013,2013.csv
2084,Son of Bigfoot,47046281,289308,0.006149434000957483,46756973,0.9938505659990425,2017,2017.csv
2085,Parker,46922566,17616641,0.3754406994706982,29305925,0.6245593005293019,2013,2013.csv
2086,Death at a Funeral,46789413,8580428,0.18338396337650142,38208985,0.8166160366234986,2007,2007.csv
2087,47 Meters Down: Uncaged,46783103,22260900,0.47583205414997803,24522203,0.5241679458500219,2019,2019.csv
2088,Mary Queen of Scots,46710283,16468499,0.352566885539957,30241784,0.647433114460043,2018,2018.csv
2089,Uncle Drew,46664414,42469946,0.9101142039413588,4194468,0.08988579605864118,2018,2018.csv
2090,Get Rich or Die Tryin',46563961,30985352,0.6654363446443055,15578609,0.3345636553556945,2005,2005.csv
2091,Torque,46546197,21215059,0.45578501289804624,25331138,0.5442149871019538,2003,2003.csv
2092,The Big Wedding,46522137,21819348,0.4690100112984922,24702789,0.5309899887015078,2013,2013.csv
2093,Fantastic Mr. Fox,46471023,21002919,0.45195731972588593,25468104,0.5480426802741141,2009,2009.csv
2094,Risen,46432579,36880033,0.7942706133122608,9552546,0.20572938668773924,2016,2016.csv
2095,The Nativity Story,46432264,37629831,0.8104242127844552,8802433,0.18957578721554477,2006,2006.csv
2096,Tyler Perry's Acrimony,46403669,43549096,0.9384838944523978,2854573,0.061516105547602284,2018,2018.csv
2097,A Werewolf Boy,46282588,342922,0.007409309090494248,45939666,0.9925906909095058,2012,2012.csv
2098,The Thousand Faces of Dunjia,46263237,124187,0.002684356047113608,46139050,0.9973156439528864,2017,2017.csv
2099,Asterix: The Secret of the Magic Potion,46221204,1271953,0.027518820150163114,44949251,0.9724811798498368,2018,2018.csv
2100,The Fog,46201432,29550869,0.6396093740124765,16650563,0.3603906259875235,2005,2005.csv
2101,The Battleship Island,46183383,1104957,0.023925423566307388,45078426,0.9760745764336927,2017,2017.csv
2102,Eddie the Eagle,46152800,15789389,0.342111182853478,30363411,0.657888817146522,2016,2016.csv
2103,Napoleon Dynamite,46118097,44540956,0.9658021231882139,1577141,0.03419787681178606,2004,2004.csv
2104,Into the Blue,46117696,18801234,0.4076793862382024,27316462,0.5923206137617977,2005,2005.csv
2105,The World's End,46089287,26004851,0.5642276696534707,20084436,0.43577233034652935,2013,2013.csv
2106,The Hunted,46061847,34244097,0.7434373398009854,11817750,0.2565626601990146,2003,2003.csv
2107,Let's Get Married,45972724,462918,0.010069405502271303,45509806,0.9899305944977287,2015,2015.csv
2108,Eight Legged Freaks,45867333,17322606,0.37766760932012333,28544727,0.6223323906798767,2002,2002.csv
2109,One Missed Call,45847751,26890041,0.5865073076321672,18957710,0.4134926923678328,2008,2008.csv
2110,Avatar 2010 Special Edition,45823494,10741486,0.23441001683546872,35082008,0.7655899831645313,2010,2010.csv
2111,Somewhere Only We Know,45737711,482341,0.010545805407708313,45255370,0.9894541945922917,2015,2015.csv
2112,Chasing the Dragon II: Wild Wild Bunch,45733356,196634,0.004299575128490461,45536722,0.9957004248715096,2019,2019.csv
2113,"McFarland, USA",45710059,44482410,0.9731426949153577,1227649,0.026857305084642312,2015,2015.csv
2114,Earth to Echo,45681062,38934842,0.8523191076424624,6746220,0.14768089235753756,2014,2014.csv
2115,That Awkward Moment,45640143,26068955,0.5711847791537376,19571188,0.42881522084626245,2014,2014.csv
2116,The Debt,45636368,31177548,0.6831732972264576,14458820,0.31682670277354236,2011,2011.csv
2117,Hero,45565534,88675,0.0019460981188105905,45476859,0.9980539018811894,2015,2015.csv
2118,Machete,45491656,26593646,0.5845829397813085,18898010,0.4154170602186915,2010,2010.csv
2119,Queen of the Damned,45479110,30336800,0.6670491133181806,15142310,0.33295088668181944,2002,2002.csv
2120,Wei ai zhi jian ru jia jing,45386560,271734,0.005987102789900799,45114826,0.9940128972100992,2014,2014.csv
2121,Good Boy,45312217,37667746,0.8312933794433408,7644471,0.16870662055665914,2003,2003.csv
2122,The Last House on the Left,45289053,32752215,0.7231817145746015,12536838,0.2768182854253985,2009,2009.csv
2123,The Spy Next Door,45236543,24307086,0.5373329699398117,20929457,0.4626670300601883,2009,2009.csv
2124,Blair Witch,45173154,20777061,0.4599426686035693,24396093,0.5400573313964308,2016,2016.csv
2125,Flatliners,45158254,16883115,0.3738655396198445,28275139,0.6261344603801555,2017,2017.csv
2126,Deuce Bigalow: European Gigolo,45109561,22400154,0.49657220117925777,22709407,0.5034277988207423,2005,2005.csv
2127,Monster's Ball,44909486,31273922,0.6963767521186949,13635564,0.30362324788130507,2001,2001.csv
2128,Grudge Match,44907260,29807260,0.6637514735924659,15100000,0.3362485264075341,2013,2013.csv
2129,Child's Play,44902237,29208403,0.6504888164035124,15693834,0.34951118359648764,2019,2019.csv
2130,Still Alice,44779195,18754371,0.41881885103115407,26024824,0.5811811489688459,2015,2015.csv
2131,The Wrestler,44734660,26238243,0.5865305112411718,18496417,0.41346948875882816,2008,2008.csv
2132,The Man from Nowhere,44723232,528175,0.011809857570222116,44195057,0.9881901424297779,2010,2010.csv
2133,Hellboy,44664690,21903748,0.4904041201226293,22760942,0.5095958798773706,2019,2019.csv
2134,Lakeview Terrace,44655002,39263506,0.8792633353817787,5391496,0.12073666461822127,2008,2008.csv
2135,Uptown Girls,44617342,37182494,0.8333641658886807,7434848,0.16663583411131933,2003,2003.csv
2136,The Gift,44567606,12008642,0.2694477688570483,32558964,0.7305522311429516,2000,2000.csv
2137,Mother!,44516999,17800004,0.3998473482006278,26716995,0.6001526517993722,2017,2017.csv
2138,Recess: School's Out,44460850,36706141,0.8255834290167642,7754709,0.17441657098323582,2001,2001.csv
2139,Oculus,44446287,27695246,0.6231172021185931,16751041,0.37688279788140683,2014,2014.csv
2140,Notorious,44420167,36843682,0.8294359181495198,7576485,0.17056408185048022,2009,2009.csv
2141,The Sisterhood of the Traveling Pants 2,44352417,44089964,0.9940825547342775,262453,0.005917445265722497,2008,2008.csv
2142,A Man Apart,44350926,26736098,0.6028306601760693,17614828,0.3971693398239306,2003,2003.csv
2143,Dark Water 2005 Re-release,44347079,25473352,0.5744087902610227,18873727,0.4255912097389774,2005,2005.csv
2144,House at the End of the Street,44287131,31611916,0.7137946235442526,12675215,0.2862053764557474,2012,2012.csv
2145,The Girl Who Kicked the Hornet's Nest,44276335,5190196,0.11722280084835386,39086139,0.8827771991516461,2009,2009.csv
2146,The Good the Bad the Weird,44261209,128486,0.0029029030815674287,44132723,0.9970970969184326,2008,2008.csv
2147,Hardball,44102389,40222729,0.912030615847137,3879660,0.08796938415286301,2001,2001.csv
2148,Winchester,44019588,25091816,0.5700147852360635,18927772,0.4299852147639365,2018,2018.csv
2149,Semi-Pro,44004502,33479698,0.7608243811053697,10524804,0.23917561889463038,2008,2008.csv
2150,Wind River,43980821,33800859,0.7685363354176585,10179962,0.23146366458234147,2017,2017.csv
2151,Max,43967255,42656255,0.9701823550276223,1311000,0.029817644972377738,2015,2015.csv
2152,Timeline,43935763,19481943,0.4434187930228957,24453820,0.5565812069771042,2003,2003.csv
2153,The Transporter,43928932,25296447,0.5758493514023969,18632485,0.42415064859760304,2002,2002.csv
2154,Battle of Memories,43892362,594552,0.01354568250393998,43297810,0.98645431749606,2017,2017.csv
2155,Of Gods and Men,43803417,3951596,0.09021204898238874,39851821,0.9097879510176112,2010,2010.csv
2156,Café Society,43763247,11103205,0.25371072215002693,32660042,0.746289277849973,2016,2016.csv
2157,Richard Jewell,43745542,22345542,0.5108072955182497,21400000,0.4891927044817504,2019,2019.csv
2158,The DUFF,43709744,34030343,0.7785527867653491,9679401,0.22144721323465083,2015,2015.csv
2159,The Sea Inside,43685449,2104923,0.04818361830274424,41580526,0.9518163816972558,2004,2004.csv
2160,"Welcome Home, Roscoe Jenkins",43655418,42436517,0.9720790441177313,1218901,0.027920955882268724,2008,2008.csv
2161,Judy,43623562,24313888,0.5573567788893534,19309674,0.4426432211106466,2019,2019.csv
2162,Boy,43551154,256211,0.005882989920313018,43294943,0.994117010079687,2010,2010.csv
2163,We Are Marshall,43545364,43545364,1.0,0,0.0,2006,2006.csv
2164,League of Gods,43498766,181633,0.004175589716728976,43317133,0.9958244102832711,2016,2016.csv
2165,Harold & Kumar Escape from Guantanamo Bay,43495888,38108728,0.8761455335731966,5387160,0.12385446642680338,2008,2008.csv
2166,Brothers,43474578,28544157,0.6565712265223138,14930421,0.3434287734776862,2009,2009.csv
2167,Last Holiday,43446924,38399961,0.8838361261202289,5046963,0.1161638738797711,2006,2006.csv
2168,The Master of Disguise,43411001,40388794,0.9303815408449116,3022207,0.06961845915508837,2002,2002.csv
2169,In the Bedroom,43368779,35930604,0.8284900988335411,7438175,0.17150990116645895,2001,2001.csv
2170,Harriet,43347017,43082155,0.9938897294824232,264862,0.006110270517576792,2019,2019.csv
2171,The Duchess,43343384,13848978,0.31951769155818566,29494406,0.6804823084418143,2008,2008.csv
2172,Orange County,43325009,41076018,0.94809023582661,2248991,0.051909764173390015,2002,2002.csv
2173,Beastly,43202283,27865571,0.6450022791619601,15336712,0.35499772083804,2011,2011.csv
2174,The Snowman,43155261,6700035,0.1552541878961177,36455226,0.8447458121038823,2017,2017.csv
2175,Freedom Writers,43095175,36605602,0.8494130027317444,6489573,0.15058699726825567,2007,2007.csv
2176,Annihilation,43070915,32732301,0.7599629819798349,10338614,0.2400370180201651,2018,2018.csv
2177,See Spot Run,43057552,33357476,0.7747183583497733,9700076,0.22528164165022665,2001,2001.csv
2178,When in Rome,43053376,32680633,0.7590724824924299,10372743,0.24092751750757013,2010,2010.csv
2179,Gifted,43046590,24801212,0.5761481223019059,18245378,0.42385187769809407,2017,2017.csv
2180,The Possession of Hannah Grace,43016528,14837422,0.3449237465190124,28179106,0.6550762534809876,2018,2018.csv
2181,Legend,42972994,1872994,0.04358537364187378,41100000,0.9564146263581262,2015,2015.csv
2182,The Gallows,42964410,22764410,0.5298434215668271,20200000,0.47015657843317293,2015,2015.csv
2183,Glory Road,42938449,42647449,0.9932228572112607,291000,0.006777142788739295,2006,2006.csv
2184,Crank,42931041,27838408,0.6484447465413196,15092633,0.3515552534586804,2006,2006.csv
2185,A Lot Like Love,42886719,21845719,0.5093819137808141,21041000,0.49061808621918596,2005,2005.csv
2186,The Warlords,42883181,129078,0.0030099912597435345,42754103,0.9969900087402565,2007,2007.csv
2187,Basic,42792561,26793311,0.6261207643076094,15999250,0.37387923569239057,2003,2003.csv
2188,Zack and Miri Make a Porno,42782463,31457946,0.735300022347942,11324517,0.26469997765205805,2008,2008.csv
2189,Shaolin Soccer,42776760,489600,0.01144546711812676,42287160,0.9885545328818732,2001,2001.csv
2190,Shaolin,42741494,66099,0.001546483143523247,42675395,0.9984535168564768,2011,2011.csv
2191,Almost Christmas,42580920,42158780,0.9900861700498721,422140,0.009913829950127897,2016,2016.csv
2192,Oliver Twist,42580321,2080321,0.04885639542266485,40500000,0.9511436045773352,2005,2005.csv
2193,Bangkok Dangerous,42487390,15298133,0.36006290336968216,27189257,0.6399370966303178,2008,2008.csv
2194,Man of the Year,42472472,37327390,0.8788607830502543,5145082,0.1211392169497457,2006,2006.csv
2195,Love the Coopers,42426912,26302731,0.6199539339558816,16124181,0.3800460660441184,2015,2015.csv
2196,8 Women,42426583,3098776,0.0730385475540182,39327807,0.9269614524459818,2002,2002.csv
2197,My Name Is Khan,42345360,4018771,0.09490463654105195,38326589,0.905095363458948,2010,2010.csv
2198,A Good Year,42269923,7459300,0.17646826562707482,34810623,0.8235317343729252,2006,2006.csv
2199,Loving Vincent,42187665,6735118,0.15964661708582353,35452547,0.8403533829141765,2017,2017.csv
2200,Long Day's Journey Into Night,42140994,521365,0.01237191984602926,41619629,0.9876280801539707,2018,2018.csv
2201,Jobs,42128352,16131410,0.3829110144161348,25996942,0.6170889855838653,2013,2013.csv
2202,Going the Distance,42059111,17804299,0.4233161038520286,24254812,0.5766838961479713,2010,2010.csv
2203,Bang Bang,42045981,2546172,0.060556846087144456,39499809,0.9394431539128556,2014,2014.csv
2204,The Sisterhood of the Traveling Pants,42013878,39053061,0.9295276432230322,2960817,0.07047235677696784,2005,2005.csv
2205,Mary and the Witch's Flower,41978431,2418404,0.05761063342267366,39560027,0.9423893665773263,2017,2017.csv
2206,Meet the Browns,41975388,41975388,1.0,0,0.0,2008,2008.csv
2207,"As Above, So Below",41898409,21321100,0.5088761246280259,20577309,0.49112387537197416,2014,2014.csv
2208,Call Me by Your Name,41887595,18095701,0.4320062061333433,23791894,0.5679937938666567,2017,2017.csv
2209,The Guilt Trip,41863726,37134215,0.8870260377683534,4729511,0.11297396223164656,2012,2012.csv
2210,The Informant!,41771168,33316821,0.7976032894268122,8454347,0.2023967105731877,2009,2009.csv
2211,Balls of Fury,41739111,32886940,0.7879166377070178,8852171,0.21208336229298225,2007,2007.csv
2212,Fly Me to the Moon 3D,41721414,13816982,0.33117242862382373,27904432,0.6688275713761763,2008,2008.csv
2213,Wimbledon,41682237,17001133,0.4078747740914193,24681104,0.5921252259085806,2004,2004.csv
2214,T2 Trainspotting,41681746,2402004,0.05762724047116452,39279742,0.9423727595288355,2017,2017.csv
2215,Overlord,41657844,21704844,0.5210265802522089,19953000,0.47897341974779106,2018,2018.csv
2216,Born to Be Wild,41644475,25978556,0.6238175892480335,15665919,0.3761824107519665,2011,2011.csv
2217,The Uninvited,41633384,28596818,0.6868722945989689,13036566,0.3131277054010311,2009,2009.csv
2218,Never Back Down,41627431,24850922,0.5969842818308918,16776509,0.40301571816910825,2008,2008.csv
2219,My Best Friend's Girl,41624687,19219250,0.4617271956903844,22405437,0.5382728043096155,2008,2008.csv
2220,Undercover Brother,41604473,39089928,0.9395607054078056,2514545,0.06043929459219445,2002,2002.csv
2221,Safe,41564670,17142080,0.4124194899177595,24422590,0.5875805100822405,2012,2012.csv
2222,The Great Battle,41509280,472166,0.0113749503725432,41037114,0.9886250496274568,2018,2018.csv
2223,Gridiron Gang,41480851,38432823,0.9265196367355144,3048028,0.07348036326448558,2006,2006.csv
2224,The Lady in the Van,41387687,10021175,0.24212938017048405,31366512,0.757870619829516,2015,2015.csv
2225,Shark Night 3D,41363927,18877153,0.45636752525938845,22486774,0.5436324747406115,2011,2011.csv
2226,Ricki and the Flash,41325328,26822144,0.6490485447568619,14503184,0.35095145524313803,2015,2015.csv
2227,Quarantine,41319906,31691811,0.7669865221861831,9628095,0.2330134778138169,2008,2008.csv
2228,Leatherheads,41319039,31373938,0.7593094795839758,9945101,0.2406905204160242,2008,2008.csv
2229,Pinocchio,41314585,3675719,0.08896904083630515,37638866,0.9110309591636948,2002,2002.csv
2230,This Is Where I Leave You,41296320,34296320,0.8304933708378858,7000000,0.1695066291621142,2014,2014.csv
2231,Evangelion: 2.0 You Can (Not) Advance,41162041,133640,0.0032466806007019912,41028401,0.996753319399298,2009,2009.csv
2232,The Concert,41146351,657986,0.01599135728949573,40488365,0.9840086427105043,2009,2009.csv
2233,The Darkest Minds,41142379,12695691,0.30857940908084097,28446688,0.6914205909191591,2018,2018.csv
2234,50/50,41097853,35014192,0.8519713183070659,6083661,0.14802868169293418,2011,2011.csv
2235,The Intruder,41092397,35419122,0.8619385722375845,5673275,0.1380614277624155,2019,2019.csv
2236,Fist Fight,41087017,32187017,0.7833865622320549,8900000,0.21661343776794503,2017,2017.csv
2237,Whale Rider,41062976,20779666,0.5060438386151067,20283310,0.4939561613848933,2003,2003.csv
2238,Dredd,41037742,13414714,0.32688723468264896,27623028,0.6731127653173511,2012,2012.csv
2239,Fright Night,41002607,18302607,0.4463766657568871,22700000,0.5536233342431128,2011,2011.csv
2240,Twisted,40954603,25198598,0.6152812175959806,15756005,0.3847187824040194,2004,2004.csv
2241,Breach,40953935,33231264,0.8114303057813614,7722671,0.18856969421863856,2007,2007.csv
2242,Drive Angry,40909909,10721033,0.262064454848824,30188876,0.737935545151176,2011,2011.csv
2243,Underwater,40882928,17291078,0.4229412824834855,23591850,0.5770587175165145,2020,2020.csv
2244,The Love Guru,40877556,32235793,0.7885939413794699,8641763,0.21140605862053005,2008,2008.csv
2245,Where the Heart Is,40863718,33772838,0.8264749184105078,7090880,0.17352508158949217,2000,2000.csv
2246,Gamer,40828540,20534907,0.5029547223584286,20293633,0.4970452776415713,2009,2009.csv
2247,Fighting with My Family,40811919,22958886,0.5625534540534592,17853033,0.43744654594654075,2019,2019.csv
2248,30 Minutes or Less,40662632,37053924,0.9112524737700206,3608708,0.0887475262299794,2011,2011.csv
2249,The Circle,40656399,20497844,0.504172639588666,20158555,0.495827360411334,2017,2017.csv
2250,The Roommate,40492652,37300000,0.9211547813662587,3192652,0.07884521863374125,2011,2011.csv
2251,War,40481352,22486409,0.5554757410276218,17994943,0.4445242589723782,2007,2007.csv
2252,Holmes & Watson,40466970,30573626,0.7555205146320567,9893344,0.24447948536794328,2018,2018.csv
2253,Serenity,40445129,25514517,0.6308427647739732,14930612,0.36915723522602684,2005,2005.csv
2254,Bless the Child,40443010,29381494,0.7264912774790996,11061516,0.2735087225209004,2000,2000.csv
2255,The Ringer,40442443,35428675,0.8760270738342884,5013768,0.12397292616571161,2005,2005.csv
2256,The Witch,40423945,25138705,0.6218765882449128,15285240,0.37812341175508724,2016,2016.csv
2257,The Boy in the Striped Pajamas,40416563,9046156,0.22382299058927896,31370407,0.7761770094107211,2008,2008.csv
2258,The Art of War,40400425,30208599,0.7477297330411747,10191826,0.2522702669588253,2000,2000.csv
2259,Bad Education,40350837,5211842,0.12916316952731366,35138995,0.8708368304726863,2004,2004.csv
2260,Magnificent Desolation: Walking on the Moon 3D,40339402,34137524,0.8462575622712504,6201878,0.15374243772874968,2005,2005.csv
2261,Carol,40272135,12711491,0.3156398586764769,27560644,0.6843601413235231,2015,2015.csv
2262,The Invasion,40170558,15074191,0.37525470768914887,25096367,0.6247452923108512,2007,2007.csv
2263,Crimson Rivers 2: Angels of the Apocalypse,40152148,152148,0.0037892866902164237,40000000,0.9962107133097836,2004,2004.csv
2264,Diary of a Wimpy Kid: The Long Haul,40140972,20738724,0.5166472799911273,19402248,0.48335272000887275,2017,2017.csv
2265,All About Steve,40105542,33862903,0.8443447292147305,6242639,0.15565527078526953,2009,2009.csv
2266,The Wild Life,40075446,8005586,0.19976286726790266,32069860,0.8002371327320974,2016,2016.csv
2267,Northern Limit Line,40034677,337907,0.008440357842777151,39696770,0.9915596421572228,2015,2015.csv
2268,Dancer in the Dark,40031879,4184036,0.10451760208407904,35847843,0.895482397915921,2000,2000.csv
2269,Om Shanti Om,39990809,3597372,0.0899549694030946,36393437,0.9100450305969054,2007,2007.csv
2270,Dream House,39984400,21302340,0.532766278848751,18682060,0.467233721151249,2011,2011.csv
2271,Black Knight,39976235,33426971,0.8361710651340728,6549264,0.16382893486592723,2001,2001.csv
2272,Brotherhood of Blades 2,39966092,14204,0.0003554012736596813,39951888,0.9996445987263404,2017,2017.csv
2273,The Secret Life of Bees,39952437,37770162,0.945378175554097,2182275,0.054621824445903015,2008,2008.csv
2274,Astro Boy,39886986,19551067,0.49016155294360925,20335919,0.5098384470563908,2009,2009.csv
2275,Monte Carlo,39782683,23186769,0.5828357277964384,16595914,0.41716427220356156,2011,2011.csv
2276,Memento,39723096,25544867,0.6430734150228371,14178229,0.3569265849771629,2001,2001.csv
2277,The Forest,39712000,26594261,0.6696782080983078,13117739,0.3303217919016922,2016,2016.csv
2278,The November Man,39661919,25018119,0.6307843803523475,14643800,0.3692156196476524,2014,2014.csv
2279,Down with Love,39468111,20305251,0.5144723293192319,19162860,0.4855276706807681,2003,2003.csv
2280,The Legend of Bagger Vance,39459427,30919168,0.7835686007300613,8540259,0.2164313992699387,2000,2000.csv
2281,Agora,39457342,619423,0.01569854857430589,38837919,0.9843014514256941,2009,2009.csv
2282,Don Jon,39439355,24477704,0.6206415901071405,14961651,0.37935840989285957,2013,2013.csv
2283,Crocodile Dundee in Los Angeles,39438674,25635682,0.6500137910316153,13802992,0.34998620896838467,2001,2001.csv
2284,Halloween II,39421467,33392973,0.8470758584402757,6028494,0.1529241415597243,2009,2009.csv
2285,Frank Miller's Sin City: A Dame to Kill For,39407616,13757804,0.3491153588179503,25649812,0.6508846411820497,2014,2014.csv
2286,Thank You for Smoking,39323027,24793509,0.6305086584509376,14529518,0.3694913415490623,2006,2006.csv
2287,Cirque du Freak: The Vampire's Assistant,39291383,13869515,0.35299126528582614,25421868,0.6470087347141739,2009,2009.csv
2288,The Gambler,39280992,33680992,0.8574374089126874,5600000,0.14256259108731267,2014,2014.csv
2289,Dumb and Dumberer: When Harry Met Lloyd,39267515,26276465,0.6691654666713694,12991050,0.33083453332863055,2003,2003.csv
2290,Mars Needs Moms,39233678,21392758,0.5452651673391417,17840920,0.45473483266085835,2011,2011.csv
2291,Scoop,39220946,10525717,0.26836978893879815,28695229,0.7316302110612019,2006,2006.csv
2292,Absolutely Fabulous: The Movie,39219109,4772155,0.12167933238870877,34446954,0.8783206676112912,2016,2016.csv
2293,Samba,39178695,151530,0.0038676632797493638,39027165,0.9961323367202506,2014,2014.csv
2294,The Spirit,39164441,19806188,0.5057186441139297,19358253,0.49428135588607025,2008,2008.csv
2295,Show Dogs,39156854,17857020,0.4560381689499366,21299834,0.5439618310500635,2018,2018.csv
2296,Women Who Flirt,39156132,375495,0.009589685722787941,38780637,0.990410314277212,2014,2014.csv
2297,Haunted Castle,39093166,13651656,0.3492082478047442,25441510,0.6507917521952559,2001,2001.csv
2298,Believer,39047153,365639,0.009364037372968011,38681514,0.990635962627032,2018,2018.csv
2299,The Life of David Gale,38955598,19955598,0.512265220521066,19000000,0.48773477947893396,2003,2003.csv
2300,The Spy Gone North,38844509,500803,0.012892504317663018,38343706,0.987107495682337,2018,2018.csv
2301,First Sunday,38810311,37931869,0.9773657572597138,878442,0.02263424274028621,2008,2008.csv
2302,The Wicker Man,38805380,23649127,0.6094290791637654,15156253,0.39057092083623457,2006,2006.csv
2303,Criminal,38803993,14708696,0.3790510940459143,24095297,0.6209489059540857,2015,2015.csv
2304,Clockstoppers,38793283,36989956,0.9535144524891075,1803327,0.046485547510892546,2002,2002.csv
2305,Dreamer: Inspired by a True Story,38741732,32751093,0.8453698714347618,5990639,0.15463012856523814,2005,2005.csv
2306,Someone Like You,38689940,27343067,0.7067229103999645,11346873,0.29327708960003557,2001,2001.csv
2307,On the Basis of Sex,38673750,24622687,0.6366769966708685,14051063,0.36332300332913153,2018,2018.csv
2308,"Crouching Tiger, Hidden Dragon: Sword of Destiny",38659039,0,0.0,38659039,1.0,2016,2016.csv
2309,Basic Instinct 2,38629478,5971336,0.15457977454419652,32658142,0.8454202254558034,2006,2006.csv
2310,Accepted,38623262,36323505,0.9404566864393794,2299757,0.05954331356062054,2006,2006.csv
2311,Head of State,38620484,38125247,0.987176830823767,495237,0.012823169176233006,2003,2003.csv
2312,The Best of Me,38609668,26766213,0.6932515710831805,11843455,0.30674842891681947,2014,2014.csv
2313,Urban Legends: Final Cut,38574362,21468807,0.5565563728571843,17105555,0.44344362714281577,2000,2000.csv
2314,Million Dollar Arm,38483455,36457627,0.9473584687237672,2025828,0.05264153127623286,2014,2014.csv
2315,What's the Worst That Could Happen?,38464131,32269834,0.8389591331206728,6194297,0.16104086687932714,2001,2001.csv
2316,Employee of the Month,38395414,28444855,0.7408399086411727,9950559,0.2591600913588274,2006,2006.csv
2317,Chernobyl Diaries,38390020,18119640,0.4719882927906784,20270380,0.5280117072093216,2012,2012.csv
2318,The Missing,38364277,27011180,0.7040711336746943,11353097,0.2959288663253057,2003,2003.csv
2319,Boruto: Naruto The Movie,38362448,919651,0.023972688082887723,37442797,0.9760273119171122,2015,2015.csv
2320,The Lazarus Effect,38356892,25801570,0.6726710287162996,12555322,0.3273289712837005,2015,2015.csv
2321,The Soloist,38332994,31720158,0.8274897076914994,6612836,0.1725102923085006,2009,2009.csv
2322,Ghajini,38316584,2430627,0.0634353782685847,35885957,0.9365646217314153,2008,2008.csv
2323,Van Wilder: Party Liaison,38275483,21305259,0.5566293964206801,16970224,0.44337060357931996,2002,2002.csv
2324,Don't Be Afraid of the Dark,38269529,24046682,0.6283506128335157,14222847,0.3716493871664843,2011,2011.csv
2325,The Original Kings of Comedy,38182790,38182790,1.0,0,0.0,2000,2000.csv
2326,The Water Diviner,38176317,4196641,0.10992786444014492,33979676,0.8900721355598551,2014,2014.csv
2327,Just My Luck,38159905,17326650,0.45405380333100936,20833255,0.5459461966689907,2006,2006.csv
2328,Jumping the Broom,38158601,37295394,0.9773784421499101,863207,0.022621557850089943,2011,2011.csv
2329,Happily N'Ever After,38085778,15589393,0.40932321246004216,22496385,0.5906767875399578,2007,2007.csv
2330,One for the Money,38080789,26414527,0.6936444252770078,11666262,0.30635557472299224,2011,2011.csv
2331,The Producers,38075318,19398532,0.5094778722530958,18676786,0.4905221277469042,2005,2005.csv
2332,The Banger Sisters,38068353,30307416,0.7961315268879638,7760937,0.20386847311203612,2002,2002.csv
2333,But Always,38039248,430760,0.011324093473141214,37608488,0.9886759065268588,2014,2014.csv
2334,Overcomer,38026103,34746945,0.9137656046426845,3279158,0.08623439535731547,2019,2019.csv
2335,The Eagle,37989684,19490041,0.5130350913158425,18499643,0.48696490868415754,2011,2011.csv
2336,For Colored Girls,37981984,37729698,0.9933577456090761,252286,0.0066422543909238655,2010,2010.csv
2337,Killing Them Softly,37930465,15026056,0.39614742397700636,22904409,0.6038525760229937,2012,2012.csv
2338,Hell or High Water,37879877,27007844,0.7129865812394269,10872033,0.28701341876057307,2016,2016.csv
2339,Bulletproof Monk,37713879,23358708,0.6193663611213261,14355171,0.3806336388786738,2003,2003.csv
2340,The Hills Have Eyes 2,37697773,20804166,0.5518672416007173,16893607,0.4481327583992826,2007,2007.csv
2341,The Handmaiden,37692886,2006788,0.05324049742436809,35686098,0.9467595025756319,2016,2016.csv
2342,Casanova,37691644,11304403,0.2999180136584119,26387241,0.700081986341588,2005,2005.csv
2343,The Prince and Me,37666766,28176497,0.7480466201956387,9490269,0.2519533798043612,2004,2004.csv
2344,Halloween: Resurrection,37664855,30354442,0.8059089036716058,7310413,0.1940910963283942,2002,2002.csv
2345,The Covenant,37598767,23380495,0.6218420673209842,14218272,0.37815793267901576,2006,2006.csv
2346,Pokémon the Movie: I Choose You!,37552144,2401722,0.06395698738266449,35150422,0.9360430126173355,2017,2017.csv
2347,Broken Embraces,37472507,5014305,0.13381290448488006,32458202,0.86618709551512,2009,2009.csv
2348,A Walk in the Woods,37461274,29504281,0.7875941699153104,7956993,0.21240583008468958,2015,2015.csv
2349,Snowden,37357216,21587519,0.5778674460109662,15769697,0.4221325539890339,2016,2016.csv
2350,The Majestic,37317558,27807266,0.7451523489291555,9510292,0.25484765107084445,2001,2001.csv
2351,Becoming Jane,37311672,18670946,0.5004049671105599,18640726,0.49959503288944007,2007,2007.csv
2352,Home Again,37270721,27020284,0.7249734718037786,10250437,0.27502652819622136,2017,2017.csv
2353,Beauty Shop,37245453,36351350,0.9759943045933688,894103,0.024005695406631247,2005,2005.csv
2354,"Like Father, Like Son",37170163,334616,0.009002274216553745,36835547,0.9909977257834462,2013,2013.csv
2355,Pain and Glory,37137074,4567338,0.12298594121874007,32569736,0.8770140587812599,2019,2019.csv
2356,The Family That Preys,37105289,37105289,1.0,0,0.0,2008,2008.csv
2357,Till The End Of The World,37013733,118660,0.003205837141582018,36895073,0.9967941628584179,2018,2018.csv
2358,2.0,36945969,4152000,0.11238032490093845,32793969,0.8876196750990616,2018,2018.csv
2359,Devil's Due,36921560,15821461,0.42851550692874296,21100099,0.571484493071257,2014,2014.csv
2360,Ex Machina,36869414,25442958,0.6900830590906598,11426456,0.3099169409093402,2015,2015.csv
2361,The Adventurers,36796816,216556,0.0058851831093211975,36580260,0.9941148168906788,2017,2017.csv
2362,Titan A.E.,36754634,22753426,0.6190627826684385,14001208,0.3809372173315615,2000,2000.csv
2363,Valentine,36684136,20384136,0.5556662422143457,16300000,0.44433375778565426,2001,2001.csv
2364,Joy Ride,36642838,21974919,0.5997057051094132,14667919,0.4002942948905868,2001,2001.csv
2365,Return to Me,36609995,32722798,0.8938214277275919,3887197,0.10617857227240812,2000,2000.csv
2366,Burnt,36606743,13651946,0.3729352813496683,22954797,0.6270647186503318,2015,2015.csv
2367,The Priests,36577134,185093,0.005060347265042691,36392041,0.9949396527349573,2015,2015.csv
2368,Brooklyn's Finest,36440201,27163593,0.7454292856397801,9276608,0.2545707143602199,2009,2009.csv
2369,Pirate Radio,36348784,8017917,0.22058281234387372,28330867,0.7794171876561262,2009,2009.csv
2370,Furry Vengeance,36288132,17630465,0.48584658477322556,18657667,0.5141534152267744,2010,2010.csv
2371,A Most Wanted Man,36233517,17237855,0.4757433566275115,18995662,0.5242566433724886,2014,2014.csv
2372,A Very Harold & Kumar Christmas,36192775,35061031,0.9687301125708101,1131744,0.031269887429189944,2011,2011.csv
2373,Sicko,36093504,24540079,0.6799029265764831,11553425,0.3200970734235169,2007,2007.csv
2374,Love Happens,36088028,22965110,0.6363636716309353,13122918,0.3636363283690647,2009,2009.csv
2375,Nothing to Lose,36075317,1016188,0.028168512005036575,35059129,0.9718314879949634,2018,2018.csv
2376,Whatever Works,36020534,5306706,0.14732446776052793,30713828,0.8526755322394721,2009,2009.csv
2377,Kundo: Age of the Rampant,35941291,280958,0.00781713711953196,35660333,0.9921828628804681,2014,2014.csv
2378,Ra.One,35911689,2511689,0.06994070927713815,33400000,0.9300592907228619,2011,2011.csv
2379,You Will Meet a Tall Dark Stranger,35867322,3248246,0.09056282484652743,32619076,0.9094371751534726,2010,2010.csv
2380,Garden State,35825316,26782316,0.747580733132961,9043000,0.2524192668670389,2004,2004.csv
2381,Conquest 1453,35797045,35730,0.0009981270800425008,35761315,0.9990018729199575,2012,2012.csv
2382,Riding in Cars with Boys,35743308,30165536,0.8439491946296632,5577772,0.15605080537033675,2001,2001.csv
2383,Hostel: Part II,35728183,17609452,0.4928728673383698,18118731,0.5071271326616302,2007,2007.csv
2384,Tad the Lost Explorer and the Secret of King Midas,35704046,5874,0.00016451916962016014,35698172,0.9998354808303799,2017,2017.csv
2385,Hostiles,35669017,29819114,0.835994835517895,5849903,0.164005164482105,2017,2017.csv
2386,Faster,35626958,23240020,0.6523155864163311,12386938,0.34768441358366886,2010,2010.csv
2387,Tyler Perry's Good Deeds,35579177,35025791,0.9844463518647438,553386,0.015553648135256191,2012,2012.csv
2388,My Dog Skip,35547761,34134641,0.9602472853353549,1413120,0.039752714664645125,2000,2000.csv
2389,Jersey Girl,35492921,25268157,0.7119210334928477,10224764,0.28807896650715226,2004,2004.csv
2390,Mia and the White Lion,35487190,399471,0.011256766173934877,35087719,0.9887432338260651,2018,2018.csv
2391,Arbitrage,35485056,7919574,0.22318054112694652,27565482,0.7768194588730535,2012,2012.csv
2392,Vacancy,35442935,19363565,0.5463307426430684,16079370,0.45366925735693164,2007,2007.csv
2393,Original Sin,35402320,16534221,0.46703778170470184,18868099,0.5329622182952981,2001,2001.csv
2394,Room,35401758,14677654,0.4146024047732319,20724104,0.5853975952267682,2015,2015.csv
2395,Namiya,35351623,70814,0.0020031329254670996,35280809,0.997996867074533,2017,2017.csv
2396,The Darjeeling Limited,35307949,11902715,0.337111481609991,23405234,0.662888518390009,2007,2007.csv
2397,Assault on Precinct 13,35294470,20040895,0.5678196896000989,15253575,0.4321803103999012,2005,2005.csv
2398,Eye in the Sky,35259653,18704595,0.5304815393390286,16555058,0.46951846066097136,2016,2016.csv
2399,Courageous,35185884,34522221,0.9811383735591239,663663,0.01886162644087612,2011,2011.csv
2400,The Girl in the Spider's Web,35164920,14841338,0.42204953118050603,20323582,0.577950468819494,2018,2018.csv
2401,The Adventures of Rocky & Bullwinkle,35134820,26005820,0.7401722849298786,9129000,0.2598277150701213,2000,2000.csv
2402,Miss Potter,35078241,3005605,0.08568288814709951,32072636,0.9143171118529005,2006,2006.csv
2403,Alfie,35060882,13399812,0.3821869626668262,21661070,0.6178130373331737,2004,2004.csv
2404,My Week with Marilyn,35057696,14600347,0.4164662446727817,20457349,0.5835337553272183,2011,2011.csv
2405,Flight of the Phoenix,35021497,21009180,0.5998938309233326,14012317,0.4001061690766674,2004,2004.csv
2406,When Marnie Was There,34949567,561085,0.016054133088401354,34388482,0.9839458669115987,2014,2014.csv
2407,The Sitter,34942188,30441326,0.8711911801287315,4500862,0.12880881987126852,2011,2011.csv
2408,The Hate U Give,34934009,29719483,0.8507321046376326,5214526,0.14926789536236737,2018,2018.csv
2409,Lost and Love,34930177,188817,0.005405555202311171,34741360,0.9945944447976889,2015,2015.csv
2410,Secret in Their Eyes,34854990,20180155,0.578974631752871,14674835,0.42102536824712905,2015,2015.csv
2411,Chimpanzee,34823764,28972764,0.8319825507661952,5851000,0.16801744923380482,2012,2012.csv
2412,Disaster Movie,34816824,14190901,0.40758746403750096,20625923,0.5924125359624991,2008,2008.csv
2413,Kidnap,34814102,30971040,0.8896119164584513,3843062,0.11038808354154876,2017,2017.csv
2414,The Life Aquatic with Steve Zissou,34808403,24020403,0.6900748362399735,10788000,0.30992516376002655,2004,2004.csv
2415,Gomorrah 2008 Re-release,34807285,1579146,0.04536826127059321,33228139,0.9546317387294068,2008,2008.csv
2416,Sunshine,34806360,3675753,0.10560578583913974,31130607,0.8943942141608603,2007,2007.csv
2417,Broken City,34737199,19701164,0.5671488941868917,15036035,0.4328511058131083,2013,2013.csv
2418,Endless Love,34718173,23438250,0.6751003285800782,11279923,0.32489967141992177,2014,2014.csv
2419,Jane Eyre,34710627,11242660,0.3238967708650149,23467967,0.6761032291349851,2011,2011.csv
2420,The Kids Are All Right,34705850,20811365,0.5996500589958177,13894485,0.4003499410041823,2010,2010.csv
2421,The Man Standing Next,34664900,113527,0.003274984205925879,34551373,0.9967250157940741,2020,2020.csv
2422,Malibu's Most Wanted,34622504,34432201,0.9945034882514563,190303,0.005496511748543664,2003,2003.csv
2423,Alex Cross,34618867,25888412,0.7478122262060165,8730455,0.2521877737939835,2012,2012.csv
2424,Gone Baby Gone,34612443,20292962,0.5862909474491587,14319481,0.41370905255084134,2007,2007.csv
2425,Crank: High Voltage,34572541,13684249,0.3958126479624393,20888292,0.6041873520375607,2009,2009.csv
2426,Salmon Fishing in the Yemen,34564651,9047981,0.2617697774526929,25516670,0.7382302225473071,2012,2012.csv
2427,Haywire,34513760,18942396,0.548836058430029,15571364,0.4511639415699709,2012,2012.csv
2428,Steve Jobs,34441873,17766658,0.515844710303647,16675215,0.484155289696353,2015,2015.csv
2429,Swimfan,34411240,28564995,0.8301065291457094,5846245,0.16989347085429063,2002,2002.csv
2430,The Medallion,34268701,22219192,0.648381507078427,12049509,0.35161849292157293,2003,2003.csv
2431,American Psycho,34266564,15070285,0.43979562701413544,19196279,0.5602043729858646,2000,2000.csv
2432,Wild Safari - A South African Adventure,34257135,16621530,0.48519906874874386,17635605,0.5148009312512561,2005,2005.csv
2433,Bad News Bears,34252847,32868349,0.95958006060051,1384498,0.040419939399489915,2005,2005.csv
2434,Victor Frankenstein,34227298,5775076,0.16872719546836562,28452222,0.8312728045316343,2015,2015.csv
2435,The House,34184504,25584504,0.748424022767743,8600000,0.25157597723225705,2017,2017.csv
2436,Cirque du Soleil: Worlds Away,34153101,12512862,0.36637557450493297,21640239,0.633624425495067,2012,2012.csv
2437,In Bruges,34085749,7800824,0.22885881134664227,26284925,0.7711411886533578,2008,2008.csv
2438,The Bad Guys: The Movie,34024386,166972,0.004907421400638942,33857414,0.9950925785993611,2019,2019.csv
2439,Darkness,33988736,22163442,0.6520819720980504,11825294,0.34791802790194964,2002,2002.csv
2440,Dungeons & Dragons,33978694,15391970,0.45298886413939277,18586724,0.5470111358606072,2000,2000.csv
2441,The Fighting Temptations,33972062,30250745,0.8904594899185101,3721317,0.1095405100814899,2003,2003.csv
2442,The Secret in Their Eyes,33965279,6391436,0.18817557777164146,27573843,0.8118244222283586,2009,2009.csv
2443,The Witness,33963557,418063,0.012309164202088727,33545494,0.9876908357979113,2015,2015.csv
2444,Hotel Rwanda,33882243,23530892,0.6944903854210597,10351351,0.3055096145789404,2004,2004.csv
2445,The Good Liar,33856058,17156058,0.5067352495674482,16700000,0.49326475043255186,2019,2019.csv
2446,Jay and Silent Bob Strike Back,33788161,30085147,0.890404985343831,3703014,0.10959501465616907,2001,2001.csv
2447,The Art of Racing in the Rain,33766787,26395642,0.7817042823766442,7371145,0.21829571762335576,2019,2019.csv
2448,Love and Honour,33755574,60910,0.0018044427269996949,33694664,0.9981955572730004,2006,2006.csv
2449,I Want to Eat Your Pancreas,33748006,277019,0.008208455338072419,33470987,0.9917915446619275,2017,2017.csv
2450,Nobody's Fool,33705333,31713110,0.9408929441521909,1992223,0.05910705584780901,2018,2018.csv
2451,Mr. Woodcock,33683200,25799486,0.7659452189815694,7883714,0.23405478101843055,2007,2007.csv
2452,The Skin I Live In,33678406,3185812,0.09459509455405936,30492594,0.9054049054459407,2011,2011.csv
2453,Y Tu Mamá También,33616692,13839658,0.411690061592021,19777034,0.588309938407979,2001,2001.csv
2454,Because of Winn-Dixie,33589427,32647042,0.9719439989256143,942385,0.0280560010743857,2005,2005.csv
2455,Nick and Norah's Infinite Playlist,33556631,31487293,0.938332963163078,2069338,0.06166703683692204,2008,2008.csv
2456,Friday After Next,33526835,33253609,0.9918505280919001,273226,0.008149471908099885,2002,2002.csv
2457,"Run, Fat Boy, Run",33478921,6003262,0.17931467982495614,27475659,0.8206853201750439,2007,2007.csv
2458,Fireproof,33473297,33456317,0.9994927299811548,16980,0.0005072700188451709,2008,2008.csv
2459,Red Planet,33463969,17480890,0.5223794583362182,15983079,0.4776205416637817,2000,2000.csv
2460,2016: Obama's America,33449086,33449086,1.0,0,0.0,2012,2012.csv
2461,Get on Up,33448971,30703100,0.9179086555457865,2745871,0.08209134445421355,2014,2014.csv
2462,Wonder Boys,33426588,19393557,0.5801835652505125,14033031,0.41981643474948743,2000,2000.csv
2463,Tell No One,33406992,6177192,0.1849071595551015,27229800,0.8150928404448985,2006,2006.csv
2464,The Perks of Being a Wallflower,33384127,17742948,0.5314785676438386,15641179,0.46852143235616134,2012,2012.csv
2465,The Box,33333531,15051977,0.45155663226917064,18281554,0.5484433677308294,2009,2009.csv
2466,The Cave,33296457,15007991,0.450738377359489,18288466,0.5492616226405109,2005,2005.csv
2467,Perfect Strangers,33262366,1014507,0.03050014541960124,32247859,0.9694998545803988,2017,2017.csv
2468,Confessions of a Teenage Drama Queen,33251890,29331068,0.8820872437626853,3920822,0.11791275623731463,2004,2004.csv
2469,Project Almanac,33213241,22348241,0.6728714310054836,10865000,0.32712856899451637,2015,2015.csv
2470,Bharat,33185983,2971549,0.08954229259986062,30214434,0.9104577074001394,2019,2019.csv
2471,Baaghi 2,33139063,1319579,0.039819442088631175,31819484,0.9601805579113688,2018,2018.csv
2472,The Crocodile Hunter: Collision Course,33082548,28442574,0.8597455673607728,4639974,0.14025443263922718,2002,2002.csv
2473,Girl with a Pearl Earring,33030115,11670971,0.3533433353168767,21359144,0.6466566646831232,2003,2003.csv
2474,Confessions of a Dangerous Mind,33013805,16007718,0.4848795223695057,17006087,0.5151204776304943,2002,2002.csv
2475,Lockout,32948113,14326864,0.43483109336185655,18621249,0.5651689066381435,2012,2012.csv
2476,Inside Llewyn Davis,32935319,13235319,0.40185792644060925,19700000,0.5981420735593908,2013,2013.csv
2477,Sleepless,32917353,20783704,0.6313905009312262,12133649,0.3686094990687738,2017,2017.csv
2478,Brightburn,32893421,17300439,0.5259543846169117,15592982,0.4740456153830883,2019,2019.csv
2479,Adaptation.,32801173,22498520,0.6859059583021619,10302653,0.31409404169783806,2002,2002.csv
2480,Awake,32730062,14377198,0.439265834571288,18352864,0.560734165428712,2007,2007.csv
2481,Katy Perry: Part of Me,32726956,25326071,0.7738596586862524,7400885,0.2261403413137476,2012,2012.csv
2482,Leap Year,32686500,25918920,0.7929548896333348,6767580,0.20704511036666515,2010,2010.csv
2483,Mud,32613173,21590086,0.6620050738393348,11023087,0.3379949261606652,2013,2013.csv
2484,88 Minutes,32593385,17213467,0.5281276246698525,15379918,0.47187237533014753,2007,2007.csv
2485,Cry Wolf,32586408,10047674,0.30833941562383926,22538734,0.6916605843761607,2005,2005.csv
2486,Last Chance Harvey,32566966,14889042,0.4571823485184343,17677924,0.5428176514815657,2008,2008.csv
2487,The Musketeer,32533802,27073640,0.832169569360507,5460162,0.16783043063949304,2001,2001.csv
2488,The Hurricane Heist,32517248,6115825,0.18807941557661953,26401423,0.8119205844233804,2018,2018.csv
2489,Fighting,32482728,23091010,0.7108704047270906,9391718,0.2891295952729093,2009,2009.csv
2490,UglyDolls,32450241,20150241,0.6209581309426947,12300000,0.3790418690573053,2019,2019.csv
2491,Movie 43,32438988,8840453,0.2725255485775327,23598535,0.7274744514224674,2012,2012.csv
2492,The Invention of Lying,32406507,18451251,0.5693687073401648,13955256,0.43063129265983524,2009,2009.csv
2493,Dhoom 2,32396427,2643586,0.08160115928833757,29752841,0.9183988407116624,2006,2006.csv
2494,Stuber,32390945,22370452,0.6906390659488323,10020493,0.3093609340511677,2019,2019.csv
2495,Alpha Dog,32351125,15309602,0.47323244554864785,17041523,0.5267675544513521,2007,2007.csv
2496,Kevin Hart: Let Me Explain,32318051,32244051,0.997710257960791,74000,0.002289742039208986,2013,2013.csv
2497,Potiche,32309881,1618844,0.050103681904616115,30691037,0.9498963180953839,2010,2010.csv
2498,Hart's War,32287044,19077641,0.5908760492289106,13209403,0.4091239507710895,2002,2002.csv
2499,Seven Psychopaths,32226382,15024049,0.4662034044032619,17202333,0.5337965955967381,2012,2012.csv
2500,Reindeer Games,32168970,23368995,0.7264452358903627,8799975,0.2735547641096373,2000,2000.csv
2501,The Kid Who Would Be King,32140970,16790790,0.5224108046521309,15350180,0.4775891953478691,2019,2019.csv
2502,Amazing Grace,32120360,21250683,0.6615954179841073,10869677,0.33840458201589274,2007,2007.csv
2503,You Again,32054369,25702053,0.8018268274131367,6352316,0.1981731725868633,2010,2010.csv
2504,Dilwale,31994323,4871263,0.15225397955756087,27123060,0.8477460204424391,2015,2015.csv
2505,Stick It,31976848,26910736,0.8415693754431331,5066112,0.1584306245568669,2006,2006.csv
2506,Suffragette,31972096,4702420,0.1470788777814254,27269676,0.8529211222185746,2015,2015.csv
2507,Bad Times at the El Royale,31882724,17839115,0.5595229253309724,14043609,0.44047707466902764,2018,2018.csv
2508,The Seeker: The Dark Is Rising,31852619,8794452,0.2760982385781213,23058167,0.7239017614218787,2007,2007.csv
2509,Self/less,31807156,12279691,0.38606692783221486,19527465,0.6139330721677851,2015,2015.csv
2510,Blood Work,31794718,26235081,0.825139603376888,5559637,0.17486039662311206,2002,2002.csv
2511,Spring Breakers,31724284,14124284,0.44521994570468476,17600000,0.5547800542953152,2013,2013.csv
2512,Hunter Killer,31672678,15767460,0.49782528651350544,15905218,0.5021747134864946,2018,2018.csv
2513,Rent,31670620,29077547,0.918123705819463,2593073,0.08187629418053705,2005,2005.csv
2514,New World,31670607,457806,0.014455232891494628,31212801,0.9855447671085054,2013,2013.csv
2515,Ae Dil Hai Mushkil,31668920,4264983,0.1346740905594507,27403937,0.8653259094405493,2016,2016.csv
2516,Anna,31640190,7743794,0.24474549615536442,23896396,0.7552545038446355,2019,2019.csv
2517,Super Troopers 2,31626386,30617396,0.9680965760678442,1008990,0.03190342393215589,2018,2018.csv
2518,Daddy's Little Girls,31609243,31366978,0.9923356279047872,242265,0.007664372095212783,2007,2007.csv
2519,Double Take,31603059,29831583,0.9439460591457302,1771476,0.05605394085426983,2001,2001.csv
2520,Love in the Time of Cholera,31575877,4607608,0.14592177439758838,26968269,0.8540782256024116,2007,2007.csv
2521,Jennifer's Body,31556061,16204793,0.5135239471111429,15351268,0.4864760528888571,2009,2009.csv
2522,The New World 2005 Re-release,31510855,12712093,0.4034194883001429,18798762,0.596580511699857,2005,2005.csv
2523,The Thing,31505287,16928670,0.5373279094394537,14576617,0.46267209056054626,2011,2011.csv
2524,Dance Flick,31439140,25662155,0.8162486314829223,5776985,0.18375136851707777,2009,2009.csv
2525,A Serious Man,31430334,9228768,0.2936261510933991,22201566,0.7063738489066008,2009,2009.csv
2526,I Don't Know How She Does It,31410151,9662284,0.3076166045811114,21747867,0.6923833954188886,2011,2011.csv
2527,Lost Souls,31355910,16815253,0.5362706105483783,14540657,0.46372938945162173,2000,2000.csv
2528,Johnson Family Vacation,31326183,31203964,0.9960985032871703,122219,0.003901496712829648,2004,2004.csv
2529,What's in a Name?,31303580,8111,0.00025910774422605975,31295469,0.9997408922557739,2012,2012.csv
2530,How High,31283740,31178740,0.9966436238122424,105000,0.003356376187757602,2001,2001.csv
2531,Tazza: The Hidden Card,31278476,251555,0.008042431479078457,31026921,0.9919575685209215,2014,2014.csv
2532,Saving Mr. Wu,31222161,92696,0.0029689168536412326,31129465,0.9970310831463588,2015,2015.csv
2533,Pride and Glory,31200557,15740721,0.5045012818200649,15459836,0.49549871817993507,2008,2008.csv
2534,The Stepfather,31198531,29062561,0.9315361995729863,2135970,0.0684638004270137,2009,2009.csv
2535,My Dear Liar,31177968,90545,0.0029041340987969455,31087423,0.997095865901203,2019,2019.csv
2536,The New Guy,31167388,29760152,0.9548490877708457,1407236,0.0451509122291544,2002,2002.csv
2537,Joyful Noise,31158113,30932113,0.9927466724316714,226000,0.007253327568328673,2012,2012.csv
2538,Premium Rush,31083599,20275446,0.6522875938529512,10808153,0.3477124061470488,2012,2012.csv
2539,Ultraviolet,31070211,18535812,0.5965782466041186,12534399,0.4034217533958813,2006,2006.csv
2540,The Strangers: Prey at Night,31039126,24586708,0.7921198554366512,6452418,0.20788014456334886,2018,2018.csv
2541,The Wild Goose Lake,31037956,12573,0.0004050846647247003,31025383,0.9995949153352753,2019,2019.csv
2542,Beauty and the Beast 2000 IMAX Release,31033346,25487190,0.8212839827197492,5546156,0.17871601728025074,2001,2001.csv
2543,This Is Not What I Expected,30996615,337670,0.010893770174581966,30658945,0.9891062298254181,2017,2017.csv
2544,Joe Dirt,30987695,27087695,0.8741435915126956,3900000,0.1258564084873044,2001,2001.csv
2545,Pathfinder,30984583,10232081,0.3302313605446941,20752502,0.6697686394553058,2007,2007.csv
2546,Playing for Keeps,30962335,13103272,0.42320038201253235,17859063,0.5767996179874677,2012,2012.csv
2547,Billy Lynn's Long Halftime Walk,30930984,1738477,0.05620503376161586,29192507,0.9437949662383841,2016,2016.csv
2548,The Promise,30925693,669625,0.021652707992671338,30256068,0.9783472920073286,2005,2005.csv
2549,Hearts in Atlantis,30919415,24185781,0.7822198770578292,6733634,0.2177801229421708,2001,2001.csv
2550,Igor,30893885,19528602,0.632118686270762,11365283,0.367881313729238,2008,2008.csv
2551,African Cats,30857747,15428747,0.499995900543225,15429000,0.500004099456775,2011,2011.csv
2552,Attack on Titan Part 1,30810658,449523,0.014589853939503662,30361135,0.9854101460604964,2015,2015.csv
2553,Winter's Tale,30800231,12600231,0.40909534087585253,18200000,0.5909046591241475,2014,2014.csv
2554,Monsoon Wedding,30787356,13885966,0.45102820781362324,16901390,0.5489717921863768,2001,2001.csv
2555,Wolf Creek,30762648,16188180,0.5262284313105946,14574468,0.4737715686894054,2005,2005.csv
2556,Norm of the North,30734502,17062499,0.5551578157993254,13672003,0.44484218420067456,2016,2016.csv
2557,Carnage,30722632,2547047,0.08290458317503527,28175585,0.9170954168249648,2011,2011.csv
2558,A Man Called Ove,30691696,3479315,0.11336339966354417,27212381,0.8866366003364559,2015,2015.csv
2559,Nancy Drew,30666930,25612520,0.8351836978791161,5054410,0.16481630212088397,2007,2007.csv
2560,A Wedding Invitation,30665036,14350,0.0004679596658552757,30650686,0.9995320403341448,2013,2013.csv
2561,When the Bough Breaks,30658387,29747603,0.9702925010373181,910784,0.02970749896268189,2016,2016.csv
2562,Wild Tales,30642704,3106530,0.10137910805782675,27536174,0.8986208919421732,2014,2014.csv
2563,City of God,30641770,7564459,0.2468675601964247,23077311,0.7531324398035754,2002,2002.csv
2564,Be Kind Rewind,30579406,11175164,0.36544738638808094,19404242,0.6345526136119191,2008,2008.csv
2565,Cabin Fever,30553394,21158188,0.6924987777135332,9395206,0.30750122228646676,2003,2003.csv
2566,Two for the Money,30526509,22991379,0.7531610968027821,7535130,0.24683890319721788,2005,2005.csv
2567,A Dangerous Method,30519436,5704709,0.18692052500577008,24814727,0.81307947499423,2011,2011.csv
2568,What's Your Number?,30426096,14011084,0.4604956219161341,16415012,0.5395043780838659,2011,2011.csv
2569,The Girl Next Door,30381722,14589444,0.4802046440948936,15792278,0.5197953559051064,2004,2004.csv
2570,Nocturnal Animals,30311857,10663357,0.3517883117487655,19648500,0.6482116882512345,2016,2016.csv
2571,Bloodshot,30265633,10021787,0.33112761923730455,20243846,0.6688723807626954,2020,2020.csv
2572,The Great Debaters,30236407,30236407,1.0,0,0.0,2007,2007.csv
2573,Far from the Madding Crowd,30229977,12236500,0.40478032781831097,17993477,0.595219672181689,2015,2015.csv
2574,A Silent Voice: The Movie,30156463,310407,0.010293216415996797,29846056,0.9897067835840032,2016,2016.csv
2575,When the Game Stands Tall,30138754,30127963,0.9996419560012335,10791,0.0003580439987665051,2014,2014.csv
2576,The Rum Diary,30134958,13109815,0.4350367768888213,17025143,0.5649632231111787,2011,2011.csv
2577,Godsend,30120671,14379751,0.47740473643498843,15740920,0.5225952635650115,2004,2004.csv
2578,Shaun of the Dead,30076102,13542874,0.45028687560642,16533228,0.54971312439358,2004,2004.csv
2579,Laws of Attraction,30031874,17871255,0.5950762513188488,12160619,0.4049237486811512,2003,2003.csv
2580,Solaris,30002758,14973382,0.49906685245403104,15029376,0.500933147545969,2002,2002.csv
2581,Reset 2017 Re-release,29949252,108970,0.0036384881999724067,29840282,0.9963615118000276,2017,2017.csv
2582,Small Time Crooks,29934477,17266359,0.5768051000189514,12668118,0.4231948999810486,2000,2000.csv
2583,Keeping Up with the Joneses,29918745,14904426,0.4981634757741342,15014319,0.5018365242258658,2016,2016.csv
2584,Rab Ne Bana Di Jodi,29914469,2078956,0.0694966706579348,27835513,0.9305033293420653,2008,2008.csv
2585,Pulse,29907685,20264436,0.6775661840760995,9643249,0.32243381592390047,2006,2006.csv
2586,The Four Feathers,29882645,18306166,0.6126019299831056,11576479,0.3873980700168944,2002,2002.csv
2587,The Bye Bye Man,29874280,22395806,0.7496684773658143,7478474,0.2503315226341857,2017,2017.csv
2588,Draft Day,29824199,28842237,0.9670749916871195,981962,0.03292500831288042,2014,2014.csv
2589,The Disaster Artist,29820616,21120616,0.7082555236283516,8700000,0.2917444763716484,2017,2017.csv
2590,Like a Boss,29753143,22169514,0.7451150286878936,7583629,0.2548849713121064,2020,2020.csv
2591,Battlefield Earth,29725663,21471685,0.7223282118215496,8253978,0.2776717881784504,2000,2000.csv
2592,The Swindlers,29721916,241916,0.008139313764294335,29480000,0.9918606862357057,2017,2017.csv
2593,Angel Eyes,29715606,24174218,0.8135192666102787,5541388,0.1864807333897212,2001,2001.csv
2594,The Raven,29699345,16008272,0.5390109445174632,13691073,0.4609890554825367,2012,2012.csv
2595,Masterminds,29674699,17368022,0.5852804774868988,12306677,0.4147195225131011,2016,2016.csv
2596,Amour,29652180,6739492,0.22728487416439533,22912688,0.7727151258356046,2012,2012.csv
2597,Cursed,29621722,19297522,0.6514652321698245,10324200,0.34853476783017545,2005,2005.csv
2598,An American Haunting,29612137,16298046,0.5503839861337937,13314091,0.44961601386620625,2006,2006.csv
2599,W.,29560587,25534493,0.8638019603602595,4026094,0.1361980396397406,2008,2008.csv
2600,In the Valley of Elah,29541790,6777741,0.22942892086092279,22764049,0.7705710791390772,2007,2007.csv
2601,The Pledge,29419291,19733089,0.670753384233495,9686202,0.32924661576650505,2001,2001.csv
2602,The Valet,29414553,1926800,0.0655049899959384,27487753,0.9344950100040615,2006,2006.csv
2603,City by the Sea,29414087,22449000,0.7632057388012757,6965087,0.23679426119872427,2002,2002.csv
2604,Luther,29413900,5791328,0.19689085772372925,23622572,0.8031091422762707,2003,2003.csv
2605,The Losers,29397654,23591432,0.8024936955853689,5806222,0.19750630441463118,2010,2010.csv
2606,Bugs!,29388999,19063544,0.6486625828936875,10325455,0.35133741710631244,2003,2003.csv
2607,Baby Boy,29381649,28734552,0.977976151032231,647097,0.022023848967768964,2001,2001.csv
2608,Across the Universe,29367143,24343673,0.828942502169857,5023470,0.17105749783014304,2007,2007.csv
2609,Nurse Betty,29360400,25170054,0.8572789880246863,4190346,0.1427210119753137,2000,2000.csv
2610,Mr. Holmes,29355203,17737646,0.6042419805443008,11617557,0.3957580194556992,2015,2015.csv
2611,Rowdy Rathore,29342463,777373,0.02649310659435781,28565090,0.9735068934056422,2012,2012.csv
2612,Sword Art Online The Movie: Ordinal Scale,29322339,1522976,0.05193910349375607,27799363,0.9480608965062439,2017,2017.csv
2613,Free Solo,29318861,17541090,0.5982868843370143,11777771,0.4017131156629857,2018,2018.csv
2614,The Class,29303505,3766810,0.12854469115554606,25536695,0.8714553088444539,2008,2008.csv
2615,Big Eyes,29253166,14482031,0.495058586137309,14771135,0.504941413862691,2014,2014.csv
2616,The Young Victoria,29181829,11001272,0.3769904895268902,18180557,0.6230095104731098,2009,2009.csv
2617,Singh Is King,29169677,2159376,0.0740281080246449,27010301,0.9259718919753551,2008,2008.csv
2618,Yu-Gi-Oh!: The Movie - Pyramid of Light,29144802,19765868,0.6781953090640314,9378934,0.32180469093596864,2004,2004.csv
2619,Special ID,29139936,12666,0.0004346612154535961,29127270,0.9995653387845465,2013,2013.csv
2620,My Hero Academia: Heroes Rising,29127005,13304000,0.45675825578359325,15823005,0.5432417442164067,2019,2019.csv
2621,Cold Creek Manor,29119434,21386011,0.7344239932685505,7733423,0.26557600673144954,2003,2003.csv
2622,Sacrifice,29093560,29792,0.0010240066873906115,29063768,0.9989759933126093,2010,2010.csv
2623,Pad Man,29045020,1670192,0.057503558269197265,27374828,0.9424964417308027,2018,2018.csv
2624,Far from Heaven,29027914,15901849,0.5478123229936537,13126065,0.4521876770063464,2002,2002.csv
2625,New in Town,29010817,16734283,0.5768290841309295,12276534,0.4231709158690705,2009,2009.csv
2626,Shorts,28972508,20919166,0.7220350409429519,8053342,0.27796495905704816,2009,2009.csv
2627,M.S. Dhoni: The Untold Story,28903047,1801550,0.06233079854867897,27101497,0.937669201451321,2016,2016.csv
2628,Twilight/The Twilight Saga: New Moon,28858846,2385237,0.082651849626974,26473609,0.917348150373026,2009,2009.csv
2629,Agent Cody Banks 2: Destination London,28818995,23630159,0.8199508345103638,5188836,0.18004916548963626,2004,2004.csv
2630,Boiler Room,28780255,16970581,0.5896605502626714,11809674,0.4103394497373286,2000,2000.csv
2631,Speak Bachchan,28775262,1216258,0.04226748656536993,27559004,0.9577325134346301,2012,2012.csv
2632,Twins 2,28733523,1431255,0.04981133013170713,27302268,0.9501886698682929,2017,2017.csv
2633,The Suspect,28674130,218693,0.007626839942484741,28455437,0.9923731600575153,2013,2013.csv
2634,Wrong Turn,28650575,15418790,0.5381668605254868,13231785,0.46183313947451315,2003,2003.csv
2635,The Fortress,28645448,252895,0.008828453302598025,28392553,0.9911715466974019,2017,2017.csv
2636,Love & Mercy,28641776,12551031,0.43820714888629814,16090745,0.5617928511137019,2015,2015.csv
2637,Heist,28510652,23510841,0.8246335790566979,4999811,0.17536642094330218,2001,2001.csv
2638,I Give It a Year,28328531,34657,0.0012233955936507969,28293874,0.9987766044063492,2013,2013.csv
2639,Brown Sugar,28316451,27363891,0.9663601911129329,952560,0.0336398088870671,2002,2002.csv
2640,Thunderbirds,28283637,6880917,0.24328260895159984,21402720,0.7567173910484002,2004,2004.csv
2641,The Master,28258060,16377274,0.5795611588339752,11880786,0.42043884116602487,2012,2012.csv
2642,Fan,28240000,2300000,0.08144475920679886,25940000,0.9185552407932012,2016,2016.csv
2643,The Upside of Anger,28237488,18761993,0.664435625435237,9475495,0.33556437456476296,2005,2005.csv
2644,L'auberge espagnole,28193749,1067438,0.03786080382569909,27126311,0.9621391961743009,2002,2002.csv
2645,Case 39,28190603,13261851,0.4704351659310019,14928752,0.5295648340689981,2009,2009.csv
2646,Gully Boy,28141995,5566534,0.19780168392468267,22575461,0.8021983160753173,2019,2019.csv
2647,Tristan & Isolde,28047963,14734633,0.52533700932221,13313330,0.47466299067779005,2006,2006.csv
2648,Pokemon 4Ever: Celebi - Voice of the Forest,28023563,1727447,0.06164266121335107,26296116,0.938357338786649,2002,2002.csv
2649,Your Highness,28013733,21596445,0.7709234967007075,6417288,0.22907650329929252,2011,2011.csv
2650,The Tailor of Panama,28008462,13729742,0.4901997831940933,14278720,0.5098002168059067,2001,2001.csv
2651,Mandela: Long Walk to Freedom,27985788,8323085,0.29740398948208996,19662703,0.70259601051791,2013,2013.csv
2652,The Brothers Grimsby,27979040,6874837,0.24571382720779555,21104203,0.7542861727922044,2016,2016.csv
2653,The 33,27972023,12227722,0.4371411392018375,15744301,0.5628588607981625,2015,2015.csv
2654,The Little Vampire,27965865,13572400,0.4853202287860576,14393465,0.5146797712139424,2000,2000.csv
2655,The Brothers,27958191,27457409,0.9820881830301539,500782,0.017911816969846152,2001,2001.csv
2656,Priceless,27949650,2165188,0.07746744592508314,25784462,0.9225325540749169,2006,2006.csv
2657,The Divine Move,27926871,136707,0.004895177837860891,27790164,0.9951048221621391,2014,2014.csv
2658,Monster Family,27890108,127259,0.004562872255639885,27762849,0.9954371277443601,2017,2017.csv
2659,Mrs. Henderson Presents,27876417,11036366,0.3959033185649361,16840051,0.6040966814350639,2005,2005.csv
2660,The Beguiled,27869129,10709995,0.3842960072415611,17159134,0.6157039927584389,2017,2017.csv
2661,Dark Skies,27858103,17418667,0.6252639312877837,10439436,0.3747360687122163,2013,2013.csv
2662,Love & Basketball,27728118,27459615,0.9903165804473278,268503,0.009683419552672129,2000,2000.csv
2663,Ruby & Quentin,27720972,312824,0.011284741386413145,27408148,0.9887152586135869,2003,2003.csv
2664,Appaloosa,27712362,20211394,0.7293277274596802,7500968,0.2706722725403197,2008,2008.csv
2665,Default,27694043,203775,0.007358080580722721,27490268,0.9926419194192773,2018,2018.csv
2666,Dirty Dancing: Havana Nights,27685016,14161590,0.5115254403320554,13523426,0.48847455966794456,2004,2004.csv
2667,Nebraska,27682872,17654912,0.6377557935462765,10027960,0.36224420645372346,2013,2013.csv
2668,Traitor,27674464,23530831,0.8502723304776563,4143633,0.1497276695223438,2008,2008.csv
2669,The Quiet American,27674124,12988801,0.46934822580111296,14685323,0.530651774198887,2002,2002.csv
2670,Ice Princess,27645491,24402491,0.882693347714461,3243000,0.11730665228553908,2005,2005.csv
2671,The Last Castle,27642707,18244060,0.659995419406645,9398647,0.34000458059335503,2001,2001.csv
2672,The Road,27639579,8117000,0.29367306933293014,19522579,0.7063269306670699,2009,2009.csv
2673,Goal! The Dream Begins,27610873,4283255,0.15512928548112187,23327618,0.8448707145188781,2005,2005.csv
2674,One Cut of the Dead,27590180,52406,0.0018994439325876091,27537774,0.9981005560674124,2018,2018.csv
2675,Cirque du Soleil: Journey of Man,27538359,15627434,0.5674787666178657,11910925,0.43252123338213433,2000,2000.csv
2676,The Women on the 6th Floor,27533970,719823,0.026143087974600104,26814147,0.9738569120253999,2011,2011.csv
2677,Mirai,27526961,812794,0.029527196990615855,26714167,0.9704728030093841,2018,2018.csv
2678,The Happytime Murders,27506452,20706452,0.7527852737968532,6800000,0.2472147262031468,2018,2018.csv
2679,The Incredible Burt Wonderstone,27437881,22537881,0.8214147805364416,4900000,0.17858521946355843,2013,2013.csv
2680,Frost/Nixon,27426335,18622031,0.678983575457676,8804304,0.321016424542324,2008,2008.csv
2681,Left Behind,27405896,14019924,0.5115659783573578,13385972,0.48843402164264216,2014,2014.csv
2682,Irrational Man,27391084,4030360,0.14714131065422603,23360724,0.852858689345774,2015,2015.csv
2683,Legend of the Fist: The Return of Chen Zhen,27390678,50433,0.0018412468650830767,27340245,0.998158753134917,2010,2010.csv
2684,Ella Enchanted,27388767,22918387,0.8367805312301938,4470380,0.16321946876980625,2004,2004.csv
2685,Detective K: Secret of the Lost Island,27387870,185367,0.006768215271943382,27202503,0.9932317847280566,2015,2015.csv
2686,Midnight Sun,27365467,9561064,0.34938428056060583,17804403,0.6506157194393942,2018,2018.csv
2687,The Last Mimzy,27308918,21471047,0.7862284034834335,5837871,0.2137715965165665,2007,2007.csv
2688,Stay Alive,27298695,23086480,0.8456990343311283,4212215,0.15430096566887172,2006,2006.csv
2689,Ramona and Beezus,27293743,26167002,0.9587179742990912,1126741,0.04128202570090881,2010,2010.csv
2690,American Ultra,27262374,14440985,0.5297038695162791,12821389,0.4702961304837209,2015,2015.csv
2691,Sorority Row,27206120,11965282,0.4398011182777993,15240838,0.5601988817222008,2009,2009.csv
2692,Khumba,27187375,1029,3.7848449877930475e-05,27186346,0.999962151550122,2013,2013.csv
2693,The Protector,27165581,12044087,0.44335834378068334,15121494,0.5566416562193166,2005,2005.csv
2694,Splice 2010 Re-release,27127620,17010170,0.627042475528631,10117450,0.37295752447136904,2010,2010.csv
2695,Shoot 'Em Up,27122238,12807139,0.47220067164074,14315099,0.52779932835926,2007,2007.csv
2696,Let Me In,27093592,12134935,0.4478894861928976,14958657,0.5521105138071024,2010,2010.csv
2697,Ghost Town,27090159,13367624,0.4934494478234698,13722535,0.5065505521765302,2008,2008.csv
2698,My Neighbor Totoro 2018 Re-release,27083857,1144649,0.042263145902741994,25939208,0.9577368540972581,2018,2018.csv
2699,Rendition,27066382,9736045,0.3597098792147395,17330337,0.6402901207852605,2007,2007.csv
2700,Hitchcock,27039669,6008677,0.22221710628188532,21030992,0.7777828937181147,2012,2012.csv
2701,The Crime of Padre Amaro,26996738,5717044,0.21176795507664667,21279694,0.7882320449233533,2002,2002.csv
2702,Clerks II,26984975,24148068,0.8948708679552232,2836907,0.10512913204477677,2006,2006.csv
2703,Observe and Report,26973554,24007324,0.8900319179296877,2966230,0.10996808207031228,2009,2009.csv
2704,The Baader Meinhof Complex,26937355,476270,0.017680652016502735,26461085,0.9823193479834973,2008,2008.csv
2705,Total Dhamaal,26911995,2167632,0.08054519926895051,24744363,0.9194548007310495,2019,2019.csv
2706,The Painted Veil,26910847,8060487,0.2995255779203085,18850360,0.7004744220796915,2006,2006.csv
2707,You're Next,26895481,18494006,0.6876250326216512,8401475,0.3123749673783488,2013,2013.csv
2708,The In-Laws,26891849,20453431,0.7605810593388354,6438418,0.23941894066116465,2003,2003.csv
2709,Jodhaa Akbar,26890354,3440718,0.12795361489104978,23449636,0.8720463851089503,2008,2008.csv
2710,The Invisible,26810113,20578909,0.7675800918854762,6231204,0.2324199081145238,2007,2007.csv
2711,Chips,26800152,18600152,0.6940315860895118,8200000,0.3059684139104883,2017,2017.csv
2712,Black Book,26768563,4398532,0.16431707596705883,22370031,0.8356829240329412,2006,2006.csv
2713,Doogal,26711924,7438000,0.27845242446781443,19273924,0.7215475755321855,2005,2005.csv
2714,A Cure for Wellness,26620002,8106986,0.3045449057441844,18513016,0.6954550942558156,2017,2017.csv
2715,Mongol: The Rise of Genghis Khan,26527510,5705761,0.215088449688644,20821749,0.7849115503113561,2007,2007.csv
2716,No Manches Frida 2,26493648,9270920,0.3499299152762957,17222728,0.6500700847237043,2019,2019.csv
2717,A Hard Day,26488847,19004,0.0007174340204388662,26469843,0.9992825659795611,2014,2014.csv
2718,"The Way, Way Back",26474920,21506546,0.8123365811870253,4968374,0.18766341881297469,2013,2013.csv
2719,Mad Money,26412163,20668843,0.7825501834136038,5743320,0.2174498165863962,2008,2008.csv
2720,Center Stage,26385941,17200925,0.65189734942559,9185016,0.3481026505744101,2000,2000.csv
2721,Only the Brave,26351322,18343983,0.6961314123063731,8007339,0.3038685876936269,2017,2017.csv
2722,Saving Grace,26330482,12178602,0.46252863886046597,14151880,0.537471361139534,2000,2000.csv
2723,All About the Benjamins,26306533,25916319,0.9851666504286216,390214,0.014833349571378334,2002,2002.csv
2724,Aloha,26250020,21067116,0.8025561885286182,5182904,0.19744381147138174,2015,2015.csv
2725,Missing Link,26249469,16649539,0.6342809829791224,9599930,0.36571901702087767,2019,2019.csv
2726,Apollo 18,26236153,17687709,0.6741731152429246,8548444,0.3258268847570755,2011,2011.csv
2727,Typhoon,26179656,139059,0.005311719909535863,26040597,0.9946882800904642,2005,2005.csv
2728,The Whole Ten Yards,26170671,16328471,0.6239225199842985,9842200,0.37607748001570157,2004,2004.csv
2729,The Zookeeper's Wife,26152835,17571660,0.6718835644395722,8581175,0.32811643556042774,2017,2017.csv
2730,Badrinath Ki Dulhania,26134309,1993259,0.0762698183449197,24141050,0.9237301816550803,2017,2017.csv
2731,Top Five,26117471,25317471,0.9693691628871723,800000,0.030630837112827655,2014,2014.csv
2732,An Education,26096852,12574914,0.48185558932548644,13521938,0.5181444106745136,2009,2009.csv
2733,Saving Silverman,26086706,19402030,0.7437516258281134,6684676,0.2562483741718866,2001,2001.csv
2734,Hichki,26055222,330279,0.012676115367583512,25724943,0.9873238846324165,2018,2018.csv
2735,Iceman,26033917,7679,0.0002949613767302093,26026238,0.9997050386232698,2014,2014.csv
2736,Bratz,26013153,10010209,0.38481336729922744,16002944,0.6151866327007726,2007,2007.csv
2737,A Prairie Home Companion,25978867,20342852,0.783053856813694,5636015,0.216946143186306,2006,2006.csv
2738,The Light Between Oceans,25975621,12545979,0.48299053177592943,13429642,0.5170094682240706,2016,2016.csv
2739,White Boy Rick,25957482,24011188,0.925019922964793,1946294,0.07498007703520704,2018,2018.csv
2740,"Paul, Apostle of Christ",25915966,17560475,0.6775929170458087,8355491,0.32240708295419124,2018,2018.csv
2741,Huevos: Little Rooster's Egg-cellent Adventure,25892561,9080818,0.3507114649647827,16811743,0.6492885350352172,2015,2015.csv
2742,Rollerball,25852764,18990798,0.7345751502624632,6861966,0.26542484973753677,2002,2002.csv
2743,Boys and Girls,25850615,21799652,0.8432933607188843,4050963,0.15670663928111575,2000,2000.csv
2744,The Alamo,25819961,22414961,0.8681252849297487,3405000,0.13187471507025128,2004,2004.csv
2745,Rust and Bone,25807712,2062027,0.07989964395138942,23745685,0.9201003560486106,2012,2012.csv
2746,Our Idiot Brother,25804448,24816118,0.9616992388289026,988330,0.038300761171097326,2011,2011.csv
2747,Fair Game,25798915,9540691,0.3698097768840279,16258224,0.6301902231159722,2010,2010.csv
2748,"The Gangster, the Cop, the Devil",25775371,216494,0.008399258346271718,25558877,0.9916007416537282,2019,2019.csv
2749,RocknRolla,25740863,5700626,0.22146211647993308,20040237,0.7785378835200669,2008,2008.csv
2750,A Beautiful Planet,25730120,15650615,0.6082604744944835,10079505,0.3917395255055165,2016,2016.csv
2751,Fireworks,25672406,525280,0.020460879280266915,25147126,0.979539120719733,2017,2017.csv
2752,Jonah: A VeggieTales Movie,25615231,25581229,0.9986725866341006,34002,0.0013274133658993745,2002,2002.csv
2753,Father Figures,25601244,17501244,0.6836091246191005,8100000,0.31639087538089944,2017,2017.csv
2754,"Love, Rosie",25574387,20431,0.0007988852284123173,25553956,0.9992011147715877,2014,2014.csv
2755,Mr. Donkey,25537759,356255,0.013950127730471574,25181504,0.9860498722695284,2016,2016.csv
2756,The Tiger and the Snow,25460023,10167,0.00039933192519111236,25449856,0.9996006680748089,2005,2005.csv
2757,Grindhouse,25422088,25037897,0.9848875119935073,384191,0.015112488006492621,2007,2007.csv
2758,The Hitcher,25399945,16472961,0.6485431759793181,8926984,0.35145682402068196,2007,2007.csv
2759,In America,25382911,15539656,0.6122093718880391,9843255,0.38779062811196086,2003,2003.csv
2760,Keys To The Heart,25375866,75134,0.0029608447648643795,25300732,0.9970391552351356,2018,2018.csv
2761,A Haunted House 2,25358716,17329486,0.6833739531607199,8029230,0.31662604683928003,2014,2014.csv
2762,And So It Goes,25312387,15160801,0.5989478985130877,10151586,0.40105210148691234,2014,2014.csv
2763,The Last Legion,25303038,5933494,0.23449729633255895,19369544,0.765502703667441,2007,2007.csv
2764,Enough Said,25288872,17550872,0.6940156128751017,7738000,0.3059843871248983,2013,2013.csv
2765,Corky Romano,25272752,23980304,0.9488600212592597,1292448,0.05113997874074022,2001,2001.csv
2766,Emma.,25231081,10055355,0.3985304870607803,15175726,0.6014695129392197,2020,2020.csv
2767,Kabhi Alvida Naa Kehna,25229168,3275444,0.12982766613627528,21953724,0.8701723338637247,2006,2006.csv
2768,North Country,25211175,18337722,0.7273648292870126,6873453,0.2726351707129874,2005,2005.csv
2769,Biutiful,25147786,5101237,0.20285034237208793,20046549,0.797149657627912,2010,2010.csv
2770,On the Other Side of the Tracks,25109572,9572,0.0003812092057961004,25100000,0.9996187907942039,2012,2012.csv
2771,Born in China,25081168,13873211,0.5531325734112542,11207957,0.4468674265887458,2016,2016.csv
2772,Race,25070261,19206207,0.7660952153629353,5864054,0.2339047846370646,2016,2016.csv
2773,The Last Exorcism 2,25051865,15179302,0.6059150486400913,9872563,0.39408495135990873,2013,2013.csv
2774,Before the Devil Knows You're Dead,25037657,7084227,0.2829428887854802,17953430,0.7170571112145198,2007,2007.csv
2775,Free State of Jones,25035950,20810036,0.8312061655339622,4225914,0.16879383446603785,2016,2016.csv
2776,Georgia Rule,25000167,19103072,0.7641177756932583,5897095,0.23588222430674163,2007,2007.csv
2777,Whiskey Tango Foxtrot,24972139,23083334,0.924363507667485,1888805,0.07563649233251504,2016,2016.csv
2778,A Single Man,24964890,9176000,0.36755619592155225,15788890,0.6324438040784478,2009,2009.csv
2779,The Way Home,24952738,445367,0.017848422084983218,24507371,0.9821515779150167,2002,2002.csv
2780,The Dark Knight 2012 Re-release,24900769,1513086,0.06076462939759009,23387683,0.9392353706024099,2008,2008.csv
2781,Booksmart,24863452,22680962,0.9122209578943423,2182490,0.08777904210565773,2019,2019.csv
2782,Seed of Chucky,24829644,17083732,0.6880377342502373,7745912,0.31196226574976266,2004,2004.csv
2783,Wild City,24817852,34866,0.0014048758127818636,24782986,0.9985951241872182,2015,2015.csv
2784,Elle s'appelait Sarah,24792815,7693187,0.31029905236658284,17099628,0.6897009476334172,2010,2010.csv
2785,Lottery Ticket,24719879,24719879,1.0,0,0.0,2010,2010.csv
2786,Big Miracle,24719215,20157300,0.815450652458017,4561915,0.18454934754198302,2012,2012.csv
2787,Bride & Prejudice,24716440,6605592,0.26725499303297723,18110848,0.7327450069670227,2004,2004.csv
2788,Super 30,24701637,2269878,0.09189180457959123,22431759,0.9081081954204088,2019,2019.csv
2789,The Shipping News,24690441,11434216,0.4631029474119154,13256225,0.5368970525880846,2001,2001.csv
2790,Drug War,24676341,128195,0.005195057079167451,24548146,0.9948049429208325,2013,2013.csv
2791,Punch-Drunk Love,24665649,17844216,0.7234440091156734,6821433,0.27655599088432664,2002,2002.csv
2792,The Death of Stalin,24646055,8047856,0.32653728963925466,16598199,0.6734627103607453,2017,2017.csv
2793,The Snow Queen 3: Fire and Ice,24644317,0,0.0,24644317,1.0,2016,2016.csv
2794,Sparkle,24637800,24397469,0.9902454358749564,240331,0.009754564125043632,2012,2012.csv
2795,The Players,24629152,10854,0.00044069726801799754,24618298,0.999559302731982,2012,2012.csv
2796,Capture the Flag,24604331,6690,0.00027190334904858825,24597641,0.9997280966509514,2015,2015.csv
2797,Joe Somebody,24516772,22771646,0.9288190957602412,1745126,0.07118090423975881,2001,2001.csv
2798,Race,24503269,1367024,0.05578945405202873,23136245,0.9442105459479713,2008,2008.csv
2799,God's Not Dead 2,24487848,20774575,0.8483626245964937,3713273,0.15163737540350627,2016,2016.csv
2800,Stan & Ollie,24420923,5470235,0.22399788083357866,18950688,0.7760021191664214,2018,2018.csv
2801,Down to You,24419914,20069008,0.8218295936668737,4350906,0.1781704063331263,2000,2000.csv
2802,The Tale of The Princess Kaguya,24366656,703232,0.02886042303055454,23663424,0.9711395769694454,2013,2013.csv
2803,The Next Best Thing,24362772,14990582,0.61530691170939,9372190,0.38469308829060994,2000,2000.csv
2804,Nowhere in Africa,24322180,6180200,0.25409728897656375,18141980,0.7459027110234362,2001,2001.csv
2805,The Great Beauty,24271739,2852400,0.11751939158541545,21419339,0.8824806084145845,2013,2013.csv
2806,Jackie,24270399,13960394,0.5752024925506993,10310005,0.42479750744930067,2016,2016.csv
2807,Trance,24261569,2328743,0.09598484747626998,21932826,0.90401515252373,2013,2013.csv
2808,The Accidental Detective 2: In Action,24243825,179045,0.0073851795250955655,24064780,0.9926148204749045,2018,2018.csv
2809,Jolly LLB 2,24214186,1654254,0.06831755566757437,22559932,0.9316824443324256,2017,2017.csv
2810,The Gunman,24177137,10664749,0.44110884593159233,13512388,0.5588911540684077,2015,2015.csv
2811,The Railway Man,24174885,4438438,0.18359706778336277,19736447,0.8164029322166372,2013,2013.csv
2812,The Way Back,24172201,2701859,0.11177546471668012,21470342,0.8882245352833199,2010,2010.csv
2813,The Guru,24128852,3095506,0.12829064557236292,21033346,0.8717093544276371,2002,2002.csv
2814,The Founder,24121245,12786053,0.5300743390318369,11335192,0.46992566096816313,2016,2016.csv
2815,Guru,24108727,2096000,0.08693947216707046,22012727,0.9130605278329296,2007,2007.csv
2816,Bad Santa 2,24079268,17782178,0.7384849904905747,6297090,0.2615150095094253,2016,2016.csv
2817,Kung Fu Jungle,24070765,129784,0.0053917688116684286,23940981,0.9946082311883315,2014,2014.csv
2818,I Can Speak,24024444,63239,0.0026322773588433514,23961205,0.9973677226411567,2017,2017.csv
2819,Partner,23968620,1062840,0.04434297844431594,22905780,0.9556570215556841,2007,2007.csv
2820,School for Scoundrels,23947685,17807569,0.7436029411611185,6140116,0.25639705883888153,2006,2006.csv
2821,Alex Rider: Operation Stormbreaker,23937870,677646,0.028308533716659,23260224,0.971691466283341,2006,2006.csv
2822,Harold & Kumar Go to White Castle,23936908,18250550,0.7624439213285191,5686358,0.23755607867148087,2004,2004.csv
2823,25th Hour,23928503,13084595,0.5468204592656716,10843908,0.4531795407343284,2002,2002.csv
2824,Birth,23925492,5095038,0.21295436683182942,18830454,0.7870456331681706,2004,2004.csv
2825,Mao's Last Dancer,23914731,4817770,0.20145616523974283,19096961,0.7985438347602571,2009,2009.csv
2826,Life as a House,23903791,15667270,0.6554303457556168,8236521,0.34456965424438324,2001,2001.csv
2827,Spirits' Homecoming,23857217,125616,0.0052653249538703525,23731601,0.9947346750461297,2016,2016.csv
2828,Silence,23834809,7100177,0.2978910802264033,16734632,0.7021089197735967,2016,2016.csv
2829,Lady Vengeance,23834149,211667,0.00888082893163083,23622482,0.9911191710683692,2005,2005.csv
2830,Eight Crazy Nights,23833131,23586598,0.9896558702253598,246533,0.010344129774640184,2002,2002.csv
2831,Wanderlust,23812816,17450535,0.7328211413551425,6362281,0.26717885864485746,2012,2012.csv
2832,Dickie Roberts: Former Child Star,23769505,22738671,0.9566320796331266,1030834,0.04336792036687344,2003,2003.csv
2833,The Dressmaker,23762417,2022115,0.08509719360618913,21740302,0.9149028063938108,2015,2015.csv
2834,Pokémon the Movie: The Power of Us,23740788,789170,0.0332411038757433,22951618,0.9667588961242567,2018,2018.csv
2835,Russian Dolls,23727301,326095,0.013743451056654105,23401206,0.9862565489433459,2005,2005.csv
2836,In the Cut,23726793,4750602,0.20022099067497237,18976191,0.7997790093250277,2003,2003.csv
2837,Amy,23706049,8413144,0.3548943984718837,15292905,0.6451056015281164,2015,2015.csv
2838,To the Arctic 3D,23695388,14560838,0.6145009315736886,9134550,0.3854990684263115,2012,2012.csv
2839,The Glass House,23619609,18150259,0.7684402819707981,5469350,0.23155971802920192,2001,2001.csv
2840,What Now?,23591043,23591043,1.0,0,0.0,2016,2016.csv
2841,Hustle & Flow,23563727,22202809,0.9422452144348812,1360918,0.057754785565118795,2005,2005.csv
2842,No manches Frida,23540937,11528613,0.48972617360133114,12012324,0.5102738263986688,2016,2016.csv
2843,Biker Boyz,23510621,22076772,0.9390127125948736,1433849,0.06098728740512639,2003,2003.csv
2844,Youth,23469540,2703296,0.11518316933352762,20766244,0.8848168306664723,2015,2015.csv
2845,Wish Upon,23468586,14301505,0.6093892917110558,9167081,0.39061070828894423,2017,2017.csv
2846,Valley of the Wolves: Iraq,23465471,0,0.0,23465471,1.0,2006,2006.csv
2847,Tomcats,23430766,13558739,0.5786724599614029,9872027,0.4213275400385971,2001,2001.csv
2848,Only Cloud Knows,23410836,0,0.0,23410836,1.0,2019,2019.csv
2849,Kingdom Come,23396049,23249649,0.9937425331943868,146400,0.006257466805613204,2001,2001.csv
2850,Antwone Fisher,23367586,21078145,0.9020249246113826,2289441,0.09797507538861738,2002,2002.csv
2851,Detroit,23355100,16790139,0.7189067484189748,6564961,0.2810932515810251,2017,2017.csv
2852,Paris,23328518,1010194,0.04330296506619066,22318324,0.9566970349338093,2008,2008.csv
2853,Middle School: The Worst Years of My Life,23316139,20007149,0.8580815631610362,3308990,0.14191843683896377,2016,2016.csv
2854,Under the Same Moon,23313049,12590147,0.5400472070384272,10722902,0.4599527929615727,2008,2008.csv
2855,Warrior,23308615,13657115,0.5859256330760108,9651500,0.41407436692398925,2011,2011.csv
2856,Jonas Brothers: The 3D Concert Experience,23186960,19162740,0.8264446913265042,4024220,0.1735553086734958,2009,2009.csv
2857,Super Troopers,23182223,18492362,0.7976958033748532,4689861,0.2023041966251468,2002,2002.csv
2858,The Peanut Butter Falcon,23178310,20457151,0.8825989038890238,2721159,0.11740109611097617,2019,2019.csv
2859,Triple 9,23177948,12639297,0.5453156163781194,10538651,0.4546843836218806,2016,2016.csv
2860,Hoodwinked! 2011 Re-release,23167844,10143779,0.4378387130023838,13024065,0.5621612869976161,2011,2011.csv
2861,Rock Dog,23157646,9420546,0.40680067395451164,13737100,0.5931993260454884,2016,2016.csv
2862,The Choice,23064015,18730891,0.8121262061267304,4333124,0.1878737938732697,2016,2016.csv
2863,"OSS 117: Cairo, Nest of Spies",23041621,303543,0.013173682528672787,22738078,0.9868263174713272,2006,2006.csv
2864,Confidence,23014206,12251640,0.5323511921288964,10762566,0.46764880787110363,2003,2003.csv
2865,Padmaavat,22991060,11846060,0.5152463609768319,11145000,0.48475363902316815,2018,2018.csv
2866,Aquamarine,22989957,18597342,0.8089333094446414,4392615,0.19106669055535858,2006,2006.csv
2867,Imagine That,22985194,16123323,0.7014656043364264,6861871,0.2985343956635737,2009,2009.csv
2868,Days of Glory,22963701,320700,0.013965518885653493,22643001,0.9860344811143466,2006,2006.csv
2869,The Human Stain,22954068,5381908,0.23446423527193525,17572160,0.7655357647280647,2003,2003.csv
2870,Domino,22944502,10169202,0.4432086606194373,12775300,0.5567913393805627,2005,2005.csv
2871,Armored,22942221,15988876,0.6969192738575747,6953345,0.30308072614242537,2009,2009.csv
2872,Young Adult,22939027,16311571,0.7110838223434673,6627456,0.28891617765653266,2011,2011.csv
2873,A Perfect Getaway,22938329,15515460,0.6763988780525382,7422869,0.3236011219474618,2009,2009.csv
2874,A Separation,22926076,7099055,0.30964980662194436,15827021,0.6903501933780556,2011,2011.csv
2875,The Wind that Shakes the Barley,22899908,1836089,0.08017888106799381,21063819,0.9198211189320062,2006,2006.csv
2876,Baggage Claim,22871096,21569509,0.9430903092707057,1301587,0.056909690729294304,2013,2013.csv
2877,Won't You Be My Neighbor?,22844741,22835787,0.9996080498351897,8954,0.0003919501648103605,2018,2018.csv
2878,Dr. T & the Women,22844291,13113041,0.5740182962999377,9731250,0.42598170370006233,2000,2000.csv
2879,Kon-Tiki,22842887,1517410,0.06642811830220935,21325477,0.9335718816977907,2012,2012.csv
2880,Sweet Sixteen,22819702,34327,0.001504270301163442,22785375,0.9984957296988366,2016,2016.csv
2881,The Ruins,22818256,17432844,0.763986695565165,5385412,0.23601330443483498,2008,2008.csv
2882,Captain Fantastic,22787526,5879835,0.2580286688427695,16907691,0.7419713311572305,2016,2016.csv
2883,Persepolis,22783978,4445756,0.19512641734467967,18338222,0.8048735826553204,2007,2007.csv
2884,Extraordinary Mission,22757764,54174,0.0023804623336457836,22703590,0.9976195376663543,2017,2017.csv
2885,Black and Blue,22741061,22055313,0.9698453823240701,685748,0.030154617675929897,2019,2019.csv
2886,U2 3D,22730842,10363341,0.4559154033977272,12367501,0.5440845966022728,2008,2008.csv
2887,The Accidental Husband,22707064,0,0.0,22707064,1.0,2008,2008.csv
2888,Fading Gigolo,22706304,3769873,0.1660275930420028,18936431,0.8339724069579972,2014,2014.csv
2889,Cassandra's Dream,22686378,973018,0.04288996683384188,21713360,0.9571100331661582,2007,2007.csv
2890,Live by Night,22678555,10378555,0.45763740238300016,12300000,0.5423625976169999,2016,2016.csv
2891,EuroTrip,22605153,17771387,0.7861653048753973,4833766,0.2138346951246028,2004,2004.csv
2892,Hunt for the Wilderpeople,22519390,5205468,0.2311549291521662,17313922,0.7688450708478338,2016,2016.csv
2893,The Farewell,22516645,17695781,0.7858977658527725,4820864,0.21410223414722754,2019,2019.csv
2894,Doomsday,22472631,11008770,0.48987455006937103,11463861,0.5101254499306289,2008,2008.csv
2895,Julieta,22468044,1490948,0.06635860246668557,20977096,0.9336413975333144,2016,2016.csv
2896,Swimming Pool,22441497,10130108,0.45140072429214506,12311389,0.5485992757078549,2003,2003.csv
2897,Two Can Play That Game,22391450,22235901,0.9930531966442548,155549,0.006946803355745161,2001,2001.csv
2898,Late Night,22386555,15499454,0.6923554785450463,6887101,0.30764452145495363,2019,2019.csv
2899,Dead Silence,22382047,16809076,0.7510070906383138,5572971,0.24899290936168617,2007,2007.csv
2900,Mojin: The Worm Valley,22381583,101516,0.004535693476194244,22280067,0.9954643065238058,2018,2018.csv
2901,The Contender,22361811,17872723,0.7992520373238107,4489088,0.20074796267618933,2000,2000.csv
2902,Solace,22354572,0,0.0,22354572,1.0,2015,2015.csv
2903,I've Loved You So Long,22272176,3169305,0.1422988485723173,19102871,0.8577011514276827,2008,2008.csv
2904,Twenty,22271862,136125,0.006111972137758397,22135737,0.9938880278622416,2015,2015.csv
2905,Fei chang xing yun,22259179,64432,0.0028946260776284696,22194747,0.9971053739223715,2013,2013.csv
2906,NASCAR: The IMAX Experience,22248831,21583831,0.970110789191576,665000,0.029889210808424046,2004,2004.csv
2907,Reign Over Me,22242388,19661987,0.8839872319464979,2580401,0.11601276805350216,2007,2007.csv
2908,Waitress,22240529,19074800,0.8576594558519719,3165729,0.14234054414802813,2007,2007.csv
2909,Fifty Shades of Black,22227514,11686940,0.5257870943192298,10540574,0.47421290568077024,2015,2015.csv
2910,Upside Down,22187813,105095,0.004736609236791386,22082718,0.9952633907632086,2012,2012.csv
2911,Mr. Turner,22179785,3958500,0.17847332604892246,18221285,0.8215266739510775,2014,2014.csv
2912,Fanaa,22175908,2105352,0.09493870555379288,20070556,0.9050612944462071,2006,2006.csv
2913,The Marine,22165608,18844784,0.8501812357233783,3320824,0.1498187642766217,2006,2006.csv
2914,Ghosts of the Abyss,22141539,17040871,0.7696335381203628,5100668,0.2303664618796372,2003,2003.csv
2915,Sabotage,22126842,10508518,0.4749217262906293,11618324,0.5250782737093708,2014,2014.csv
2916,The Glass Castle,22088533,17273059,0.7819921313923383,4815474,0.21800786860766172,2017,2017.csv
2917,Little Black Book,22035509,20698668,0.9393324202313639,1336841,0.06066757976863616,2004,2004.csv
2918,Big Brother,22029250,85624,0.0038868322798097984,21943626,0.9961131677201902,2018,2018.csv
2919,Reno 911! Miami,22021262,20342161,0.9237509185440871,1679101,0.07624908145591293,2007,2007.csv
2920,My Blueberry Nights,22007671,867275,0.039407850108264524,21140396,0.9605921498917355,2007,2007.csv
2921,Love Don't Cost a Thing,21964072,21924226,0.9981858555189584,39846,0.0018141444810415846,2003,2003.csv
2922,Unaccompanied Minors,21949234,16655224,0.7588066171238596,5294010,0.24119338287614045,2006,2006.csv
2923,Bullet to the Head,21947209,9489829,0.4323934309824999,12457380,0.5676065690175002,2013,2013.csv
2924,Leap! 2017 Re-release,21929861,21858070,0.9967263358395204,71791,0.003273664160479631,2017,2017.csv
2925,OSS 117: Lost in Rio,21924245,89375,0.004076537185202957,21834870,0.995923462814797,2009,2009.csv
2926,Like Stars on Earth,21897373,1223869,0.05589113360767065,20673504,0.9441088663923294,2007,2007.csv
2927,Flicka,21893591,21000147,0.9591915277854601,893444,0.04080847221453986,2006,2006.csv
2928,Mr 3000,21839377,21811187,0.9987092122637015,28190,0.0012907877362985218,2004,2004.csv
2929,Black or White,21833967,21571189,0.9879647157110754,262778,0.012035284288924683,2015,2015.csv
2930,Master Z: The Ip Man Legacy,21832649,209454,0.009593613674639298,21623195,0.9904063863253607,2018,2018.csv
2931,The Barbarian Invasions 2003 Re-release,21815430,3435749,0.1574916928064219,18379681,0.8425083071935782,2003,2003.csv
2932,Welcome Back,21775694,1388365,0.0637575546386719,20387329,0.9362424453613281,2015,2015.csv
2933,Diana,21766271,335359,0.015407278536594533,21430912,0.9845927214634055,2013,2013.csv
2934,Legends of Oz: Dorothy's Return,21755418,8462347,0.38897652989246173,13293071,0.6110234701075383,2014,2014.csv
2935,Proud Mary,21753365,20877013,0.9597141867476595,876352,0.0402858132523405,2018,2018.csv
2936,22 Bullets,21695883,0,0.0,21695883,1.0,2010,2010.csv
2937,Gretel & Hansel,21676865,15347654,0.708020001969842,6329211,0.29197999803015795,2020,2020.csv
2938,White Oleander,21672284,16357770,0.7547783150128523,5314514,0.24522168498714764,2002,2002.csv
2939,Dark Waters,21620897,11136084,0.5150611466305028,10484813,0.4849388533694971,2019,2019.csv
2940,Just Wright,21584424,21540363,0.9979586668608807,44061,0.0020413331391192094,2010,2010.csv
2941,Man of the House,21577624,19699706,0.91296919438396,1877918,0.08703080561604003,2005,2005.csv
2942,Wicker Park,21568818,13001257,0.6027802265288714,8567561,0.3972197734711286,2004,2004.csv
2943,It Follows,21528593,14674076,0.6816086866429218,6854517,0.3183913133570782,2015,2015.csv
2944,Win a Date with Tad Hamilton!,21513434,17071962,0.7935489053026124,4441472,0.20645109469738768,2004,2004.csv
2945,Black Christmas,21510851,16273581,0.7565289257965666,5237270,0.24347107420343342,2006,2006.csv
2946,Chak de! India,21505244,1120404,0.052099106617902124,20384840,0.9479008933820978,2007,2007.csv
2947,The Star 2019 Re-release,21502695,43510,0.002023467290960505,21459185,0.9979765327090395,2019,2019.csv
2948,My Soul to Take,21500813,14744435,0.6857617430559486,6756378,0.3142382569440514,2010,2010.csv
2949,Winged Migration,21493351,924651,0.04302032754222457,20568700,0.9569796724577754,2001,2001.csv
2950,Over Her Dead Body,21458111,7563670,0.35248536089686555,13894441,0.6475146391031344,2008,2008.csv
2951,The Merchant of Venice,21417725,3765585,0.17581629234664278,17652140,0.8241837076533572,2004,2004.csv
2952,Our Family Wedding,21409028,20255281,0.9461093235993713,1153747,0.053890676400628744,2010,2010.csv
2953,Love & Friendship,21401949,14016568,0.6549201663829776,7385381,0.34507983361702244,2016,2016.csv
2954,Shaft,21360215,21360215,1.0,0,0.0,2019,2019.csv
2955,Waist Deep,21353303,21344312,0.9995789410191014,8991,0.000421058980898646,2006,2006.csv
2956,Bears,21316745,17780194,0.8340951679067324,3536551,0.16590483209326753,2014,2014.csv
2957,Hotel Mumbai,21314816,9651611,0.4528123067072219,11663205,0.5471876932927782,2019,2019.csv
2958,Love Live! The School Idol Movie,21292009,115840,0.005440538748598124,21176169,0.9945594612514018,2015,2015.csv
2959,New York Minute,21289826,14071441,0.6609467357788645,7218385,0.33905326422113546,2004,2004.csv
2960,Michael Jordan to the Max,21268532,18650521,0.8769068311813905,2618011,0.12309316881860957,2000,2000.csv
2961,I'm So Excited!,21245677,1368119,0.06439517083875464,19877558,0.9356048291612453,2013,2013.csv
2962,The Prison,21205329,207481,0.009784380143312088,20997848,0.9902156198566879,2017,2017.csv
2963,ATL,21170563,21170563,1.0,0,0.0,2006,2006.csv
2964,Penelope,21156270,10011996,0.47324013164891543,11144274,0.5267598683510846,2007,2007.csv
2965,The Prodigy,21150265,14856291,0.7024163054221779,6293974,0.2975836945778221,2018,2018.csv
2966,Mindhunters,21148829,4480744,0.2118672386069224,16668085,0.7881327613930776,2004,2004.csv
2967,The Jacket,21126225,6303762,0.2983856320757731,14822463,0.7016143679242269,2005,2005.csv
2968,Beasts of the Southern Wild,21107746,12795746,0.6062109142302546,8312000,0.39378908576974536,2012,2012.csv
2969,Unplanned,21051915,19005109,0.9027734056497948,2046806,0.0972265943502052,2019,2019.csv
2970,Gonjiam: Haunted Asylum,21041950,115252,0.005477249019221127,20926698,0.9945227509807789,2018,2018.csv
2971,Yves Saint Laurent,21026290,723593,0.034413726815334514,20302697,0.9655862731846655,2014,2014.csv
2972,My Hero Academia: Two Heroes,21022724,5754556,0.27373027396449673,15268168,0.7262697260355033,2018,2018.csv
2973,The Infiltrator,21011110,15436808,0.7346974053250875,5574302,0.26530259467491246,2016,2016.csv
2974,Before Midnight,20994648,8114627,0.38650931418330997,12880021,0.6134906858166901,2013,2013.csv
2975,71: Into the Fire,20967660,176638,0.008424306765752593,20791022,0.9915756932342474,2010,2010.csv
2976,Once,20936722,9439923,0.45087874787657783,11496799,0.5491212521234222,2007,2007.csv
2977,El nino,20918976,1237,5.9132913580473535e-05,20917739,0.9999408670864195,2014,2014.csv
2978,Amores Perros,20908467,5408467,0.2586735316367288,15500000,0.7413264683632712,2001,2001.csv
2979,The Devil's Rejects,20901859,17044981,0.8154767956285611,3856878,0.18452320437143893,2005,2005.csv
2980,Pokémon Heroes,20867919,746381,0.035766910921975495,20121538,0.9642330890780245,2002,2002.csv
2981,A Thousand Words 2012 Re-release,20803842,18450127,0.8868615229821492,2353715,0.11313847701785083,2012,2012.csv
2982,Love Nowadays,20794985,2430083,0.11685908886205015,18364902,0.8831409111379499,2009,2009.csv
2983,Best in Show,20789556,18715392,0.900230481112728,2074164,0.09976951888727205,2000,2000.csv
2984,SuperFly,20780685,20545116,0.9886640406704591,235569,0.01133595932954087,2018,2018.csv
2985,I Love You Phillip Morris 2010 Re-release,20722843,2037459,0.09831947286383437,18685384,0.9016805271361656,2010,2010.csv
2986,Bobby,20704591,11242801,0.5430100502830507,9461790,0.45698994971694923,2006,2006.csv
2987,The Photograph,20653204,20578185,0.9963676822249952,75019,0.0036323177750047886,2020,2020.csv
2988,Keanu,20651333,20591853,0.9971197985137328,59480,0.0028802014862672545,2016,2016.csv
2989,Pandorum,20648328,10330853,0.5003239487478115,10317475,0.49967605125218856,2009,2009.csv
2990,Super Size Me,20645757,11536423,0.5587793656585225,9109334,0.4412206343414775,2004,2004.csv
2991,The Front Line,20629645,11018,0.0005340857780150847,20618627,0.9994659142219849,2011,2011.csv
2992,If Beale Street Could Talk,20596567,14915773,0.7241873366566379,5680794,0.275812663343362,2018,2018.csv
2993,The Best Offer,20596350,100035,0.004856928533453743,20496315,0.9951430714665462,2013,2013.csv
2994,Polisse,20590872,211440,0.010268627768653994,20379432,0.989731372231346,2011,2011.csv
2995,Walk Hard: The Dewey Cox Story,20576198,18317151,0.8902106696290539,2259047,0.10978933037094608,2007,2007.csv
2996,The Man with the Iron Fists,20546518,15634090,0.7609118975779741,4912428,0.23908810242202597,2012,2012.csv
2997,Country Strong,20529194,20218921,0.9848862551544888,310273,0.015113744845511227,2010,2010.csv
2998,Cock and Bull,20490872,82778,0.004039749992094041,20408094,0.995960250007906,2016,2016.csv
2999,My Life in Ruins,20455482,8665206,0.4236128975107993,11790276,0.5763871024892007,2009,2009.csv
3000,The Sapphires,20423628,2450867,0.12000154918607017,17972761,0.8799984508139298,2012,2012.csv
3001,That Demon Within,20415934,172343,0.00844159272850314,20243591,0.9915584072714969,2014,2014.csv
3002,Beerfest,20387597,19185184,0.9410223284284067,1202413,0.05897767157159326,2006,2006.csv
3003,The Clan,20381995,201227,0.009872782325773311,20180768,0.9901272176742267,2015,2015.csv
3004,Ladies in Lavender,20377075,6765081,0.3319947048337409,13611994,0.6680052951662592,2004,2004.csv
3005,The Namesake,20354321,13569248,0.6666519605345715,6785073,0.3333480394654285,2007,2007.csv
3006,Burn the Stage: The Movie,20347513,4201819,0.20650282911724888,16145694,0.7934971708827512,2018,2018.csv
3007,Brahms: The Boy II,20311536,12611536,0.6209050856616654,7700000,0.37909491433833464,2020,2020.csv
3008,Cold War 2018 Re-release,20296042,4580048,0.22566212663533117,15715994,0.7743378733646689,2018,2018.csv
3009,Labor Day,20275812,13371528,0.6594817509651402,6904284,0.3405182490348599,2014,2014.csv
3010,Ong-Bak: The Thai Warrior,20235426,4563167,0.22550387622182996,15672259,0.77449612377817,2003,2003.csv
3011,Singh Is Bliing,20224851,919095,0.045443845297055585,19305756,0.9545561547029444,2015,2015.csv
3012,Serving Sara,20146150,16930185,0.8403682589477394,3215965,0.1596317410522606,2002,2002.csv
3013,Melinda and Melinda,20129327,3826280,0.19008484486341745,16303047,0.8099151551365825,2004,2004.csv
3014,Mulholland Drive,20117339,7220243,0.35890646372266233,12897096,0.6410935362773377,2001,2001.csv
3015,I Heart Huckabees,20072172,12785432,0.6369730191630483,7286740,0.3630269808369518,2004,2004.csv
3016,The Bling Ring,20045576,5845732,0.29162205166865746,14199844,0.7083779483313425,2013,2013.csv
3017,Evening,20016753,12492481,0.6241012715698695,7524272,0.3758987284301305,2007,2007.csv
3018,Asterix & Obelix: Mission Cleopatra 2002 Re-release,20015611,3115188,0.155637916824023,16900423,0.8443620831759769,2002,2002.csv
3019,The Company You Keep,20014680,5133027,0.25646310608013717,14881653,0.7435368939198628,2012,2012.csv
3020,The Wife,19978189,9601092,0.48057869509593687,10377097,0.5194213049040631,2018,2018.csv
3021,Himalaya 2001 Re-release,19960881,2487878,0.12463768508013248,17473003,0.8753623149198675,2001,2001.csv
3022,Crazy/Beautiful,19937988,16937988,0.8495334634567941,3000000,0.15046653654320585,2001,2001.csv
3023,Ballistic: Ecks vs. Sever,19924033,14307963,0.7181258432968868,5616070,0.2818741567031133,2002,2002.csv
3024,Get Over It,19900366,11576464,0.5817211603042879,8323902,0.4182788396957121,2001,2001.csv
3025,Jaane Tu... Ya Jaane Na,19852786,604037,0.030425805224516097,19248749,0.9695741947754839,2008,2008.csv
3026,Blindness,19844979,3351751,0.1688966765850445,16493228,0.8311033234149555,2008,2008.csv
3027,The Rooftop,19833152,85755,0.0043238210446831645,19747397,0.9956761789553168,2013,2013.csv
3028,The Diving Bell and the Butterfly,19780116,6003227,0.3034980684643103,13776889,0.6965019315356897,2007,2007.csv
3029,2 Days in Paris,19776159,4433994,0.22420905899876714,15342165,0.7757909410012328,2007,2007.csv
3030,Summer Catch,19772447,19753553,0.9990444278343494,18894,0.0009555721656505136,2001,2001.csv
3031,The Perfect Man,19770475,16535005,0.8363483932480125,3235470,0.1636516067519875,2005,2005.csv
3032,Gone,19767535,11682205,0.590979350738471,8085330,0.4090206492615291,2012,2012.csv
3033,Thomas and the Magic Railroad,19748009,15933506,0.8068411352253283,3814503,0.1931588647746717,2000,2000.csv
3034,It Comes at Night,19735344,13985117,0.7086330494163162,5750227,0.2913669505836838,2017,2017.csv
3035,Another Year,19722766,3205706,0.1625383579564854,16517060,0.8374616420435146,2010,2010.csv
3036,Brothers,19694450,613775,0.031164871321615988,19080675,0.9688351286783841,2015,2015.csv
3037,Blackhat,19652057,8005980,0.4073863616414302,11646077,0.5926136383585698,2015,2015.csv
3038,Youth in Revolt,19651093,15281286,0.7776303333356572,4369807,0.2223696666643428,2010,2010.csv
3039,Amelia,19643086,14246488,0.7252673027038623,5396598,0.2747326972961377,2009,2009.csv
3040,Don,19640129,2223961,0.11323555970533594,17416168,0.8867644402946641,2006,2006.csv
3041,Shackleton's Antarctic Adventure,19613216,15553324,0.7930022287013002,4059892,0.2069977712986998,2001,2001.csv
3042,S1m0ne,19576023,9688676,0.49492565471546496,9887347,0.5050743452845351,2002,2002.csv
3043,The Guard,19561904,5360274,0.27401596490811936,14201630,0.7259840350918806,2011,2011.csv
3044,Puella Magi Madoka Magica the Movie Part III: The Rebellion Story,19544634,375627,0.019218932418995412,19169007,0.9807810675810046,2013,2013.csv
3045,View from the Top,19526014,15614000,0.7996511730453537,3912014,0.20034882695464626,2003,2003.csv
3046,Margin Call,19504039,5354039,0.2745092439571106,14150000,0.7254907560428894,2011,2011.csv
3047,In This Corner of the World,19496308,172147,0.008829723042947414,19324161,0.9911702769570526,2016,2016.csv
3048,The Lion King 2002 IMAX Release,19486215,15686215,0.8049903483051993,3800000,0.19500965169480067,2002,2002.csv
3049,2046,19470239,1444588,0.0741946721866126,18025651,0.9258053278133874,2004,2004.csv
3050,Blue Is the Warmest Colour,19465835,2199787,0.11300758482746823,17266048,0.8869924151725318,2013,2013.csv
3051,Vanity Fair,19463185,16136476,0.8290768443088836,3326709,0.17092315569111632,2004,2004.csv
3052,Buried,19439764,1044143,0.05371171172654154,18395621,0.9462882882734585,2010,2010.csv
3053,Get Carter,19412993,14967182,0.7709878636436948,4445811,0.2290121363563053,2000,2000.csv
3054,The Edge of Seventeen,19370020,14431633,0.7450499792979047,4938387,0.2549500207020953,2016,2016.csv
3055,Tuck Everlasting,19344615,19161999,0.9905598534786038,182616,0.009440146521396265,2002,2002.csv
3056,Rock Star,19334145,17008282,0.8797017918299465,2325863,0.12029820817005354,2001,2001.csv
3057,Duplex,19322135,9692135,0.5016078709728505,9630000,0.4983921290271494,2003,2003.csv
3058,The White Ribbon,19319671,2222862,0.115056928246863,17096809,0.884943071753137,2009,2009.csv
3059,Deep Blue,19288261,132261,0.006857072288683775,19156000,0.9931429277113162,2003,2003.csv
3060,The Lost City of Z,19263938,8580410,0.44541308220572556,10683528,0.5545869177942745,2017,2017.csv
3061,O,19260537,16025437,0.8320347973683184,3235100,0.16796520263168155,2001,2001.csv
3062,Half Past Dead,19233280,15567860,0.809423041727672,3665420,0.19057695827232796,2002,2002.csv
3063,Foxcatcher,19206513,12096300,0.6298019843581185,7110213,0.3701980156418815,2014,2014.csv
3064,Martin Lawrence Live: Runteldat,19184820,19184820,1.0,0,0.0,2002,2002.csv
3065,Everybody Knows,19176163,2660165,0.13872248582784782,16515998,0.8612775141721521,2018,2018.csv
3066,My Annoying Brother,19162324,51996,0.0027134495794977685,19110328,0.9972865504205022,2016,2016.csv
3067,How to Lose Friends & Alienate People,19152009,2778752,0.14508932196094937,16373257,0.8549106780390506,2008,2008.csv
3068,They Shall Not Grow Old 2018 Re-release,19130011,17956913,0.9386776097515052,1173098,0.06132239024849489,2018,2018.csv
3069,Oolong Courtyard: KungFu School,19129015,37727,0.0019722395533695804,19091288,0.9980277604466304,2018,2018.csv
3070,The Weather Man,19126398,12482775,0.6526464104741521,6643623,0.347353589525848,2005,2005.csv
3071,Shame,19123767,3909002,0.20440543957683652,15214765,0.7955945604231635,2011,2011.csv
3072,Norwegian Wood,19115721,13000,0.000680068515333531,19102721,0.9993199314846665,2010,2010.csv
3073,Bhool Bhulaiyaa,19073095,1097797,0.05755736025013245,17975298,0.9424426397498675,2007,2007.csv
3074,Always Miss You,19015465,91884,0.0048320669518205316,18923581,0.9951679330481795,2019,2019.csv
3075,Memoir of a Murderer,19015346,91335,0.004803225773541013,18924011,0.995196774226459,2017,2017.csv
3076,A Mighty Heart,19008745,9176787,0.4827665897985375,9831958,0.5172334102014625,2007,2007.csv
3077,Headhunters,18962444,1200010,0.0632835092354129,17762434,0.9367164907645871,2011,2011.csv
3078,Akeelah and the Bee,18948425,18848430,0.9947227803893991,99995,0.005277219610600881,2006,2006.csv
3079,The Man Who Wasn't There,18916623,7504257,0.3967017263070687,11412366,0.6032982736929313,2001,2001.csv
3080,The Curse of the Jade Scorpion,18914307,7517191,0.3974341222229289,11397116,0.602565877777071,2001,2001.csv
3081,Feardotcom,18902015,13258249,0.7014198750768106,5643766,0.2985801249231894,2002,2002.csv
3082,[Rec] 2,18853164,27766,0.0014727501442198243,18825398,0.9985272498557802,2009,2009.csv
3083,The Counterfeiters,18814713,5488570,0.291716913247627,13326143,0.708283086752373,2007,2007.csv
3084,Sex Drive,18755936,8402485,0.4479907054491975,10353451,0.5520092945508025,2008,2008.csv
3085,Les Misérables,18755018,330181,0.017604941781447503,18424837,0.9823950582185524,2013,2013.csv
3086,A Mighty Wind,18750246,17781006,0.948307878200638,969240,0.051692121799361994,2003,2003.csv
3087,Look at Me,18729751,1737308,0.09275659884640218,16992443,0.9072434011535978,2004,2004.csv
3088,3000 Miles to Graceland,18720175,15749959,0.8413360986208729,2970216,0.15866390137912706,2001,2001.csv
3089,Pina,18705853,3524826,0.18843439002754914,15181027,0.8115656099724509,2011,2011.csv
3090,Happy-Go-Lucky,18696602,3512016,0.1878424753332183,15184586,0.8121575246667817,2008,2008.csv
3091,13 Assassins,18689058,802778,0.042954438902164035,17886280,0.957045561097836,2010,2010.csv
3092,Glee: The 3D Concert Movie,18663238,11862398,0.6356023536751768,6800840,0.3643976463248232,2011,2011.csv
3093,The Drop,18658381,10724389,0.5747759679684963,7933992,0.4252240320315037,2014,2014.csv
3094,Greta,18653107,10532219,0.56463617562479,8120888,0.43536382437521,2019,2019.csv
3095,Peppa Celebrates Chinese New Year,18653040,131225,0.0070350462980833155,18521815,0.9929649537019167,2019,2019.csv
3096,Waiting...,18637690,16124543,0.8651578065736687,2513147,0.13484219342633127,2005,2005.csv
3097,Admission,18637201,18007317,0.9662028649044457,629884,0.03379713509555431,2013,2013.csv
3098,Max Keeble's Big Move,18634654,17294293,0.9280715917773413,1340361,0.07192840822265871,2001,2001.csv
3099,An Unfinished Life,18618284,8586392,0.46118063297347917,10031892,0.5388193670265208,2005,2005.csv
3100,De-Lovely,18611951,13456633,0.7230103388946167,5155318,0.2769896611053833,2004,2004.csv
3101,Detective K: Secret of the Living Dead,18603476,104013,0.005591051908793819,18499463,0.9944089480912062,2018,2018.csv
3102,Fired Up!,18599102,17231291,0.9264582236282161,1367811,0.07354177637178397,2009,2009.csv
3103,Battle of the Sexes,18598607,12638526,0.6795415377076358,5960081,0.32045846229236413,2017,2017.csv
3104,The Turning,18594342,15472775,0.8321227500279386,3121567,0.16787724997206138,2020,2020.csv
3105,Empire,18591272,17600423,0.9467035391661205,990849,0.05329646083387947,2002,2002.csv
3106,Keeping Mum,18575768,1619466,0.0871816443874622,16956302,0.9128183556125378,2005,2005.csv
3107,See No Evil,18564467,15032800,0.8097620039401078,3531667,0.19023799605989228,2006,2006.csv
3108,Black Christmas,18529730,10429730,0.5628646504833044,8100000,0.4371353495166956,2019,2019.csv
3109,My Love,18513120,885574,0.04783494084195425,17627546,0.9521650591580457,2007,2007.csv
3110,Airpocalypse,18491089,105678,0.005715077137966293,18385411,0.9942849228620337,2018,2018.csv
3111,My Baby's Daddy,18490423,17669317,0.955592903418164,821106,0.044407096581835906,2004,2004.csv
3112,Motherless Brooklyn,18477736,9277736,0.5021035044553077,9200000,0.4978964955446923,2019,2019.csv
3113,Easy Virtue,18463793,2656784,0.14389156117597288,15807009,0.8561084388240271,2008,2008.csv
3114,Summer Wars,18434328,80768,0.004381391065624958,18353560,0.995618608934375,2009,2009.csv
3115,Repo Men,18409891,13794835,0.7493164951384014,4615056,0.25068350486159857,2010,2010.csv
3116,Loser,18404706,15618626,0.848621325437092,2786080,0.151378674562908,2000,2000.csv
3117,Kabei: Our Mother,18385964,14416,0.0007840763747824156,18371548,0.9992159236252176,2008,2008.csv
3118,Bandidas,18381890,0,0.0,18381890,1.0,2006,2006.csv
3119,The Wasted Times,18345372,386540,0.021070164180917127,17958832,0.9789298358190829,2016,2016.csv
3120,Fabricated City,18307490,104874,0.005728475066762292,18202616,0.9942715249332377,2017,2017.csv
3121,Asura,18300843,175702,0.009600759921277943,18125141,0.990399240078722,2016,2016.csv
3122,The World's Fastest Indian,18297690,5128124,0.28026073236567023,13169566,0.7197392676343298,2005,2005.csv
3123,Chappaquiddick,18263470,17395520,0.9524761723812616,867950,0.04752382761873839,2018,2018.csv
3124,Friends with Money,18245244,13368437,0.7327080416134747,4876807,0.26729195838652525,2006,2006.csv
3125,The Visitor,18197518,9427089,0.5180425704208673,8770429,0.48195742957913273,2008,2008.csv
3126,Daddy Day Camp,18197398,13235267,0.7273164548030439,4962131,0.2726835451969562,2007,2007.csv
3127,Antitrust,18195610,11328094,0.6225729173135718,6867516,0.3774270826864282,2001,2001.csv
3128,My Boss's Daughter,18191005,15550605,0.8548513399891869,2640400,0.14514866001081303,2003,2003.csv
3129,The Case for Christ,18175663,14682684,0.8078210957146378,3492979,0.19217890428536225,2017,2017.csv
3130,Sorry to Bother You,18170707,17493096,0.9627086056695537,677611,0.03729139433044625,2018,2018.csv
3131,Soul Kitchen,18164139,276901,0.01524437794711877,17887238,0.9847556220528813,2009,2009.csv
3132,Hell Fest,18159691,11107431,0.6116530837446518,7052260,0.3883469162553482,2018,2018.csv
3133,All the Pretty Horses,18133495,15540353,0.8569971205219954,2593142,0.14300287947800466,2000,2000.csv
3134,Blinded by the Light,18096691,11901145,0.6576420517983095,6195546,0.3423579482016906,2019,2019.csv
3135,The Lighthouse,18082592,10867104,0.600970480338217,7215488,0.399029519661783,2019,2019.csv
3136,Dead Man Down,18074539,10895295,0.6027979468798623,7179244,0.3972020531201377,2013,2013.csv
3137,Krrish,18041250,1430721,0.07930276449802535,16610529,0.9206972355019747,2006,2006.csv
3138,The Country Bears,18012097,16990825,0.9433007716980427,1021272,0.05669922830195729,2002,2002.csv
3139,Quills,17989227,7065332,0.3927535074186345,10923895,0.6072464925813655,2000,2000.csv
3140,Kalank,17987034,2729336,0.15173908049542797,15257698,0.848260919504572,2019,2019.csv
3141,Dope,17986781,17506470,0.9732964447612944,480311,0.02670355523870558,2015,2015.csv
3142,Whiteout,17976667,10275638,0.5716097427849112,7701029,0.4283902572150889,2009,2009.csv
3143,Cantinflas,17966873,6382924,0.3552607067462435,11583949,0.6447392932537566,2014,2014.csv
3144,Night Watch 2005 Re-release,17939389,1502188,0.08373685413700545,16437201,0.9162631458629945,2005,2005.csv
3145,City of Ember,17929684,7873007,0.43910461556377683,10056677,0.5608953844362232,2008,2008.csv
3146,"Carry On, Munna Bhai",17897527,2217562,0.12390326328324577,15679965,0.8760967367167543,2006,2006.csv
3147,We Have a Pope,17877523,548115,0.030659448739067487,17329408,0.9693405512609325,2011,2011.csv
3148,A Prophet,17874044,2087720,0.11680177132830152,15786324,0.8831982286716985,2009,2009.csv
3149,The Old Man & the Gun,17860397,11277120,0.6314036580485864,6583277,0.3685963419514135,2018,2018.csv
3150,The Quiet Ones,17835162,8509867,0.4771398768343119,9325295,0.5228601231656881,2014,2014.csv
3151,Flyboys,17834865,13090630,0.7339909777842445,4744235,0.2660090222157555,2006,2006.csv
3152,The Edge of Heaven,17804565,742349,0.04169430704990546,17062216,0.9583056929500945,2007,2007.csv
3153,Friendship,17779520,1243910,0.06996308111805043,16535610,0.9300369188819496,2008,2008.csv
3154,Deception,17772506,4598506,0.258742689410261,13174000,0.741257310589739,2008,2008.csv
3155,Unforgettable,17768012,11368012,0.6398021343074284,6400000,0.36019786569257156,2017,2017.csv
3156,Reign of Government,17722998,1009065,0.05693534468604014,16713933,0.9430646553139599,2008,2008.csv
3157,The Last Kiss,17720347,1048950,0.05919466475458974,16671397,0.9408053352454102,2002,2002.csv
3158,Joyeux Noel,17709155,1054361,0.059537623336630124,16654794,0.9404623766633698,2005,2005.csv
3159,The Children Act,17696794,547750,0.03095193400567357,17149044,0.9690480659943265,2018,2018.csv
3160,Memories of Tomorrow,17696020,140200,0.007922685440002894,17555820,0.9920773145599971,2006,2006.csv
3161,Regression,17671101,55039,0.0031146333213759574,17616062,0.996885366678624,2015,2015.csv
3162,Before I Go to Sleep,17669776,3242457,0.18350300535784947,14427319,0.8164969946421505,2014,2014.csv
3163,Kit Kittredge: An American Girl,17657973,17657973,1.0,0,0.0,2008,2008.csv
3164,The Oxford Murders,17646627,4803,0.0002721766601628742,17641824,0.9997278233398371,2008,2008.csv
3165,Swing Vote,17634313,16289867,0.9237596610653332,1344446,0.07624033893466675,2008,2008.csv
3166,Neerja,17618280,1585687,0.09000237253579804,16032593,0.909997627464202,2015,2015.csv
3167,Operation Finale,17612099,17612099,1.0,0,0.0,2018,2018.csv
3168,Avenue Montaigne,17574836,2044858,0.11635146979465413,15529978,0.8836485302053458,2006,2006.csv
3169,Deliver Us from Eva,17573594,17573594,1.0,0,0.0,2003,2003.csv
3170,Little Boy,17572289,6485961,0.3691016577293943,11086328,0.6308983422706057,2015,2015.csv
3171,Toilet: A Love Story,17567417,1830715,0.10421082393615408,15736702,0.8957891760638459,2017,2017.csv
3172,In the Land of Women,17562071,11052958,0.6293652952433685,6509113,0.3706347047566315,2007,2007.csv
3173,Loving Pablo,17535962,22017,0.0012555341988081407,17513945,0.9987444658011918,2018,2018.csv
3174,Addicted,17534314,17390770,0.9918135377295056,143544,0.0081864622704943,2014,2014.csv
3175,Roll Bounce,17500866,17380866,0.9931431964566781,120000,0.006856803543321799,2005,2005.csv
3176,Annapolis,17496992,17127992,0.9789106607581464,369000,0.021089339241853685,2006,2006.csv
3177,Machete Kills,17496820,8008161,0.45769236924195367,9488659,0.5423076307580463,2013,2013.csv
3178,Rebound,17492014,16809014,0.9609536100302687,683000,0.03904638996973133,2005,2005.csv
3179,"Paris, je t'aime",17471727,4899278,0.2804117761226466,12572449,0.7195882238773534,2006,2006.csv
3180,Capitalism: A Love Story,17436509,14363397,0.8237541700577793,3073112,0.17624582994222066,2009,2009.csv
3181,A Guy Thing,17432163,15545431,0.8917671891893163,1886732,0.10823281081068367,2003,2003.csv
3182,Frailty,17423030,13110448,0.7524780706914929,4312582,0.2475219293085072,2002,2002.csv
3183,Fate/Stay Night: Heaven's Feel - I. Presage Flower,17422935,193833,0.011125163469874622,17229102,0.9888748365301254,2017,2017.csv
3184,Stolen,17415418,304318,0.017474056608919753,17111100,0.9825259433910802,2012,2012.csv
3185,Kapoor & Sons,17412627,2607036,0.14972100418851217,14805591,0.8502789958114878,2016,2016.csv
3186,Billy and Buddy,17400053,894,5.1379153845106106e-05,17399159,0.9999486208461549,2013,2013.csv
3187,Fruitvale Station,17385830,16101339,0.9261185114544431,1284491,0.07388148854555693,2013,2013.csv
3188,Firehouse Dog,17384424,13932383,0.8014290838741623,3452041,0.19857091612583772,2007,2007.csv
3189,The Matador,17347231,12594698,0.7260350657692862,4752533,0.27396493423071383,2005,2005.csv
3190,Fate/stay night [Heaven's Feel] II. lost butterfly,17295864,420595,0.024317663459888447,16875269,0.9756823365401116,2019,2019.csv
3191,The Importance of Being Earnest,17290970,8384929,0.4849310940913089,8906041,0.515068905908691,2002,2002.csv
3192,While We're Young,17287309,7587485,0.4389049215236449,9699824,0.5610950784763551,2015,2015.csv
3193,12 Rounds,17280326,12234694,0.7080129159600346,5045632,0.2919870840399654,2009,2009.csv
3194,Legend of the Naga Pearls,17274695,13588,0.0007865840757246365,17261107,0.9992134159242754,2017,2017.csv
3195,Adventureland,17164820,16044025,0.9347039467934998,1120795,0.06529605320650027,2009,2009.csv
3196,Mother,17149348,551509,0.03215918179513297,16597839,0.967840818204867,2009,2009.csv
3197,My Afternoons with Margueritte,17107143,666557,0.03896366564539736,16440586,0.9610363343546027,2010,2010.csv
3198,Kinsey,17050017,10254979,0.6014644442876509,6795038,0.39853555571234917,2004,2004.csv
3199,Melancholia,17039814,3030848,0.17786860819020678,14008966,0.8221313918097932,2011,2011.csv
3200,Beyond Outrage,17027515,3878,0.0002277490285576022,17023637,0.9997722509714424,2012,2012.csv
3201,Kung Pow: Enter the Fist,16994625,16037962,0.9437079076472709,956663,0.056292092352729174,2002,2002.csv
3202,Death Sentence,16974459,9534258,0.5616825844051937,7440201,0.4383174155948063,2007,2007.csv
3203,Chinese Puzzle,16968297,338523,0.019950322651707476,16629774,0.9800496773482925,2013,2013.csv
3204,Jason X,16951798,13121555,0.7740509295828089,3830243,0.22594907041719114,2001,2001.csv
3205,Catch That Kid,16951702,16703799,0.9853759227244556,247903,0.014624077275544368,2004,2004.csv
3206,Rachel Getting Married,16937968,12796841,0.7555121724164315,4141127,0.24448782758356846,2008,2008.csv
3207,The Nutcracker in 3D,16918946,195459,0.011552670006748648,16723487,0.9884473299932514,2010,2010.csv
3208,Sugar & Spice,16908947,13305101,0.7868675086627216,3603846,0.21313249133727843,2001,2001.csv
3209,Material Girls,16907725,11449638,0.677183831650917,5458087,0.32281616834908305,2006,2006.csv
3210,Calvary,16887741,3600006,0.21317273873397277,13287735,0.7868272612660272,2014,2014.csv
3211,Life or Something Like It,16872671,14448589,0.8563308678276249,2424082,0.1436691321723751,2002,2002.csv
3212,The Last Godfather,16863629,164247,0.009739718538637206,16699382,0.9902602814613628,2010,2010.csv
3213,The Cold Light of Day,16863583,3763583,0.2231781348008902,13100000,0.7768218651991098,2012,2012.csv
3214,The Pyramid,16861137,2756333,0.16347254636505237,14104804,0.8365274536349476,2014,2014.csv
3215,The Good Girl,16856124,14018296,0.8316440956414417,2837828,0.16835590435855835,2002,2002.csv
3216,Monkey Kingdom,16839663,16432322,0.9758106204381881,407341,0.024189379561811896,2015,2015.csv
3217,Femme Fatale,16838910,6630252,0.3937459134825235,10208658,0.6062540865174765,2002,2002.csv
3218,House of 1000 Corpses,16829545,12634962,0.7507607603176437,4194583,0.24923923968235623,2003,2003.csv
3219,Hit and Run,16816647,13749300,0.8176005597310807,3067347,0.18239944026891924,2012,2012.csv
3220,Hardcore Henry,16810562,9252038,0.5503705349053768,7558524,0.44962946509462326,2016,2016.csv
3221,Hollywoodland,16800438,14426251,0.8586830295733956,2374187,0.14131697042660435,2006,2006.csv
3222,Paparazzi,16796512,15714234,0.9355653126077604,1082278,0.06443468739223954,2004,2004.csv
3223,The Birth of a Nation,16779212,15861566,0.9453105425928225,917646,0.05468945740717741,2016,2016.csv
3224,House of Sand and Fog,16763804,13040288,0.7778835877584825,3723516,0.22211641224151749,2003,2003.csv
3225,102 Not Out,16758596,1343797,0.08018553582889641,15414799,0.9198144641711036,2018,2018.csv
3226,Miss Pettigrew Lives for a Day,16724933,12313694,0.7362477326516046,4411239,0.26375226734839535,2008,2008.csv
3227,Love Is All You Need,16722143,1631709,0.09757774467064419,15090434,0.9024222553293558,2012,2012.csv
3228,Delhi Belly,16706074,1532594,0.09173872927894369,15173480,0.9082612707210563,2011,2011.csv
3229,Pride,16699029,1446634,0.08662982739894637,15252395,0.9133701726010536,2014,2014.csv
3230,Whip It,16691303,13043363,0.7814466611743852,3647940,0.21855333882561476,2009,2009.csv
3231,Dogville,16680836,1535286,0.0920389121984054,15145550,0.9079610878015946,2003,2003.csv
3232,American Dreamz,16656103,7191830,0.4317834730008574,9464273,0.5682165269991426,2006,2006.csv
3233,CyberWorld,16653900,11253900,0.6757516257453209,5400000,0.32424837425467906,2000,2000.csv
3234,My Way,16653488,70177,0.004213952056169854,16583311,0.9957860479438302,2011,2011.csv
3235,Digimon: The Movie,16643191,9631153,0.5786842799556888,7012038,0.4213157200443112,2000,2000.csv
3236,Beautiful Boy,16636604,7649973,0.45982779899070747,8986631,0.5401722010092925,2018,2018.csv
3237,Everyone's Hero,16627188,14523101,0.8734550303996081,2104087,0.12654496960039183,2006,2006.csv
3238,Nothing to Lose 2,16610713,1150551,0.06926559985715243,15460162,0.9307344001428476,2019,2019.csv
3239,Belle,16607575,10726630,0.6458877951778029,5880945,0.3541122048221971,2014,2014.csv
3240,Upgrade,16593554,11977130,0.7217941376512832,4616424,0.27820586234871686,2018,2018.csv
3241,Sunshine Cleaning,16580250,12062558,0.7275257007584325,4517692,0.2724742992415675,2009,2009.csv
3242,The Dish,16575074,2552992,0.1540259790092038,14022082,0.8459740209907962,2000,2000.csv
3243,Tazza: One-Eyed Jack,16572611,97655,0.005892553683906537,16474956,0.9941074463160935,2019,2019.csv
3244,Battle of the Year,16549477,8888355,0.5370776973798024,7661122,0.4629223026201976,2013,2013.csv
3245,"Tomorrow, When the War Began",16533595,4936,0.00029854366216179845,16528659,0.9997014563378382,2010,2010.csv
3246,Silent House,16527747,12754783,0.7717194001094039,3772964,0.2282805998905961,2012,2012.csv
3247,A Secret,16494522,623558,0.03780394484908384,15870964,0.9621960551509162,2007,2007.csv
3248,The Fountain,16468343,10144010,0.6159702891784559,6324333,0.3840297108215441,2006,2006.csv
3249,Omkara,16466144,1244576,0.07558393756303844,15221568,0.9244160624369616,2006,2006.csv
3250,Pride and Prejudice and Zombies,16457494,10938134,0.6646293779599738,5519360,0.33537062204002627,2016,2016.csv
3251,They,16446271,12840842,0.7807752894257914,3605429,0.2192247105742086,2002,2002.csv
3252,Everybody's Fine,16443609,9208876,0.5600276678921275,7234733,0.4399723321078724,2009,2009.csv
3253,The Powerpuff Girls Movie,16426471,11412414,0.6947575045181646,5014057,0.3052424954818354,2002,2002.csv
3254,Poms,16418218,13631124,0.8302438181780751,2787094,0.1697561818219249,2019,2019.csv
3255,Forever My Girl,16376066,16376066,1.0,0,0.0,2018,2018.csv
3256,Before I Fall,16373843,12241122,0.7476022580648904,4132721,0.25239774193510955,2017,2017.csv
3257,The Magdalene Sisters,16373112,306989,0.018749581631152343,16066123,0.9812504183688476,2002,2002.csv
3258,The Single Moms Club,16365451,15973881,0.9760733755519478,391570,0.02392662444805218,2014,2014.csv
3259,Little Q,16360233,1652,0.0001009765569964682,16358581,0.9998990234430035,2019,2019.csv
3260,Italian for Beginners,16349568,4544753,0.27797388897370257,11804815,0.7220261110262974,2000,2000.csv
3261,Playmobil: The Movie,16349303,1115008,0.068199115277269,15234295,0.931800884722731,2019,2019.csv
3262,Macbeth,16322067,1110707,0.06804940820301743,15211360,0.9319505917969826,2015,2015.csv
3263,The Emperor's Club,16318449,14118751,0.865201772545908,2199698,0.13479822745409198,2002,2002.csv
3264,Two Lovers,16303643,3149034,0.19314910170690072,13154609,0.8068508982930993,2008,2008.csv
3265,Evangelion: 1.0 You Are (Not) Alone,16283819,107797,0.0066198844386565585,16176022,0.9933801155613434,2007,2007.csv
3266,Rabbit-Proof Fence,16217411,6199600,0.38228050087649623,10017811,0.6177194991235038,2002,2002.csv
3267,Caché,16197824,3647381,0.22517722133540902,12550443,0.774822778664591,2005,2005.csv
3268,Gangnam 1970,16191434,18022,0.0011130576822287637,16173412,0.9988869423177712,2015,2015.csv
3269,In the House,16190771,389757,0.024072788133437252,15801014,0.9759272118665627,2012,2012.csv
3270,Just Visiting,16176732,4781539,0.2955812706793931,11395193,0.7044187293206069,2001,2001.csv
3271,Birthday Girl,16171098,5142576,0.31801031692467635,11028522,0.6819896830753236,2002,2002.csv
3272,Catch and Release,16161742,15539051,0.9614712943691343,622691,0.03852870563086578,2007,2007.csv
3273,Iris,16153953,5594617,0.3463311426002044,10559336,0.6536688573997956,2001,2001.csv
3274,Scouts Guide to the Zombie Apocalypse,16137046,3703046,0.22947483696830262,12434000,0.7705251630316974,2015,2015.csv
3275,The Space Between Us,16080475,7885294,0.4903644948299102,8195181,0.5096355051700898,2017,2017.csv
3276,To Be and to Have,16063920,777129,0.04837729520565341,15286791,0.9516227047943466,2002,2002.csv
3277,Unfriended: Dark Web,16024987,8866745,0.5533074691417846,7158242,0.44669253085821536,2018,2018.csv
3278,Sea Rex 3D: Journey to a Prehistoric World,16004150,6096582,0.38093756931795814,9907568,0.6190624306820418,2010,2010.csv
3279,What the #$*! Do We (K)now!?,15998178,10942306,0.6839720123129022,5055872,0.3160279876870979,2004,2004.csv
3280,The Kitchen,15980032,12180032,0.762203229630579,3800000,0.23779677036942104,2019,2019.csv
3281,The Words,15950164,11494838,0.7206720883873043,4455326,0.27932791161269566,2012,2012.csv
3282,Before Sunset,15936507,5820649,0.3652399487541404,10115858,0.6347600512458595,2004,2004.csv
3283,Drowning Mona,15906764,15506764,0.974853464853065,400000,0.025146535146934976,2000,2000.csv
3284,The Nightmare Before Christmas 2008 3D Release,15894421,14486897,0.9114454059068903,1407524,0.08855459409310978,2007,2007.csv
3285,Wonder Wheel,15889124,1404061,0.08836616795236792,14485063,0.911633832047632,2017,2017.csv
3286,The Last Kiss,15852401,11614790,0.7326833329537904,4237611,0.2673166670462096,2006,2006.csv
3287,Finding Your Feet,15845593,1418682,0.08953164453990456,14426911,0.9104683554600954,2018,2018.csv
3288,Highlander: Endgame,15843608,12811858,0.8086452277789251,3031750,0.1913547722210749,2000,2000.csv
3289,The Hunt,15843274,613308,0.038710938155838245,15229966,0.9612890618441617,2012,2012.csv
3290,"I Love You, Beth Cooper",15821907,14800725,0.9354577169490378,1021182,0.06454228305096218,2009,2009.csv
3291,"I, Daniel Blake",15793051,260354,0.01648535169043651,15532697,0.9835146483095635,2016,2016.csv
3292,The Great Yokai War,15787492,0,0.0,15787492,1.0,2005,2005.csv
3293,Kiss Kiss Bang Bang,15785148,4243756,0.26884486607284264,11541392,0.7311551339271574,2005,2005.csv
3294,Away We Go,15779455,9451946,0.5990033242592979,6327509,0.4009966757407021,2009,2009.csv
3295,The Gospel,15778152,15778152,1.0,0,0.0,2005,2005.csv
3296,Shine a Light,15773351,5505267,0.3490232988538707,10268084,0.6509767011461293,2008,2008.csv
3297,Lantana,15747450,4623189,0.2935833420649058,11124261,0.7064166579350942,2001,2001.csv
3298,I Hate Luv Storys,15719212,847993,0.053946279240969584,14871219,0.9460537207590304,2010,2010.csv
3299,The Brand New Testament,15709652,127910,0.008142128164264873,15581742,0.9918578718357351,2015,2015.csv
3300,Enigma 2001 Re-release,15705007,4301582,0.27389876362360105,11403425,0.7261012363763989,2001,2001.csv
3301,Feng Shui,15702302,64147,0.004085197189558576,15638155,0.9959148028104414,2018,2018.csv
3302,Judy Moody and the Not Bummer Summer,15691640,15013650,0.956792916482917,677990,0.04320708351708298,2011,2011.csv
3303,Larry the Cable Guy: Health Inspector,15680099,15680099,1.0,0,0.0,2006,2006.csv
3304,Out of the Furnace,15660668,11330849,0.723522713079672,4329819,0.276477286920328,2013,2013.csv
3305,The Divine Move 2: The Wrathful,15642991,67578,0.004320017827792652,15575413,0.9956799821722073,2019,2019.csv
3306,Vampire Academy,15642346,7791979,0.4981336559106927,7850367,0.5018663440893073,2014,2014.csv
3307,Tully,15636462,9369755,0.5992247479001324,6266707,0.4007752520998676,2018,2018.csv
3308,The Conspirator,15623183,11538204,0.7385309382857513,4084979,0.2614690617142486,2011,2011.csv
3309,Facing Windows,15530077,543354,0.03498720579427906,14986723,0.965012794205721,2003,2003.csv
3310,Paranoia,15500644,7388654,0.47666755007082284,8111990,0.5233324499291772,2013,2013.csv
3311,With a Friend Like Harry...,15472186,3830441,0.24756947725421605,11641745,0.7524305227457839,2001,2001.csv
3312,Bait,15471969,15325127,0.9905091588536663,146842,0.009490841146333735,2000,2000.csv
3313,Zelary,15461305,330033,0.02134574022050532,15131272,0.9786542597794947,2003,2003.csv
3314,Chronicles of Evil,15460494,105057,0.006795190373606432,15355437,0.9932048096263936,2015,2015.csv
3315,The Greatest Game Ever Played,15431177,15337393,0.9939224337845389,93784,0.006077566215461076,2005,2005.csv
3316,The Haunting of Molly Hartley,15418749,13559812,0.8794365872354495,1858937,0.12056341276455049,2008,2008.csv
3317,Our Little Sister,15407615,64441,0.004182412398025262,15343174,0.9958175876019747,2015,2015.csv
3318,Anonymous,15395087,4463292,0.2899166467847827,10931795,0.7100833532152173,2011,2011.csv
3319,Miss Bala,15383580,15006824,0.9755092117699521,376756,0.024490788230047883,2019,2019.csv
3320,Alex & Emma,15368897,14218698,0.9251606019612207,1150199,0.07483939803877923,2003,2003.csv
3321,Apollo 11,15342353,9039891,0.5892115114285273,6302462,0.4107884885714727,2019,2019.csv
3322,The Dead Don't Die,15321451,6563605,0.4283931724221159,8757846,0.5716068275778841,2019,2019.csv
3323,"The Goods: Live Hard, Sell Hard",15300885,15122676,0.9883530266386552,178209,0.011646973361344785,2009,2009.csv
3324,Primeval,15291277,10597734,0.6930574863041197,4693543,0.3069425136958803,2007,2007.csv
3325,Namastey London,15273747,1207007,0.07902494391192941,14066740,0.9209750560880706,2007,2007.csv
3326,Brother,15250594,450594,0.029545996700194106,14800000,0.9704540032998059,2001,2001.csv
3327,Hey Arnold! The Movie,15249308,13728902,0.9002967216610748,1520406,0.09970327833892528,2002,2002.csv
3328,Ta Ra Rum Pum,15242548,872643,0.0572504675727444,14369905,0.9427495324272556,2007,2007.csv
3329,The Negotiation,15229193,110986,0.0072877138007247004,15118207,0.9927122861992753,2018,2018.csv
3330,Attack on Titan Part 2,15186410,305934,0.020145248284485932,14880476,0.9798547517155141,2015,2015.csv
3331,Spectacle,15159762,2065487,0.13624798331266677,13094275,0.8637520166873333,2015,2015.csv
3332,Transamerica,15151744,9015303,0.5950010111047283,6136441,0.40499898889527175,2005,2005.csv
3333,Extraordinary Measures,15134293,12068313,0.7974150493848638,3065980,0.2025849506151361,2010,2010.csv
3334,Irreplaceable,15130912,8494,0.0005613673518159382,15122418,0.9994386326481841,2016,2016.csv
3335,Surviving Christmas,15125687,11663156,0.7710827283415292,3462531,0.22891727165847078,2004,2004.csv
3336,Three,15121228,119550,0.007906103922247585,15001678,0.9920938960777524,2016,2016.csv
3337,The Dreamers,15121165,2532228,0.1674624937959476,12588937,0.8325375062040524,2003,2003.csv
3338,The Science of Sleep,15116179,4670644,0.3089831100835734,10445535,0.6910168899164266,2006,2006.csv
3339,War of the Buttons,15082409,47771,0.003167332221265184,15034638,0.9968326677787348,2011,2011.csv
3340,Ip Man 2,15061802,205675,0.013655404579080245,14856127,0.9863445954209198,2010,2010.csv
3341,The Housemaid,15038301,157961,0.01050391264279123,14880340,0.9894960873572087,2010,2010.csv
3342,Boat Trip,15020293,8600126,0.5725671263536604,6420167,0.42743287364633964,2002,2002.csv
3343,Change of Plans,15016366,46714,0.0031108724973805246,14969652,0.9968891275026195,2009,2009.csv
3344,The Assassination of Jesse James by the Coward Robert Ford,15001776,3909149,0.26057908077017017,11092627,0.7394209192298299,2007,2007.csv
3345,Journey to the South Pacific,14994876,7653913,0.510435231341693,7340963,0.489564768658307,2013,2013.csv
3346,Oldboy,14980005,707481,0.0472283553977452,14272524,0.9527716446022548,2003,2003.csv
3347,Undisputed,14946150,12764657,0.8540431482354988,2181493,0.14595685176450124,2002,2002.csv
3348,Harry Potter and the Deathly Hallows: Part 2 2018 Re-release,14895840,181938,0.01221401411400767,14713902,0.9877859858859923,2011,2011.csv
3349,Elegy,14894347,3581642,0.24046989102644112,11312705,0.7595301089735589,2008,2008.csv
3350,Blue Valentine,14892418,9706328,0.651763064936802,5186090,0.3482369350631979,2010,2010.csv
3351,Gold,14880939,7227038,0.4856573903031254,7653901,0.5143426096968746,2017,2017.csv
3352,School of Life,14880497,6300,0.00042337295588984697,14874197,0.9995766270441101,2017,2017.csv
3353,Raise Your Voice,14867514,10411980,0.7003174841469798,4455534,0.2996825158530202,2004,2004.csv
3354,Josie and the Pussycats,14866015,14271015,0.9599758240523771,595000,0.040024175947622816,2001,2001.csv
3355,Emperor,14858240,3346265,0.22521274390506546,11511975,0.7747872560949345,2013,2013.csv
3356,The Take,14857808,50269,0.0033833389151347224,14807539,0.9966166610848652,2016,2016.csv
3357,Supernova,14828081,14230455,0.9596963356215817,597626,0.040303664378418216,2000,2000.csv
3358,Soul Plane,14821824,14190750,0.9574226491962123,631074,0.04257735080378771,2004,2004.csv
3359,Little Children,14821658,5463019,0.3685835282395532,9358639,0.6314164717604468,2006,2006.csv
3360,Possession,14815898,10113733,0.6826270672219801,4702165,0.3173729327780199,2002,2002.csv
3361,Somewhere,14788642,1785645,0.12074435232119352,13002997,0.8792556476788065,2010,2010.csv
3362,Dabangg 3,14784628,202000,0.013662839538471985,14582628,0.986337160461528,2019,2019.csv
3363,Out Cold,14782676,13906394,0.940722369887563,876282,0.059277630112437016,2001,2001.csv
3364,Seondal: The Man Who Sells the River,14777982,97477,0.006596096814842514,14680505,0.9934039031851575,2016,2016.csv
3365,The Secret of the Grain,14776783,86356,0.005844032493405364,14690427,0.9941559675065946,2007,2007.csv
3366,The Triplets of Belleville,14776760,7007149,0.47420063667542817,7769611,0.5257993633245718,2003,2003.csv
3367,Katyn,14768451,118095,0.007996437811927602,14650356,0.9920035621880724,2007,2007.csv
3368,Elite Squad,14759148,8744,0.0005924461222287356,14750404,0.9994075538777712,2007,2007.csv
3369,A Royal Affair,14758997,1546761,0.10480122734627563,13212236,0.8951987726537244,2012,2012.csv
3370,Bhagam Bhag,14730896,789963,0.053626269576541714,13940933,0.9463737304234583,2006,2006.csv
3371,Sword Master,14714624,75526,0.005132716948798691,14639098,0.9948672830512013,2016,2016.csv
3372,Inherent Vice,14710975,8110975,0.5513553656368799,6600000,0.4486446343631201,2014,2014.csv
3373,Turistas,14697742,7027762,0.47815249444438473,7669980,0.5218475055556153,2006,2006.csv
3374,Iron Monkey,14694904,14694904,1.0,0,0.0,2001,2001.csv
3375,The Way Back,14690514,13590514,0.9251217486331655,1100000,0.0748782513668344,2020,2020.csv
3376,My Best Friend,14687738,1426784,0.09714116632527078,13260954,0.9028588336747292,2006,2006.csv
3377,Together with You,14687167,1151941,0.07843180376447002,13535226,0.92156819623553,2003,2003.csv
3378,Desert Flower 2009 Re-release,14682943,44348,0.003020375411114788,14638595,0.9969796245888852,2009,2009.csv
3379,"Hello, My Name Is Doris",14659448,14444999,0.985371277281382,214449,0.014628722718618054,2016,2016.csv
3380,Freedomland,14655628,12512886,0.8537939145289442,2142742,0.1462060854710559,2006,2006.csv
3381,Beyond the Lights,14618727,14618727,1.0,0,0.0,2014,2014.csv
3382,Welcome to Mooseport,14615099,14470947,0.9901367756728846,144152,0.009863224327115403,2004,2004.csv
3383,The Band's Visit,14587587,3054457,0.2093874058814525,11533130,0.7906125941185475,2007,2007.csv
3384,Together,14572229,1034829,0.07101377558642538,13537400,0.9289862244135746,2001,2001.csv
3385,Hollywood Ending,14569744,4850753,0.33293330342660793,9718991,0.6670666965733921,2002,2002.csv
3386,Megan Leavey,14510490,13406883,0.9239441948548947,1103607,0.07605580514510536,2017,2017.csv
3387,Envy,14494036,13562325,0.9357176289613189,931711,0.06428237103868101,2004,2004.csv
3388,Malena,14493284,3448233,0.23791937010273173,11045051,0.7620806298972683,2000,2000.csv
3389,A United Kingdom,14459330,3902185,0.269873154565253,10557145,0.7301268454347469,2016,2016.csv
3390,Serenity,14454622,8547045,0.5913018687033117,5907577,0.40869813129668836,2019,2019.csv
3391,America: Imagine the World Without Her,14444502,14444502,1.0,0,0.0,2014,2014.csv
3392,RBG,14441292,14017361,0.9706445240495103,423931,0.02935547595048975,2018,2018.csv
3393,Unfinished Business,14431253,10219501,0.7081506366772171,4211752,0.29184936332278283,2015,2015.csv
3394,45 Years,14430249,4247285,0.2943320659262359,10182964,0.705667934073764,2015,2015.csv
3395,Do You Believe?,14410698,12985600,0.9011083293814082,1425098,0.09889167061859183,2015,2015.csv
3396,Woodlawn,14401617,14394097,0.9994778364123973,7520,0.0005221635876026977,2015,2015.csv
3397,I Dreamed of Africa,14400327,6651522,0.4619007610035522,7748805,0.5380992389964477,2000,2000.csv
3398,How to Deal,14390329,14195227,0.986442144581962,195102,0.013557855418038044,2003,2003.csv
3399,Bright Star,14374652,4444637,0.30919962445003885,9930015,0.6908003755499611,2009,2009.csv
3400,Hot Rod,14353654,13938332,0.971065068170098,415322,0.028934931829901988,2007,2007.csv
3401,Eighth Grade,14347433,13539709,0.9437025424687469,807724,0.056297457531253155,2018,2018.csv
3402,Thugs of Hindostan,14341431,1449848,0.1010950720329094,12891583,0.8989049279670905,2018,2018.csv
3403,Being Julia,14339171,7739049,0.5397138370133113,6600122,0.4602861629866887,2004,2004.csv
3404,Freddy Got Fingered,14333252,14254993,0.9945400387853364,78259,0.005459961214663637,2001,2001.csv
3405,The Other Side of the Door,14332467,3000342,0.20933883887540086,11332125,0.7906611611245992,2016,2016.csv
3406,Beginners,14311701,5790894,0.4046265360071455,8520807,0.5953734639928545,2011,2011.csv
3407,The Beauty Inside,14301869,108083,0.007557264019129248,14193786,0.9924427359808707,2015,2015.csv
3408,Unsane,14293601,7732899,0.5410042577794077,6560702,0.45899574222059225,2018,2018.csv
3409,Stealing Harvard,14277032,14036406,0.9831459367745341,240626,0.01685406322546591,2002,2002.csv
3410,Colette,14273033,5137622,0.35995306673781247,9135411,0.6400469332621875,2018,2018.csv
3411,Caramel,14248749,1055580,0.07408229311920647,13193169,0.9259177068807936,2007,2007.csv
3412,Proof,14189860,7535331,0.5310363174830478,6654529,0.46896368251695225,2005,2005.csv
3413,What Planet Are You From?,14145677,6291602,0.4447720671128006,7854075,0.5552279328871994,2000,2000.csv
3414,Ya veremos,14134723,4165949,0.2947315628328903,9968774,0.7052684371671096,2018,2018.csv
3415,Shaandaar,14120808,521794,0.03695213475036273,13599014,0.9630478652496373,2015,2015.csv
3416,Red Lights,14107313,52624,0.0037302638709440982,14054689,0.9962697361290559,2012,2012.csv
3417,District 13: Ultimatum,14103752,36136,0.002562155091779833,14067616,0.9974378449082202,2009,2009.csv
3418,Seeking Justice,14089528,411746,0.02922354815576505,13677782,0.970776451844235,2011,2011.csv
3419,Island of Lemurs: Madagascar,14066534,11272213,0.8013497141513325,2794321,0.19865028584866748,2014,2014.csv
3420,Osmosis Jones,14026418,13596911,0.9693787109438775,429507,0.030621289056122526,2001,2001.csv
3421,Ghosts of Mars,14010832,8709640,0.621636174068749,5301192,0.3783638259312509,2001,2001.csv
3422,Tenacious D in the Pick of Destiny,13924254,8334575,0.5985652804092773,5589679,0.4014347195907228,2006,2006.csv
3423,Heyy Babyy,13921302,1443521,0.10369152253144139,12477781,0.8963084774685586,2007,2007.csv
3424,Dirty Pretty Things,13904766,8112414,0.5834268624153761,5792352,0.4165731375846239,2002,2002.csv
3425,Touching the Void,13885802,4593598,0.33081258108102074,9292204,0.6691874189189793,2003,2003.csv
3426,The Quake,13837294,6235,0.0004505938805665327,13831059,0.9995494061194334,2018,2018.csv
3427,La Belle Époque,13827149,0,0.0,13827149,1.0,2019,2019.csv
3428,House of the Dead,13818181,10249719,0.7417560241829225,3568462,0.25824397581707753,2003,2003.csv
3429,Juwanna Mann,13802599,13670733,0.9904462920352899,131866,0.009553707964710124,2002,2002.csv
3430,Winter's Bone,13796834,6531503,0.47340592776574686,7265331,0.5265940722342531,2010,2010.csv
3431,The Ladies Man,13743212,13616610,0.9907880341218632,126602,0.009211965878136785,2000,2000.csv
3432,One Night with the King,13728450,13395961,0.9757810240777364,332489,0.02421897592226362,2006,2006.csv
3433,Pulling Strings,13725819,5842961,0.4256912465478381,7882858,0.5743087534521619,2013,2013.csv
3434,American Outlaws,13678913,13342790,0.9754276527674385,336123,0.024572347232561534,2001,2001.csv
3435,Phantom,13676590,489984,0.03582647428927825,13186606,0.9641735257107218,2015,2015.csv
3436,Religulous,13639115,13011160,0.9539592561540833,627955,0.046040743845916686,2008,2008.csv
3437,All Is Lost,13627519,6263670,0.45963392162579264,7363849,0.5403660783742074,2013,2013.csv
3438,Sing Street,13624522,3237118,0.23759497764398635,10387404,0.7624050223560137,2016,2016.csv
3439,Sydney White,13620075,11892415,0.8731534150876555,1727660,0.12684658491234446,2007,2007.csv
3440,Do It Like An Hombre,13610252,2534252,0.18620169560416663,11076000,0.8137983043958333,2017,2017.csv
3441,Love Forecast,13608637,32211,0.0023669526933520232,13576426,0.9976330473066479,2015,2015.csv
3442,Strange Magic,13603453,12429583,0.9137079387123255,1173870,0.08629206128767454,2015,2015.csv
3443,Anything Else,13585075,3212310,0.23645876080919687,10372765,0.7635412391908032,2003,2003.csv
3444,The Two Faces of January,13551951,507463,0.03744575227581623,13044488,0.9625542477241837,2014,2014.csv
3445,The Last Station,13550772,6617867,0.48837564383785664,6932905,0.5116243561621434,2009,2009.csv
3446,Nymphomaniac: Vol. I,13545832,785896,0.05801755108139537,12759936,0.9419824489186046,2013,2013.csv
3447,The Comebacks,13539154,13349927,0.9860237205367485,189227,0.013976279463251544,2007,2007.csv
3448,Phantom of the Theatre,13526843,43955,0.0032494647864250363,13482888,0.9967505352135749,2016,2016.csv
3449,The Man,13485145,8330720,0.6177701463350969,5154425,0.38222985366490314,2005,2005.csv
3450,One Night at McCool's,13473370,6290673,0.46689677489744585,7182697,0.5331032251025541,2001,2001.csv
3451,Brideshead Revisited,13451186,6432256,0.4781924805738319,7018930,0.5218075194261681,2008,2008.csv
3452,The Lord of the Rings: The Two Towers 2003 Re-release,13451150,1996877,0.1484539983570178,11454273,0.8515460016429822,2003,2003.csv
3453,Three Identical Strangers,13448497,12320845,0.9161503326356841,1127652,0.08384966736431587,2018,2018.csv
3454,Made in China,13439480,921738,0.06858434998973174,12517742,0.9314156500102683,2009,2009.csv
3455,Trapped,13414416,7073251,0.5272872855590582,6341165,0.47271271444094176,2002,2002.csv
3456,Lords of Dogtown,13411957,11273517,0.8405571983268363,2138440,0.15944280167316374,2005,2005.csv
3457,The Third Murder,13411936,89315,0.006659366701421778,13322621,0.9933406332985782,2017,2017.csv
3458,The History Boys,13407101,2706659,0.20188249495547173,10700442,0.7981175050445283,2006,2006.csv
3459,Solarmax,13400161,13400161,1.0,0,0.0,2000,2000.csv
3460,Our President,13392049,507268,0.03787829629356942,12884781,0.9621217037064306,2017,2017.csv
3461,Ratchet & Clank,13385737,8821329,0.6590095860989947,4564408,0.3409904139010052,2016,2016.csv
3462,I Think I Love My Wife,13369768,12550605,0.9387302008531487,819163,0.061269799146851316,2007,2007.csv
3463,RRRrrrr!!!,13315054,54361,0.004082672139369469,13260693,0.9959173278606306,2004,2004.csv
3464,Hotel Artemis,13313581,6708147,0.5038574520258674,6605434,0.4961425479741326,2018,2018.csv
3465,Vera Drake,13267869,3775283,0.2845432827230959,9492586,0.7154567172769041,2004,2004.csv
3466,The Pirates Who Don't Do Anything: A VeggieTales Movie,13247725,12981269,0.9798866597849819,266456,0.02011334021501805,2008,2008.csv
3467,Bhootnath,13236817,476032,0.035962724271250406,12760785,0.9640372757287496,2008,2008.csv
3468,Paris Can Wait,13203541,5617731,0.42547154585273755,7585810,0.5745284541472625,2017,2017.csv
3469,Kal ho naa ho,13200241,1991922,0.15090042674220872,11208319,0.8490995732577913,2003,2003.csv
3470,The Well Digger's Daughter,13194167,386368,0.029283243117962657,12807799,0.9707167568820373,2011,2011.csv
3471,The Honeymooners,13183426,12843849,0.9742421279567238,339577,0.025757872043276155,2005,2005.csv
3472,Mommy,13156856,3494070,0.2655702851805933,9662786,0.7344297148194067,2014,2014.csv
3473,The Sisters Brothers,13143056,3143056,0.23914194689576002,10000000,0.76085805310424,2018,2018.csv
3474,Head Over Heels,13127022,10424470,0.7941229930139524,2702552,0.20587700698604755,2001,2001.csv
3475,Delhi-6,13125579,879913,0.06703803314124276,12245666,0.9329619668587572,2009,2009.csv
3476,The Crew,13105853,13023075,0.9936838907013531,82778,0.006316109298646948,2000,2000.csv
3477,Hillary's America: The Secret History of the Democratic Party,13099931,13099931,1.0,0,0.0,2016,2016.csv
3478,How to Eat Fried Worms,13098996,13040527,0.9955363754596154,58469,0.004463624540384622,2006,2006.csv
3479,In the Name of the King: A Dungeon Siege Tale,13097915,4775656,0.364611924875066,8322259,0.635388075124934,2007,2007.csv
3480,The Angels' Share,13090471,346669,0.026482545967979304,12743802,0.9735174540320207,2012,2012.csv
3481,Shut In,13082071,6900335,0.5274650321038619,6181736,0.47253496789613814,2016,2016.csv
3482,Hot Tub Time Machine 2,13081651,12314651,0.94136825695778,767000,0.05863174304221998,2015,2015.csv
3483,The Way of the Gun,13069740,6055661,0.4633344657200526,7014079,0.5366655342799475,2000,2000.csv
3484,The Barbarian Invasions,13065317,5109226,0.39105258601838744,7956091,0.6089474139816126,2003,2003.csv
3485,Welcome to Marwen,13061491,10763520,0.8240651852074162,2297971,0.1759348147925838,2018,2018.csv
3486,"Roman J. Israel, Esq.",13025860,11962778,0.9183868090091556,1063082,0.08161319099084437,2017,2017.csv
3487,Friends with Kids,13019073,7251073,0.5569577035169861,5768000,0.4430422964830138,2012,2012.csv
3488,The Vatican Tapes,13015764,1784763,0.13712318385613015,11231001,0.8628768161438698,2015,2015.csv
3489,Thirst,13008937,318574,0.02448885716027374,12690363,0.9755111428397263,2009,2009.csv
3490,In a Better World,13004504,1008098,0.07751914259859508,11996406,0.922480857401405,2010,2010.csv
3491,The Divorce,12991996,9081057,0.6989731985754922,3910939,0.30102680142450783,2003,2003.csv
3492,Pyaar Ka Punchnama 2,12983721,222856,0.017164262848839713,12760865,0.9828357371511602,2015,2015.csv
3493,The Wave,12975143,177404,0.013672604610215086,12797739,0.9863273953897849,2015,2015.csv
3494,I Saw the Devil,12966357,129210,0.00996501947308716,12837147,0.9900349805269129,2010,2010.csv
3495,Le Havre,12959706,611709,0.04720083927829844,12347997,0.9527991607217016,2011,2011.csv
3496,Loving,12957265,7751969,0.5982720118790501,5205296,0.4017279881209499,2016,2016.csv
3497,Child 44,12951093,1224330,0.09453487825313277,11726763,0.9054651217468672,2015,2015.csv
3498,Paris 36,12940622,851540,0.06580363756858056,12089082,0.9341963624314195,2008,2008.csv
3499,Godzilla 2000,12924063,10037390,0.7766435369434519,2886673,0.22335646305654808,2000,2000.csv
3500,Gods and Generals,12923936,12882934,0.9968274370903725,41002,0.0031725629096275316,2003,2003.csv
3501,Take Point,12908032,112386,0.008706671938836221,12795646,0.9912933280611638,2018,2018.csv
3502,Mubarakan,12899968,758868,0.05882712267193221,12141100,0.9411728773280678,2017,2017.csv
3503,My Brother Is an Only Child,12894062,255620,0.019824629352643102,12638442,0.9801753706473569,2007,2007.csv
3504,Formula 51,12881605,5204007,0.4039874689528207,7677598,0.5960125310471793,2001,2001.csv
3505,Cherry Blossoms,12861658,104589,0.00813184427699757,12757069,0.9918681557230025,2008,2008.csv
3506,In the Mood for Love,12854953,2738980,0.21306806800460493,10115973,0.7869319319953951,2000,2000.csv
3507,Earth: One Amazing Day,12851540,81345,0.006329591628707532,12770195,0.9936704083712925,2017,2017.csv
3508,Slither,12834936,7802450,0.607907199537263,5032486,0.39209280046273703,2006,2006.csv
3509,The Girl from Paris,12812396,183266,0.014303803909901006,12629130,0.985696196090099,2001,2001.csv
3510,Knockaround Guys,12806614,11715637,0.9148114404010302,1090977,0.08518855959896972,2002,2002.csv
3511,Aliens of the Deep,12770637,8968684,0.7022894785906137,3801953,0.29771052140938625,2005,2005.csv
3512,Street Fighter: The Legend of Chun-Li,12764201,8742261,0.6849046798933988,4021940,0.31509532010660124,2009,2009.csv
3513,Suburbicon,12751667,5775178,0.4528959233330042,6976489,0.5471040766669958,2017,2017.csv
3514,Elle,12748594,2341534,0.18366997960716294,10407060,0.8163300203928371,2016,2016.csv
3515,Bon Cop Bad Cop,12735126,12665721,0.9945501128139603,69405,0.00544988718603962,2006,2006.csv
3516,Populaire,12698385,179091,0.014103447013143797,12519294,0.9858965529868562,2012,2012.csv
3517,The Past,12673462,1331747,0.10508154756766541,11341715,0.8949184524323346,2013,2013.csv
3518,"Remember Me, My Love",12671306,227986,0.01799230481846149,12443320,0.9820076951815385,2003,2003.csv
3519,Redemption,12671109,36895,0.0029117419793326695,12634214,0.9970882580206674,2013,2013.csv
3520,The Green Inferno,12666449,7192291,0.5678222049447323,5474158,0.43217779505526766,2015,2015.csv
3521,Chasing Papi,12661189,6130049,0.4841606108241493,6531140,0.5158393891758507,2003,2003.csv
3522,Idlewild,12643027,12571185,0.9943176582633257,71842,0.005682341736674295,2006,2006.csv
3523,Winged Migration 2003 Re-release,12634963,10764402,0.8519535830852849,1870561,0.14804641691471515,2003,2003.csv
3524,Narc,12633747,10465659,0.8283891548564333,2168088,0.17161084514356667,2002,2002.csv
3525,Made in Dagenham,12629471,1095369,0.08673118612806506,11534102,0.9132688138719349,2010,2010.csv
3526,Luis and the Aliens,12627729,169710,0.013439471182823135,12458019,0.9865605288171768,2018,2018.csv
3527,Politics,12604224,1514558,0.12016273274737103,11089666,0.879837267252629,2010,2010.csv
3528,Their Finest,12597262,3603484,0.2860529534116223,8993778,0.7139470465883777,2017,2017.csv
3529,Maria Full of Grace,12594630,6529624,0.5184450833410748,6065006,0.48155491665892525,2004,2004.csv
3530,Gossip,12591270,5108820,0.4057430267161295,7482450,0.5942569732838705,2000,2000.csv
3531,People Like Us,12558931,12434778,0.9901143656255457,124153,0.009885634374454322,2012,2012.csv
3532,A Tribute to Love,12552605,1852050,0.14754307970337632,10700555,0.8524569202966237,2007,2007.csv
3533,Breakin' All the Rules,12544254,12264319,0.9776842050551591,279935,0.022315794944840883,2004,2004.csv
3534,Apocalypse Now Redux 2001 Re-release,12543269,4626290,0.36882649969477654,7916979,0.6311735003052235,2001,2001.csv
3535,The Clearing,12520799,5763875,0.46034402437096866,6756924,0.5396559756290313,2004,2004.csv
3536,Sorority Boys,12517488,10200032,0.8148625347194262,2317456,0.18513746528057387,2002,2002.csv
3537,Zoom,12506362,11989328,0.9586583212608111,517034,0.041341678739188904,2006,2006.csv
3538,Seducing Doctor Lewis,12504038,9354342,0.7481056919372766,3149696,0.2518943080627234,2003,2003.csv
3539,Ready to Rumble,12452362,12394327,0.9953394384133709,58035,0.004660561586629107,2000,2000.csv
3540,The Promise,12448676,8224288,0.6606556392021128,4224388,0.33934436079788727,2017,2017.csv
3541,Can You Ever Forgive Me?,12442161,8803865,0.707583272712835,3638296,0.292416727287165,2018,2018.csv
3542,Nine Queens,12413888,1222889,0.09850974972546876,11190999,0.9014902502745312,2002,2002.csv
3543,Monsieur Ibrahim,12364836,2823890,0.22838070800130306,9540946,0.7716192919986969,2003,2003.csv
3544,Rampant,12359573,167937,0.013587605332320138,12191636,0.9864123946676798,2018,2018.csv
3545,Tall Tales from the Magical Garden of Antoon Krings 2018 Re-release,12353849,220,1.7808215075317822e-05,12353629,0.9999821917849246,2018,2018.csv
3546,Casshern,12353768,0,0.0,12353768,1.0,2004,2004.csv
3547,Soul Men,12331637,12082391,0.9797880849071376,249246,0.020211915092862368,2008,2008.csv
3548,Say It Isn't So,12320393,5520393,0.4480695542747703,6800000,0.5519304457252298,2001,2001.csv
3549,Chasing Liberty,12313323,12195626,0.990441491707803,117697,0.009558508292196996,2004,2004.csv
3550,Abandon,12302219,10727683,0.8720120329511286,1574536,0.12798796704887141,2002,2002.csv
3551,Marrowbone,12294931,1377,0.00011199737517843735,12293554,0.9998880026248216,2017,2017.csv
3552,The Beatles: Eight Days a Week - The Touring Years,12283800,2930414,0.23855924062586495,9353386,0.761440759374135,2016,2016.csv
3553,The Current War: Director's Cut,12282385,5979540,0.4868386718051909,6302845,0.5131613281948091,2019,2019.csv
3554,The Man Who Knew Infinity,12252684,3866794,0.3155875071943421,8385890,0.684412492805658,2016,2016.csv
3555,Bandslam,12225023,5210988,0.42625588516275187,7014035,0.5737441148372482,2009,2009.csv
3556,Gainsbourg: A Heroic Life,12220456,233007,0.0190669644406068,11987449,0.9809330355593932,2010,2010.csv
3557,The Guillotines,12217440,5290,0.0004329875980565487,12212150,0.9995670124019435,2012,2012.csv
3558,I Married an Anti-Fan,12194083,89408,0.007332080649278835,12104675,0.9926679193507212,2016,2016.csv
3559,Koi... Mil Gaya,12168232,671372,0.05517416170237385,11496860,0.9448258382976261,2003,2003.csv
3560,Little Women,12165890,1379497,0.11339055342436928,10786393,0.8866094465756307,2018,2018.csv
3561,The Eye,12165016,512049,0.04209192984209803,11652967,0.957908070157902,2002,2002.csv
3562,My Big Fat Independent Movie,12155249,4655,0.0003829621260740936,12150594,0.9996170378739259,2005,2005.csv
3563,Dark Blue,12150301,9250301,0.7613227853367583,2900000,0.23867721466324168,2003,2003.csv
3564,Miss & Mrs. Cops,12147170,104578,0.008609248080005466,12042592,0.9913907519199945,2019,2019.csv
3565,Bachelorette,12128575,447954,0.03693377004305947,11680621,0.9630662299569406,2012,2012.csv
3566,End of the Spear,12128105,11967000,0.9867163913900812,161105,0.013283608609918863,2006,2006.csv
3567,Barney's Version,12104765,4439201,0.3667316961543657,7665564,0.6332683038456344,2011,2011.csv
3568,Bella,12083296,8070537,0.6679085739520078,4012759,0.3320914260479922,2007,2007.csv
3569,Stoker,12077441,1714221,0.14193577927642123,10363220,0.8580642207235788,2012,2012.csv
3570,Don't Move,12071007,337265,0.027940088179884248,11733742,0.9720599118201158,2004,2004.csv
3571,The Connection,12062441,190980,0.01583261630046522,11871461,0.9841673836995348,2014,2014.csv
3572,The Bookshop,12055868,1588150,0.13173253058178805,10467718,0.868267469418212,2017,2017.csv
3573,Dave Chappelle's Block Party,12051924,11718595,0.9723422583813174,333329,0.027657741618682626,2006,2006.csv
3574,Three Burials,12045362,5027684,0.41739584082238457,7017678,0.5826041591776154,2005,2005.csv
3575,Tamara Drewe,12037973,560391,0.04655194026436178,11477582,0.9534480597356382,2010,2010.csv
3576,Spread,12035862,250618,0.020822604978355516,11785244,0.9791773950216445,2009,2009.csv
3577,I Am Love,12014663,5005465,0.4166130169443787,7009198,0.5833869830556213,2010,2010.csv
3578,The Cookout,12009070,11814019,0.9837580262251782,195051,0.016241973774821863,2004,2004.csv
3579,A Most Violent Year,12007070,5749134,0.47881239969451334,6257936,0.5211876003054867,2014,2014.csv
3580,The Return,11992014,7749851,0.6462509967049739,4242163,0.3537490032950262,2006,2006.csv
3581,The Assassin,11991669,632542,0.052748453947486375,11359127,0.9472515460525136,2015,2015.csv
3582,This Must Be the Place,11928909,143979,0.012069754241565594,11784930,0.9879302457584344,2011,2011.csv
3583,The Polar Express 2005 IMAX Release,11910480,10900597,0.9152105540666707,1009883,0.08478944593332931,2005,2005.csv
3584,The Hedgehog 2009 Re-release,11906717,707945,0.059457615394738955,11198772,0.9405423846052611,2009,2009.csv
3585,Keep Dancing,11905018,695157,0.05839193187276155,11209861,0.9416080681272384,2007,2007.csv
3586,The Warring States,11868961,68961,0.005810196865589161,11800000,0.9941898031344109,2011,2011.csv
3587,Viceroy's House,11868221,1105717,0.09316619567498785,10762504,0.9068338043250121,2017,2017.csv
3588,Boy Erased,11853081,6788692,0.5727364893566491,5064389,0.4272635106433509,2018,2018.csv
3589,Layer Cake,11850214,2339957,0.1974611597731484,9510257,0.8025388402268516,2004,2004.csv
3590,Unstoppable,11845347,101417,0.008561758469380424,11743930,0.9914382415306195,2018,2018.csv
3591,Smart People,11843604,9511289,0.8030738785254894,2332315,0.19692612147451063,2008,2008.csv
3592,What Women Want,11838177,123526,0.010434545791974559,11714651,0.9895654542080254,2011,2011.csv
3593,Last Letter,11834622,180946,0.015289546214488303,11653676,0.9847104537855117,2018,2018.csv
3594,The Rules of Attraction,11819244,6532619,0.5527103933212649,5286625,0.44728960667873513,2002,2002.csv
3595,Ash Is Purest White,11813509,422814,0.03579072060638376,11390695,0.9642092793936162,2018,2018.csv
3596,Chloe,11808880,3075255,0.2604188542859272,8733625,0.7395811457140729,2010,2010.csv
3597,Getaway,11806432,10501938,0.8895098874918349,1304494,0.11049011250816504,2013,2013.csv
3598,Ballon,11799591,34222,0.002900270017833669,11765369,0.9970997299821663,2018,2018.csv
3599,The Divine Fury,11799556,102982,0.0087276165306559,11696574,0.9912723834693441,2019,2019.csv
3600,Win Win,11789613,10179275,0.8634104444310429,1610338,0.1365895555689572,2011,2011.csv
3601,Toni Erdmann,11784207,1479387,0.12553980085380373,10304820,0.8744601991461962,2016,2016.csv
3602,The Interview,11782625,6105175,0.5181506667656826,5677450,0.4818493332343175,2014,2014.csv
3603,Millions,11782282,6584159,0.5588186566914627,5198123,0.44118134330853737,2005,2005.csv
3604,The Hoax,11772461,7164995,0.60862337959752,4607466,0.39137662040248,2006,2006.csv
3605,The Longshots,11767866,11537046,0.9803855686324097,230820,0.019614431367590352,2008,2008.csv
3606,The Son's Room,11767402,1016340,0.08636910679179652,10751062,0.9136308932082035,2001,2001.csv
3607,C'est Si Bon,11750035,164167,0.013971617956882681,11585868,0.9860283820431173,2015,2015.csv
3608,Beyond Borders,11705002,4430101,0.3784793031218619,7274901,0.621520696878138,2003,2003.csv
3609,Seeking a Friend for the End of the World,11681781,7078738,0.6059639364922181,4603043,0.3940360635077819,2012,2012.csv
3610,Shopgirl,11675161,10284523,0.8808891800292946,1390638,0.11911081997070533,2005,2005.csv
3611,A Sound of Thunder,11665465,1900451,0.16291257999573955,9765014,0.8370874200042604,2005,2005.csv
3612,I'm Not There,11664116,4017609,0.3444417905308898,7646507,0.6555582094691103,2007,2007.csv
3613,After the Wedding,11632723,1534584,0.13191958580978846,10098139,0.8680804141902115,2006,2006.csv
3614,Back to Burgundy,11625884,257610,0.02215831501501305,11368274,0.9778416849849869,2017,2017.csv
3615,The Lunchbox 2013 Re-release,11621581,4235151,0.36442124354681177,7386430,0.6355787564531883,2013,2013.csv
3616,Delicacy,11597420,498584,0.042990941088621434,11098836,0.9570090589113786,2011,2011.csv
3617,Looking for Eric,11562239,55804,0.0048264008381075675,11506435,0.9951735991618924,2009,2009.csv
3618,The Order,11560806,7660806,0.6626532786727846,3900000,0.33734672132721544,2002,2002.csv
3619,The Legend of Drunken Master,11555430,11555430,1.0,0,0.0,2000,2000.csv
3620,Haute Cuisine,11509942,217883,0.01892998244474212,11292059,0.9810700175552579,2012,2012.csv
3621,Wedding Daze,11492406,0,0.0,11492406,1.0,2007,2007.csv
3622,Something New,11483669,11468568,0.9986850021539283,15101,0.0013149978460716694,2006,2006.csv
3623,Fists of Legend,11478881,134213,0.011692167555356658,11344668,0.9883078324446434,2013,2013.csv
3624,Trumbo,11430025,7857741,0.6874649005579603,3572284,0.3125350994420397,2015,2015.csv
3625,Seasons,11425100,150092,0.013137040376014214,11275008,0.9868629596239857,2016,2016.csv
3626,Fun Size,11417362,9409538,0.8241429149745799,2007824,0.17585708502542005,2012,2012.csv
3627,Suspect Zero,11416075,8725813,0.7643444003302361,2690262,0.2356555996697639,2004,2004.csv
3628,Bring The Soul: The Movie,11393886,4809800,0.42213868034136903,6584086,0.577861319658631,2019,2019.csv
3629,Watch Out Ladies,11386430,702166,0.061666914037147726,10684264,0.9383330859628523,2008,2008.csv
3630,The King's Case Note,11383493,90959,0.007990429651074587,11292534,0.9920095703489255,2017,2017.csv
3631,King of Thieves,11353515,7518,0.0006621737849467764,11345997,0.9993378262150532,2018,2018.csv
3632,Bajirao Mastani,11350917,6557047,0.577666720671114,4793870,0.4223332793288859,2015,2015.csv
3633,The Apparition,11350665,4936819,0.4349365433655209,6413846,0.5650634566344791,2012,2012.csv
3634,Snow Flower and the Secret Fan,11348205,1348205,0.11880337022463024,10000000,0.8811966297753697,2011,2011.csv
3635,I Still Believe,11346349,9868521,0.8697529927908969,1477828,0.13024700720910312,2020,2020.csv
3636,Connie and Carla,11341016,8085771,0.7129670745548723,3255245,0.28703292544512765,2004,2004.csv
3637,Kabhi Khushi Kabhie Gham...,11329690,2902000,0.2561411653805179,8427690,0.7438588346194821,2001,2001.csv
3638,Quiet Chaos,11326121,11434,0.0010095247967066572,11314687,0.9989904752032933,2008,2008.csv
3639,"It's Not You, It's Me",11301956,1339911,0.11855567301801564,9962045,0.8814443269819844,2010,2010.csv
3640,Lars and the Real Girl,11293663,5972884,0.5288703939545566,5320779,0.47112960604544335,2007,2007.csv
3641,Tashan,11283337,457380,0.040535880475784776,10825957,0.9594641195242152,2008,2008.csv
3642,Tomorrow,11277905,62510,0.00554269609470908,11215395,0.994457303905291,2015,2015.csv
3643,Il Divo,11260366,240159,0.021327814744209913,11020207,0.9786721852557901,2008,2008.csv
3644,At Eternity's Gate,11242604,2294915,0.2041266418349343,8947689,0.7958733581650657,2018,2018.csv
3645,You Can Count on Me,11242521,9416804,0.8376060849697323,1825717,0.16239391503026768,2000,2000.csv
3646,Let the Right One In,11227336,2122065,0.18900877287363627,9105271,0.8109912271263637,2008,2008.csv
3647,Stop-Loss,11212953,10915744,0.9734941366471437,297209,0.02650586335285629,2008,2008.csv
3648,Waltz with Bashir,11179372,2283849,0.20429135017602063,8895523,0.7957086498239794,2008,2008.csv
3649,Rudo y Cursi,11169232,1827660,0.16363345304314567,9341572,0.8363665469568543,2008,2008.csv
3650,Straw Dogs,11168712,10324441,0.9244074876315191,844271,0.0755925123684808,2010,2010.csv
3651,Genghis Khan: To the Ends of the Earth and Sea,11167501,3892,0.0003485112739188472,11163609,0.9996514887260811,2007,2007.csv
3652,Ida,11156836,3827060,0.343023774840824,7329776,0.656976225159176,2013,2013.csv
3653,Shadow of the Vampire,11155214,8293784,0.7434894570377583,2861430,0.2565105429622417,2000,2000.csv
3654,Gloria Bell,11145006,5611123,0.5034652291797779,5533883,0.49653477082022207,2019,2019.csv
3655,The Astronaut Farmer,11130889,11003643,0.9885682087028269,127246,0.01143179129717312,2007,2007.csv
3656,Bicycling with Molière,11123929,59874,0.0053824507509891515,11064055,0.9946175492490108,2013,2013.csv
3657,We Are Your Friends,11122090,3591417,0.32290846414657676,7530673,0.6770915358534232,2015,2015.csv
3658,The Nightmare Before Christmas 2006 3D Release,11111265,8700869,0.7830673645170014,2410396,0.21693263548299857,2006,2006.csv
3659,Conviction 2010 Re-release,11104555,6783129,0.6108420373441349,4321426,0.3891579626558651,2010,2010.csv
3660,The Warrior's Way,11103434,5666340,0.510323202713683,5437094,0.489676797286317,2010,2010.csv
3661,The Squid and the Whale,11098131,7372734,0.6643221277528621,3725397,0.33567787224713785,2005,2005.csv
3662,The Belko Experiment,11084630,10166820,0.9171997621932352,917810,0.08280023780676486,2017,2017.csv
3663,Dhamaal,11077541,166339,0.015015877621215755,10911202,0.9849841223787843,2007,2007.csv
3664,Promised Land,11039031,7597898,0.6882758097155448,3441133,0.3117241902844552,2012,2012.csv
3665,Head-On,11030861,435395,0.039470626998200774,10595466,0.9605293730017992,2004,2004.csv
3666,Last Night,11027222,99000,0.008977782436954657,10928222,0.9910222175630453,2010,2010.csv
3667,La boda de Valentina,11021794,2783739,0.2525667781488204,8238055,0.7474332218511796,2018,2018.csv
3668,Kismat Konnection,11019454,490154,0.04448078824958115,10529300,0.9555192117504189,2008,2008.csv
3669,The Loft,11016443,6002684,0.5448840428802655,5013759,0.45511595711973457,2014,2014.csv
3670,Adrenaline Rush: The Science of Risk,11011932,10994028,0.9983741272648614,17904,0.0016258727351385752,2002,2002.csv
3671,Gringo,11001627,4969853,0.4517380020246096,6031774,0.5482619979753903,2018,2018.csv
3672,[REC] 3: Genesis,10998667,9600,0.0008728330442225408,10989067,0.9991271669557774,2012,2012.csv
3673,The Beat That My Heart Skipped,10988397,1023424,0.09313678783174652,9964973,0.9068632121682535,2005,2005.csv
3674,Hyde Park on Hudson,10980481,6376145,0.5806799356057353,4604336,0.41932006439426467,2012,2012.csv
3675,Justin Bieber's Believe,10980157,6206566,0.5652529376401448,4773591,0.43474706235985516,2013,2013.csv
3676,Roving Mars,10978976,10407978,0.9479916888423838,570998,0.05200831115761616,2006,2006.csv
3677,District B13,10976892,1200216,0.10934023947762263,9776676,0.8906597605223774,2004,2004.csv
3678,Friend Request,10975390,3759078,0.3425006309570776,7216312,0.6574993690429224,2016,2016.csv
3679,The Florida Project,10971298,5904366,0.538164764096281,5066932,0.46183523590371894,2017,2017.csv
3680,Extreme Ops,10959475,4842259,0.441833117006061,6117216,0.558166882993939,2002,2002.csv
3681,U Me Aur Hum,10948019,1028191,0.09391571205713106,9919828,0.9060842879428689,2008,2008.csv
3682,Captivity,10921200,2626800,0.24052301944841226,8294400,0.7594769805515877,2007,2007.csv
3683,Black Snake Moan,10907485,9396870,0.8615065709464648,1510615,0.13849342905353526,2007,2007.csv
3684,Jonah Hex,10903312,10547117,0.9673314860658853,356195,0.0326685139341147,2010,2010.csv
3685,One Chance,10900434,101196,0.009283667053990695,10799238,0.9907163329460094,2013,2013.csv
3686,A Bag of Marbles,10898998,411318,0.037739065554466565,10487680,0.9622609344455334,2017,2017.csv
3687,The Perfect Score,10898337,10391003,0.9534484940225284,507334,0.04655150597747161,2004,2004.csv
3688,The Darkness,10898293,10753574,0.9867209479502891,144719,0.013279052049710905,2016,2016.csv
3689,Lucky Numbers,10890222,10042516,0.9221589789445982,847706,0.0778410210554018,2000,2000.csv
3690,Molière,10878867,635733,0.05843742735341833,10243134,0.9415625726465817,2007,2007.csv
3691,Here on Earth,10873148,10522168,0.9677204798463149,350980,0.03227952015368502,2000,2000.csv
3692,Son of Rambow,10871449,1785505,0.1642379962413474,9085944,0.8357620037586526,2008,2008.csv
3693,Steamboy,10870198,468867,0.043133252954545995,10401331,0.956866747045454,2004,2004.csv
3694,Only You,10857889,61565,0.005670070858156682,10796324,0.9943299291418434,2015,2015.csv
3695,The Libertine,10852064,4835065,0.44554335470192585,6016999,0.5544566452980741,2005,2005.csv
3696,Extract,10848783,10823158,0.997637983910269,25625,0.0023620160897309863,2009,2009.csv
3697,I'm Always Here,10836270,1747060,0.16122337298719946,9089210,0.8387766270128005,2004,2004.csv
3698,Danny Collins,10835752,5637066,0.5202284068516887,5198686,0.47977159314831125,2015,2015.csv
3699,Flying Monsters 3D with David Attenborough,10813862,5705874,0.5276444252756324,5107988,0.4723555747243677,2011,2011.csv
3700,Sophie Scholl: The Final Days,10804315,680331,0.06296845288201983,10123984,0.9370315471179802,2005,2005.csv
3701,Carandiru,10781635,216335,0.02006513854345839,10565300,0.9799348614565416,2004,2004.csv
3702,The Great Raid,10769311,10167373,0.9441061735518642,601938,0.05589382644813582,2005,2005.csv
3703,Golden Slumber,10733326,94450,0.008799695453208073,10638876,0.991200304546792,2018,2018.csv
3704,Not Easily Broken,10726909,10572742,0.985628012692193,154167,0.014371987307806937,2009,2009.csv
3705,Our Kind of Traitor,10711027,3153157,0.2943841893032293,7557870,0.7056158106967707,2016,2016.csv
3706,Prom,10702246,10130219,0.9465507520570916,572027,0.05344924794290843,2011,2011.csv
3707,Impractical Jokers: The Movie,10691091,10691091,1.0,0,0.0,2020,2020.csv
3708,City of Life and Death,10687316,122558,0.011467612635389465,10564758,0.9885323873646106,2009,2009.csv
3709,The Sessions,10656155,6002451,0.563284880897472,4653704,0.4367151191025281,2012,2012.csv
3710,The Savages,10653221,6623082,0.6216976067613729,4030139,0.3783023932386271,2007,2007.csv
3711,Red Joan,10647493,1579730,0.14836638070576802,9067763,0.851633619294232,2018,2018.csv
3712,The Night Listener,10639686,7836393,0.7365248372931307,2803293,0.2634751627068694,2006,2006.csv
3713,Only God Forgives,10635126,779188,0.07326551655335348,9855938,0.9267344834466466,2013,2013.csv
3714,The Boondock Saints II: All Saints Day,10629321,10273188,0.9664952258004063,356133,0.033504774199593745,2009,2009.csv
3715,Irina Palm,10610594,44383,0.004182894944430067,10566211,0.99581710505557,2007,2007.csv
3716,My Old Lady,10606667,4013786,0.37842104404710736,6592881,0.6215789559528927,2014,2014.csv
3717,Heartbreaker 2010 Re-release,10606371,504030,0.04752143782260681,10102341,0.9524785621773932,2010,2010.csv
3718,Bad Lieutenant: Port of Call New Orleans,10593928,1702112,0.1606686396207337,8891816,0.8393313603792664,2009,2009.csv
3719,First Daughter,10592180,9055921,0.8549629065971311,1536259,0.1450370934028689,2004,2004.csv
3720,Pollock,10558970,8598593,0.814340129766445,1960377,0.18565987023355499,2000,2000.csv
3721,The Phone,10551318,40516,0.0038398994324690054,10510802,0.996160100567531,2015,2015.csv
3722,Moms' Night Out,10536956,10429707,0.9898216334964292,107249,0.01017836650357086,2014,2014.csv
3723,Get Low,10522511,9176933,0.8721238685329006,1345578,0.12787613146709945,2010,2010.csv
3724,Anatomie,10501958,9660,0.0009198284738902974,10492298,0.9990801715261097,2000,2000.csv
3725,Intimate Strangers,10484574,2110589,0.20130422084864869,8373985,0.7986957791513513,2004,2004.csv
3726,The Leisure Seeker,10472180,3226443,0.308096594978314,7245737,0.691903405021686,2017,2017.csv
3727,The Cooler,10464788,8291572,0.7923306234201782,2173216,0.2076693765798218,2003,2003.csv
3728,Alone in the Dark,10442808,5178569,0.49589813391187504,5264239,0.5041018660881249,2005,2005.csv
3729,Mood Indigo,10435322,303187,0.029053918987837653,10132135,0.9709460810121624,2013,2013.csv
3730,Furious,10433259,9996,0.0009580898931005164,10423263,0.9990419101068995,2017,2017.csv
3731,Every Day,10421847,6102076,0.5855081157879213,4319771,0.4144918842120787,2018,2018.csv
3732,The Perfect Match,10414738,9669521,0.9284459196189093,745217,0.07155408038109072,2016,2016.csv
3733,The Virgin Suicides,10409377,4906229,0.4713278229811448,5503148,0.5286721770188552,2000,2000.csv
3734,Swing Kids,10397408,222001,0.0213515714685814,10175407,0.9786484285314186,2018,2018.csv
3735,Lobster Cop,10373129,85693,0.008261056042010082,10287436,0.9917389439579899,2018,2018.csv
3736,Town & Country,10372291,6719973,0.6478774072189066,3652318,0.35212259278109337,2001,2001.csv
3737,Harry Brown,10371451,1818681,0.1753545381451448,8552770,0.8246454618548552,2009,2009.csv
3738,Queen of Katwe,10367161,8874389,0.8560095671322168,1492772,0.14399043286778318,2016,2016.csv
3739,Wasabi,10366360,97220,0.009378412480369195,10269140,0.9906215875196308,2001,2001.csv
3740,"Where'd You Go, Bernadette",10347840,9198356,0.8889155611219346,1149484,0.11108443887806538,2019,2019.csv
3741,Code Name: The Cleaner,10337477,8135024,0.7869448222230627,2202453,0.21305517777693725,2007,2007.csv
3742,Kin,10313019,5718096,0.5544541321993104,4594923,0.4455458678006896,2018,2018.csv
3743,The Babadook,10312540,964413,0.09351847362531442,9348127,0.9064815263746856,2014,2014.csv
3744,3-D Sex and Zen: Extreme Ecstasy,10306807,153215,0.014865418553000944,10153592,0.9851345814469991,2011,2011.csv
3745,Stone,10300416,1810078,0.17572863076598072,8490338,0.8242713692340193,2010,2010.csv
3746,Saved!,10275509,8940582,0.8700865329396335,1334927,0.12991346706036655,2004,2004.csv
3747,Girls vs Gangsters,10265819,37115,0.0036153959075257416,10228704,0.9963846040924743,2018,2018.csv
3748,Facing the Giants,10243159,10178331,0.9936710930680662,64828,0.006328906931933791,2006,2006.csv
3749,Chennai Express,10234653,5307960,0.5186262787805312,4926693,0.4813737212194688,2013,2013.csv
3750,The Collector,10234475,7712114,0.7535427073689661,2522361,0.24645729263103383,2009,2009.csv
3751,The Miracle Season,10230620,10230620,1.0,0,0.0,2018,2018.csv
3752,The Wash,10229331,10097538,0.9871161662478221,131793,0.012883833752177928,2001,2001.csv
3753,In the Mix,10223896,10223896,1.0,0,0.0,2005,2005.csv
3754,Babies,10219306,7320323,0.7163229088159215,2898983,0.28367709118407847,2010,2010.csv
3755,The Best of Enemies,10209813,10205616,0.9995889248902012,4197,0.0004110751097987789,2019,2019.csv
3756,Senna,10197661,1612430,0.15811763109207103,8585231,0.841882368907929,2010,2010.csv
3757,BTS World Tour: Love Yourself in Seoul,10195760,3509917,0.34425261088923237,6685843,0.6557473891107676,2019,2019.csv
3758,Woman on Top,10194274,5020111,0.492444189748088,5174163,0.507555810251912,2000,2000.csv
3759,Flame & Citron,10186084,148089,0.01453836430172773,10037995,0.9854616356982723,2008,2008.csv
3760,"4 Months, 3 Weeks and 2 Days",10174839,1198208,0.11776186335724821,8976631,0.8822381366427517,2007,2007.csv
3761,For Greater Glory: The True Story of Cristiada,10173682,5672846,0.557600090114867,4500836,0.44239990988513306,2012,2012.csv
3762,Next Day Air,10172519,10027047,0.985699510612858,145472,0.014300489387141966,2009,2009.csv
3763,Punisher: War Zone,10161493,8050977,0.7923025681363949,2110516,0.2076974318636051,2008,2008.csv
3764,The Ice Harvest,10156968,9016782,0.8877434683263745,1140186,0.11225653167362544,2005,2005.csv
3765,Sleepover,10143022,9436390,0.9303331886690179,706632,0.06966681133098203,2004,2004.csv
3766,Let's Talk About the Rain,10134366,111844,0.011036112175147415,10022522,0.9889638878248526,2008,2008.csv
3767,Ben Is Back,10134204,3703184,0.36541439268441805,6431020,0.634585607315582,2018,2018.csv
3768,Thirteen,10128960,4601043,0.4542463392095536,5527917,0.5457536607904464,2003,2003.csv
3769,Trespass,10117966,24094,0.00238130865432835,10093872,0.9976186913456716,2011,2011.csv
3770,Marshall,10116816,10051659,0.9935595349366836,65157,0.006440465063316364,2017,2017.csv
3771,Iron Sky,10109659,122082,0.012075778223578065,9987577,0.9879242217764219,2012,2012.csv
3772,Bernie,10090641,9206470,0.9123771225237326,884171,0.08762287747626736,2012,2012.csv
3773,Pulse: A Stomp Odyssey,10086514,10086514,1.0,0,0.0,2002,2002.csv
3774,A Little Chaos,10084623,558173,0.05534892082728328,9526450,0.9446510791727167,2015,2015.csv
3775,Gladiators of Rome,10079201,8201,0.000813655764975815,10071000,0.9991863442350242,2012,2012.csv
3776,Papillon,10060903,2335896,0.23217558105867833,7725007,0.7678244189413217,2018,2018.csv
3777,A Day Without a Mexican,10057021,4179890,0.4156190983393591,5877131,0.5843809016606408,2004,2004.csv
3778,Sexy Beast,10045677,6946056,0.6914472762761534,3099621,0.30855272372384657,2001,2001.csv
3779,The Deep End,10031529,8823109,0.8795378052538152,1208420,0.12046219474618475,2001,2001.csv
3780,The King's Choice,10017316,113231,0.01130352681297066,9904085,0.9886964731870294,2016,2016.csv
3781,Kissing Jessica Stein,10013424,7025722,0.7016303314430709,2987702,0.2983696685569292,2002,2002.csv
3782,Elephant,10012022,1266955,0.12654336956111362,8745067,0.8734566304388863,2003,2003.csv
3783,Moonlight Mile,10011050,6835856,0.6828310716658093,3175194,0.3171689283341907,2002,2002.csv
3784,Thank You for Your Service,9995692,9536300,0.9540410008631719,459392,0.045958999136828146,2017,2017.csv
3785,Angel-A,9995168,202647,0.02027449663677489,9792521,0.9797255033632251,2005,2005.csv
3786,Alan Partridge,9979601,153426,0.015373961343745106,9826175,0.9846260386562549,2013,2013.csv
3787,Returner,9978256,73060,0.007321920784553934,9905196,0.992678079215446,2002,2002.csv
3788,Taking Woodstock,9975737,7460204,0.7478348717493254,2515533,0.2521651282506746,2009,2009.csv
3789,Kinky Boots,9950133,1822428,0.18315614474700992,8127705,0.8168438552529901,2005,2005.csv
3790,Cyrus,9933873,7468936,0.7518654607321837,2464937,0.24813453926781628,2010,2010.csv
3791,The Goldfinch,9932621,5332621,0.5368795406569927,4600000,0.4631204593430073,2019,2019.csv
3792,The Collection,9929706,6842058,0.6890494038796314,3087648,0.3109505961203685,2012,2012.csv
3793,Portrait of a Lady on Fire,9915428,3759854,0.37919230516322644,6155574,0.6208076948367736,2019,2019.csv
3794,Never Let Me Go,9904795,2434652,0.24580539021756634,7470143,0.7541946097824337,2010,2010.csv
3795,Whatever It Takes,9902115,8745680,0.8832133337170898,1156435,0.11678666628291026,2000,2000.csv
3796,The Princess and the Matchmaker,9899017,78900,0.007970488382836398,9820117,0.9920295116171636,2018,2018.csv
3797,The Dark Knight 2018 Re-release,9891372,375589,0.03797137545731775,9515783,0.9620286245426822,2008,2008.csv
3798,Tsotsi,9891303,2912606,0.29446130605846366,6978697,0.7055386939415363,2005,2005.csv
3799,Star Wars: Episode V - The Empire Strikes Back 2020 Re-release,9881670,611000,0.061831653961324354,9270670,0.9381683460386756,2020,2020.csv
3800,Arctic Dogs,9870905,5801249,0.5877119676463303,4069656,0.4122880323536697,2019,2019.csv
3801,Mostly Martha,9852022,4160475,0.4222965600361022,5691547,0.5777034399638977,2002,2002.csv
3802,Simmba,9846453,5102129,0.5181692331238468,4744324,0.4818307668761533,2018,2018.csv
3803,Mondays in the Sun,9832663,153256,0.015586418450423857,9679407,0.9844135815495761,2002,2002.csv
3804,3 Strikes,9832166,9832166,1.0,0,0.0,2000,2000.csv
3805,The Express,9808124,9793406,0.9984994072260913,14718,0.0015005927739086496,2008,2008.csv
3806,Ghost in the Shell 2: Innocence,9789651,1043896,0.10663260620833163,8745755,0.8933673937916684,2004,2004.csv
3807,Moon,9760107,5010163,0.5133307452469528,4749944,0.4866692547530473,2009,2009.csv
3808,Young & Beautiful,9757417,61067,0.0062585210819625725,9696350,0.9937414789180374,2013,2013.csv
3809,Tamjung Hong Gil-dong: Sarajin Ma-eul,9754195,67054,0.006874375589169583,9687141,0.9931256244108304,2016,2016.csv
3810,Maudie,9733932,6170998,0.6339676504828675,3562934,0.3660323495171324,2017,2017.csv
3811,My Life Without Me,9726954,400948,0.041220303910144945,9326006,0.958779696089855,2003,2003.csv
3812,Bread and Tulips,9719848,5318679,0.547197754532787,4401169,0.4528022454672131,2000,2000.csv
3813,Popstar: Never Stop Never Stopping,9680029,9639125,0.9957743928246496,40904,0.0042256071753504045,2016,2016.csv
3814,I Know Who Killed Me,9669758,7498716,0.7754812478244026,2171042,0.22451875217559736,2007,2007.csv
3815,Tod@s Caen,9667157,2670925,0.2762885717072765,6996232,0.7237114282927235,2019,2019.csv
3816,In Darkness,9661759,1041455,0.10779144874137307,8620304,0.892208551258627,2012,2012.csv
3817,Overdrive,9650552,7793,0.0008075185751032687,9642759,0.9991924814248967,2017,2017.csv
3818,The Young Black Stallion,9638389,6751389,0.7004686156576582,2887000,0.29953138434234183,2003,2003.csv
3819,On the Road,9617377,744296,0.07739074801788472,8873081,0.9226092519821153,2012,2012.csv
3820,Private,9595697,15811,0.0016477177218080145,9579886,0.998352282278192,2005,2005.csv
3821,Paterson,9588282,2152738,0.22451759345417668,7435544,0.7754824065458233,2016,2016.csv
3822,Hysteria,9584256,1804139,0.1882398592024253,7780117,0.8117601407975746,2011,2011.csv
3823,I Could Never Be Your Woman,9576495,0,0.0,9576495,1.0,2007,2007.csv
3824,The Man Without a Past,9564237,921847,0.0963847926394965,8642390,0.9036152073605035,2002,2002.csv
3825,God of War,9559524,53000,0.005544209104972172,9506524,0.9944557908950278,2017,2017.csv
3826,Mid-August Lunch,9520933,675299,0.07092781768341401,8845634,0.929072182316586,2008,2008.csv
3827,Traffik,9515914,9186156,0.9653466813592473,329758,0.034653318640752745,2018,2018.csv
3828,The Young and Prodigious T.S. Spivet,9494789,173564,0.01827992175497528,9321225,0.9817200782450247,2013,2013.csv
3829,The Square,9493791,1502347,0.15824521521487042,7991444,0.8417547847851296,2017,2017.csv
3830,Point Blank,9487445,708215,0.07464760006513872,8779230,0.9253523999348613,2010,2010.csv
3831,Our Time Will Come,9484714,114560,0.012078382120957996,9370154,0.987921617879042,2017,2017.csv
3832,The Mayor 2017 Re-release,9476194,96777,0.010212644443539252,9379417,0.9897873555564608,2017,2017.csv
3833,Official Secrets,9473603,1988546,0.20990387712045777,7485057,0.7900961228795422,2019,2019.csv
3834,Promare,9465371,2313596,0.24442739751035644,7151775,0.7555726024896435,2019,2019.csv
3835,Peepli [Live],9460931,757951,0.08011378584200646,8702980,0.9198862141579935,2010,2010.csv
3836,All the King's Men,9451623,7221458,0.7640442281711829,2230165,0.23595577182881713,2006,2006.csv
3837,Superbabies: Baby Geniuses 2,9448644,9219388,0.9757366242182476,229256,0.024263375781752385,2004,2004.csv
3838,Goya's Ghosts,9448082,1000626,0.10590784457628544,8447456,0.8940921554237146,2006,2006.csv
3839,Veronica Guerin,9439660,1571504,0.1664788774171951,7868156,0.8335211225828049,2003,2003.csv
3840,The Big Bad Fox and Other Tales 2017 Re-release,9422127,35787,0.0037981869698848255,9386340,0.9962018130301151,2017,2017.csv
3841,Ghost Dog: The Way of the Samurai,9380473,3308029,0.3526505539752633,6072444,0.6473494460247367,2000,2000.csv
3842,Running Scared,9380029,6855137,0.7308225806124906,2524892,0.26917741938750933,2006,2006.csv
3843,Bel Ami,9374932,120462,0.01284937320078695,9254470,0.9871506267992131,2012,2012.csv
3844,Chéri,9368242,2715657,0.2898790402724439,6652585,0.7101209597275562,2009,2009.csv
3845,You Were Never Really Here,9360514,2528078,0.2700789721590075,6832436,0.7299210278409924,2017,2017.csv
3846,Journey of a Woman,9354562,675102,0.0721682105479658,8679460,0.9278317894520342,2007,2007.csv
3847,Martian Child,9351744,7500310,0.8020225959992061,1851434,0.19797740400079386,2007,2007.csv
3848,Jexi,9341662,6546159,0.7007488603205725,2795503,0.2992511396794275,2019,2019.csv
3849,Miracle at St. Anna,9333654,7919117,0.8484476711907255,1414537,0.1515523288092745,2008,2008.csv
3850,Saving Private Perez,9330465,1400726,0.15012392201246133,7929739,0.8498760779875387,2011,2011.csv
3851,Replicas,9330075,4046429,0.4336973711358162,5283646,0.5663026288641838,2018,2018.csv
3852,Seraphine,9329376,884613,0.09482016803696196,8444763,0.9051798319630381,2008,2008.csv
3853,The Story of the Weeping Camel,9328652,1763052,0.18899322217186362,7565600,0.8110067778281363,2004,2004.csv
3854,MacGruber,9322895,8525600,0.9144798906348296,797295,0.08552010936517036,2010,2010.csv
3855,Peeples,9307166,9177065,0.9860214161861945,130101,0.013978583813805406,2013,2013.csv
3856,Mad Love,9306362,280046,0.030091887678557958,9026316,0.969908112321442,2001,2001.csv
3857,Secretary,9304609,4059680,0.4363085004431675,5244929,0.5636914995568325,2002,2002.csv
3858,Mid90s,9303022,7362439,0.7914029441185886,1940583,0.20859705588141145,2018,2018.csv
3859,Shootout at Lokhandwala,9291694,289232,0.03112801605390793,9002462,0.9688719839460921,2007,2007.csv
3860,Hello Greetings,9289939,1413283,0.15213049299893142,7876656,0.8478695070010686,2005,2005.csv
3861,The Page Turner,9284027,209659,0.02258276500057572,9074368,0.9774172349994242,2006,2006.csv
3862,Jerusalem,9279456,8020721,0.8643525008362559,1258735,0.13564749916374408,2013,2013.csv
3863,Le Chef,9245235,342667,0.03706417413943507,8902568,0.9629358258605649,2012,2012.csv
3864,We Need to Talk About Kevin,9232318,1738692,0.1883267019181965,7493626,0.8116732980818036,2011,2011.csv
3865,The Aftermath,9215591,1618497,0.17562595822666174,7597094,0.8243740417733383,2019,2019.csv
3866,State and Main,9206279,6944471,0.7543189816428548,2261808,0.24568101835714515,2000,2000.csv
3867,Tulip Fever,9204549,2455635,0.2667849342754327,6748914,0.7332150657245673,2017,2017.csv
3868,My Cousin Rachel,9200168,2716368,0.2952519997460916,6483800,0.7047480002539084,2017,2017.csv
3869,Away from Her,9194283,4571521,0.49721343143342445,4622762,0.5027865685665756,2007,2007.csv
3870,Less Sugar,9178465,697369,0.07597882652491457,8481096,0.9240211734750854,2007,2007.csv
3871,A Hologram for the King,9169507,4212494,0.4594024520620356,4957013,0.5405975479379644,2016,2016.csv
3872,Unfinished Song,9166865,1702668,0.18574158122760617,7464197,0.8142584187723938,2013,2013.csv
3873,The Raid: Redemption,9148519,4105187,0.4487269469517416,5043332,0.5512730530482585,2012,2012.csv
3874,The Personal History of David Copperfield,9132289,0,0.0,9132289,1.0,2020,2020.csv
3875,Ruby Sparks,9128263,2540106,0.2782682751362444,6588157,0.7217317248637556,2012,2012.csv
3876,My Piece of the Pie,9123187,6850,0.0007508341109307526,9116337,0.9992491658890692,2011,2011.csv
3877,Searching for Sugar Man,9122406,3696196,0.40517775683301094,5426210,0.5948222431669891,2012,2012.csv
3878,City Of Rock,9118873,312537,0.034273643245168565,8806336,0.9657263567548314,2017,2017.csv
3879,Human Capital,9113941,158549,0.017396316258795178,8955392,0.9826036837412048,2014,2014.csv
3880,Miss Sloane,9101546,3500605,0.3846165255880704,5600941,0.6153834744119295,2016,2016.csv
3881,Meet the Blacks,9097072,9097072,1.0,0,0.0,2016,2016.csv
3882,Tolkien,9090040,4535154,0.4989146362392245,4554886,0.5010853637607755,2019,2019.csv
3883,Mad Hot Ballroom,9079042,8117961,0.8941429062669828,961081,0.1058570937330172,2005,2005.csv
3884,Twice Born,9075131,18295,0.002015948860683113,9056836,0.9979840511393169,2012,2012.csv
3885,Me and Earl and the Dying Girl,9074749,6758416,0.7447496343976016,2316333,0.2552503656023985,2015,2015.csv
3886,Monsieur Lazhar,9074711,2009517,0.22144143212935377,7065194,0.7785585678706463,2012,2012.csv
3887,The Fifth Estate,9058564,3255008,0.3593293594878835,5803556,0.6406706405121165,2013,2013.csv
3888,El Crimen Perfecto (The Perfect Crime),9040997,418843,0.04632708096242041,8622154,0.9536729190375796,2004,2004.csv
3889,Incarnate,9037058,4799774,0.5311213007596056,4237284,0.4688786992403944,2016,2016.csv
3890,Like Crazy,9029150,107362,0.011890598782831163,8921788,0.9881094012171688,2016,2016.csv
3891,Truman,9027600,210840,0.02335504453010767,8816760,0.9766449554698924,2015,2015.csv
3892,"Two Days, One Night",9016922,1436243,0.15928306799149422,7580679,0.8407169320085058,2014,2014.csv
3893,Frances Ha,9013161,4069826,0.45154258311817574,4943335,0.5484574168818243,2013,2013.csv
3894,Comedy of Power,8987781,80550,0.00896216763626083,8907231,0.9910378323637392,2006,2006.csv
3895,Breaking and Entering,8974829,930469,0.10367540150347154,8044360,0.8963245984965285,2006,2006.csv
3896,Champion,8974547,97472,0.010860938162115592,8877075,0.9891390618378844,2018,2018.csv
3897,The Lobster 2016 Re-release,8952351,8700374,0.9718535388078506,251977,0.028146461192149416,2016,2016.csv
3898,Ong Bak 2,8936663,102458,0.011464905860274691,8834205,0.9885350941397253,2008,2008.csv
3899,Kandahar,8914751,1418314,0.15909743300738294,7496437,0.8409025669926171,2001,2001.csv
3900,Downhill,8899195,8287061,0.9312146772826081,612134,0.06878532271739185,2020,2020.csv
3901,Cadillac Records,8883644,8195551,0.9225438344895406,688093,0.07745616551045945,2008,2008.csv
3902,Hannah Arendt,8880936,717205,0.08075781651843905,8163731,0.919242183481561,2013,2013.csv
3903,Bluebeard,8855737,43144,0.0048718700656986535,8812593,0.9951281299343013,2017,2017.csv
3904,Après Vous,8852763,830292,0.09378902383357603,8022471,0.906210976166424,2003,2003.csv
3905,Rang De Basanti,8846694,2197694,0.24841980518372173,6649000,0.7515801948162782,2006,2006.csv
3906,All Together,8835903,43180,0.004886880265661585,8792723,0.9951131197343385,2012,2012.csv
3907,Morgan,8809407,3915251,0.4444397903286793,4894156,0.5555602096713207,2016,2016.csv
3908,The Rocker,8808935,6409528,0.727616675568613,2399407,0.272383324431387,2008,2008.csv
3909,Dolphins and Whales 3D: Tribes of the Ocean,8808659,7714996,0.8758422820091004,1093663,0.12415771799089964,2008,2008.csv
3910,Captive State,8808611,5958315,0.6764193582847511,2850296,0.32358064171524886,2019,2019.csv
3911,18 ans après,8785730,25611,0.0029150679567890203,8760119,0.997084932043211,2003,2003.csv
3912,The Traitor,8779418,296027,0.033718294310625146,8483391,0.9662817056893749,2019,2019.csv
3913,Son of the Bride,8772695,624757,0.07121608582083384,8147938,0.9287839141791662,2001,2001.csv
3914,7 Days in Entebbe,8771432,3326885,0.379286415262639,5444547,0.620713584737361,2018,2018.csv
3915,Sorry We Missed You,8766149,28273,0.0032252474832449233,8737876,0.9967747525167551,2019,2019.csv
3916,Ghost World,8764007,6217849,0.7094755857680168,2546158,0.29052441423198316,2001,2001.csv
3917,Marguerite,8754356,506677,0.0578771299682124,8247679,0.9421228700317876,2015,2015.csv
3918,La folle histoire de Max et Léon,8750678,543,6.205233468766649e-05,8750135,0.9999379476653123,2016,2016.csv
3919,Big Stan,8742330,0,0.0,8742330,1.0,2008,2008.csv
3920,The Villainess,8737458,27741,0.003174950883884077,8709717,0.9968250491161159,2017,2017.csv
3921,Delta Farce,8729473,8130530,0.9313884125651113,598943,0.06861158743488868,2007,2007.csv
3922,Code Geass: Lelouch of the Re;Surrection 2019 Re-release,8715612,522805,0.05998488689032967,8192807,0.9400151131096703,2019,2019.csv
3923,Infernal Affairs,8708932,169659,0.019481033954565265,8539273,0.9805189660454348,2002,2002.csv
3924,The Royal Guard,8707875,1290212,0.14816611400600033,7417663,0.8518338859939997,2007,2007.csv
3925,The Forsaken,8704851,7288451,0.8372861293088187,1416400,0.16271387069118126,2001,2001.csv
3926,The Station Agent,8679814,5739376,0.661232602449776,2940438,0.338767397550224,2003,2003.csv
3927,Mardaani 2,8677988,0,0.0,8677988,1.0,2019,2019.csv
3928,Corpus Christi,8662587,127240,0.01468845276820885,8535347,0.9853115472317912,2019,2019.csv
3929,How She Move,8659212,7070641,0.8165455471005907,1588571,0.18345445289940931,2008,2008.csv
3930,Fashion,8658713,191442,0.022109752338482638,8467271,0.9778902476615173,2008,2008.csv
3931,Le Week-end,8652213,2225098,0.257170968860799,6427115,0.7428290311392011,2013,2013.csv
3932,The Condemned,8642858,7371706,0.8529245765694635,1271152,0.1470754234305365,2007,2007.csv
3933,Pope Francis: A Man of His Word,8608385,2008385,0.23330566651003642,6600000,0.7666943334899635,2018,2018.csv
3934,Things We Lost in the Fire,8591255,3287315,0.38263501665356225,5303940,0.6173649833464377,2007,2007.csv
3935,Love Me If You Dare,8561371,553504,0.06465132745678233,8007867,0.9353486725432176,2003,2003.csv
3936,Willard,8546666,6886089,0.8057047040331282,1660577,0.19429529596687176,2003,2003.csv
3937,Space Dogs,8530226,14408,0.0016890525526521807,8515818,0.9983109474473478,2010,2010.csv
3938,Our Brand Is Crisis,8527658,7002261,0.8211235722633342,1525397,0.1788764277366658,2015,2015.csv
3939,Before Night Falls,8527517,4242892,0.49755303917893096,4284625,0.502446960821069,2000,2000.csv
3940,What If,8526288,3493000,0.40967417474052015,5033288,0.5903258252594799,2014,2014.csv
3941,Stronger,8503658,4211129,0.495213824450607,4292529,0.504786175549393,2017,2017.csv
3942,Big Trouble,8493890,7267307,0.8555923140045374,1226583,0.1444076859954626,2002,2002.csv
3943,Piranha 3DD,8493728,376512,0.044328238436644074,8117216,0.9556717615633559,2012,2012.csv
3944,La mujer de mi hermano,8492178,2808241,0.3306856026804902,5683937,0.6693143973195098,2005,2005.csv
3945,A Girl Cut in Two,8488537,409658,0.048260141883106594,8078879,0.9517398581168934,2007,2007.csv
3946,Star Wars: Episode II - Attack of the Clones 2002 IMAX Release,8485488,8485488,1.0,0,0.0,2002,2002.csv
3947,Stay,8483797,3626883,0.4275070466679012,4856914,0.5724929533320988,2005,2005.csv
3948,Amityville: The Awakening,8481997,742,8.747939901417083e-05,8481255,0.9999125206009858,2017,2017.csv
3949,A-X-L,8467697,6501381,0.767786211528353,1966316,0.232213788471647,2018,2018.csv
3950,Lucky You,8461686,5758950,0.6805913147805296,2702736,0.31940868521947047,2007,2007.csv
3951,The Outrage,8457741,44745,0.005290419746833109,8412996,0.9947095802531669,2010,2010.csv
3952,Beyond the Sea,8447615,6318709,0.7479873313355307,2128906,0.2520126686644692,2004,2004.csv
3953,Casa de mi Padre,8446952,5909483,0.6995994531518588,2537469,0.3004005468481412,2012,2012.csv
3954,A Street Cat Named Bob,8446262,82703,0.009791668787920621,8363559,0.9902083312120794,2016,2016.csv
3955,Princesas,8446185,29472,0.003489386036417625,8416713,0.9965106139635824,2005,2005.csv
3956,Then She Found Me,8443998,3735717,0.442410929040959,4708281,0.557589070959041,2008,2008.csv
3957,The Way 2010 Re-release,8437872,4430765,0.5251045524274367,4007107,0.4748954475725633,2010,2010.csv
3958,Condorito: The Movie,8431194,447719,0.053102680355830975,7983475,0.946897319644169,2017,2017.csv
3959,Raees,8428190,3262954,0.38714765566509535,5165236,0.6128523443349047,2017,2017.csv
3960,Amen.,8419052,274299,0.032580746620878454,8144753,0.9674192533791215,2002,2002.csv
3961,Death Defying Acts,8394639,5665,0.000674835451530435,8388974,0.9993251645484695,2008,2008.csv
3962,Malang,8394609,0,0.0,8394609,1.0,2020,2020.csv
3963,Go for Zucker,8394115,87490,0.01042277833934846,8306625,0.9895772216606515,2005,2005.csv
3964,Death to Smoochy,8382938,8364691,0.997823316837128,18247,0.0021766831628720145,2002,2002.csv
3965,Bones,8378853,7316658,0.8732290684655764,1062195,0.12677093153442362,2001,2001.csv
3966,Filth,8377987,34411,0.004107311219270214,8343576,0.9958926887807298,2013,2013.csv
3967,The Hunt,8377244,5812500,0.6938439419933333,2564744,0.3061560580066666,2020,2020.csv
3968,Easy Money,8369756,205741,0.024581481228365558,8164015,0.9754185187716344,2010,2010.csv
3969,The Love Punch,8366493,266588,0.031863768965084895,8099905,0.9681362310349151,2014,2014.csv
3970,Venus in Fur,8350026,373605,0.04474297445301368,7976421,0.9552570255469863,2013,2013.csv
3971,I Am Not Your Negro,8345298,7123919,0.8536446511556568,1221379,0.14635534884434326,2017,2017.csv
3972,Bordertown,8329799,0,0.0,8329799,1.0,2007,2007.csv
3973,Time Renegades,8312361,59425,0.007148991724493198,8252936,0.9928510082755068,2016,2016.csv
3974,London Boulevard,8307227,16075,0.0019350620850977108,8291152,0.9980649379149023,2010,2010.csv
3975,The Office,8290521,63675,0.007680458200395367,8226846,0.9923195417996047,2015,2015.csv
3976,Redline,8267379,6881022,0.8323099739349074,1386357,0.1676900260650927,2007,2007.csv
3977,My Worst Nightmare,8226544,21952,0.0026684352505742387,8204592,0.9973315647494257,2011,2011.csv
3978,Hoot,8224998,8117637,0.9869469877074742,107361,0.013053012292525786,2006,2006.csv
3979,It Runs in the Family,8211508,7491839,0.912358485189322,719669,0.08764151481067789,2003,2003.csv
3980,The Machinist,8203235,1082715,0.13198634441168636,7120520,0.8680136555883137,2004,2004.csv
3981,Santa vs. the Snowman 3D,8198286,1934053,0.23590943277655843,6264233,0.7640905672234416,2002,2002.csv
3982,Cave of Forgotten Dreams,8183347,5304920,0.6482579805060203,2878427,0.35174201949397965,2011,2011.csv
3983,The Big Year,8179416,7204138,0.880764347968119,975278,0.11923565203188101,2011,2011.csv
3984,This Is England,8176544,329379,0.0402834009087458,7847165,0.9597165990912542,2007,2007.csv
3985,Water 2006 Re-release,8172058,3278815,0.4012226785468238,4893243,0.5987773214531762,2006,2006.csv
3986,Control,8159508,872252,0.1069000728965521,7287256,0.8930999271034479,2007,2007.csv
3987,The Edukators,8152859,175493,0.02152533240179917,7977366,0.9784746675982008,2004,2004.csv
3988,Impostor,8145549,6285176,0.7716086417256836,1860373,0.22839135827431645,2002,2002.csv
3989,Mangal Pandey: The Rising,8142076,954108,0.11718239918173202,7187968,0.882817600818268,2005,2005.csv
3990,Walk of Shame,8122990,59209,0.0072890647409389895,8063781,0.992710935259061,2014,2014.csv
3991,Spartan,8112712,4434432,0.5466029115787667,3678280,0.4533970884212332,2004,2004.csv
3992,Ernest & Celestine,8111137,262075,0.03231051331027943,7849062,0.9676894866897205,2012,2012.csv
3993,The New Year's Eve of Old Lee,8099301,25358,0.0031308874679432212,8073943,0.9968691125320568,2016,2016.csv
3994,The Man Who Invented Christmas,8096007,5676486,0.7011463799376656,2419521,0.29885362006233446,2017,2017.csv
3995,"New York, I Love You",8095596,1588015,0.19615788633721346,6507581,0.8038421136627866,2009,2009.csv
3996,The Company Men,8087000,4441272,0.5491865957709905,3645728,0.4508134042290095,2011,2011.csv
3997,Bug,8059140,7025810,0.8717816044888165,1033330,0.12821839551118358,2007,2007.csv
3998,The Hidden Blade,8043781,38147,0.004742421505508417,8005634,0.9952575784944916,2004,2004.csv
3999,Heroine,8036853,598668,0.07449035088734358,7438185,0.9255096491126564,2012,2012.csv
4000,Billu,8034797,754928,0.09395732088813195,7279869,0.9060426791118681,2009,2009.csv
4001,Counter Investigation,8029345,11846,0.001475338274790783,8017499,0.9985246617252093,2007,2007.csv
4002,Me and You and Everyone We Know,8012838,3885134,0.48486366503353745,4127704,0.5151363349664626,2005,2005.csv
4003,My King,8003331,54114,0.0067614347076236135,7949217,0.9932385652923764,2015,2015.csv
4004,Disobedience,8003180,3498782,0.4371739733455951,4504398,0.5628260266544048,2018,2018.csv
4005,Life Itself,7997774,4102648,0.5129737349417476,3895126,0.48702626505825247,2018,2018.csv
4006,Denial,7994527,4073489,0.5095347104337755,3921038,0.4904652895662245,2016,2016.csv
4007,American Splendor,7986084,6010990,0.7526830421518231,1975094,0.2473169578481769,2003,2003.csv
4008,Metallica Through the Never,7975812,3419967,0.42879232860553884,4555845,0.5712076713944612,2013,2013.csv
4009,Merci pour le Chocolat,7972251,443238,0.05559759721564211,7529013,0.9444024027843579,2002,2002.csv
4010,Silk,7965682,1103075,0.1384784127711852,6862607,0.8615215872288148,2007,2007.csv
4011,My Mom's New Boyfriend,7963718,0,0.0,7963718,1.0,2008,2008.csv
4012,Fanfan,7949963,32686,0.0041114656760037754,7917277,0.9958885343239963,2003,2003.csv
4013,Chasing Mavericks,7942116,6002756,0.7558131863095428,1939360,0.2441868136904573,2012,2012.csv
4014,Suspiria,7942093,2483472,0.3126974211961507,5458621,0.6873025788038493,2018,2018.csv
4015,Funny Games,7938872,1294919,0.16311120773832857,6643953,0.8368887922616715,2008,2008.csv
4016,Coffee and Cigarettes,7929307,2198924,0.2773160378328144,5730383,0.7226839621671856,2004,2004.csv
4017,El cantante,7911532,7556712,0.955151543342048,354820,0.04484845665795196,2007,2007.csv
4018,The Ark of Mr Chow,7894075,54075,0.006850074264559179,7840000,0.9931499257354408,2015,2015.csv
4019,Gardener,7885479,1058803,0.13427250265963553,6826676,0.8657274973403645,2003,2003.csv
4020,Pavarotti,7885016,4600249,0.5834165713804512,3284767,0.4165834286195488,2019,2019.csv
4021,The Battle of Jangsari,7883200,70853,0.008987847574589,7812347,0.991012152425411,2019,2019.csv
4022,City Island,7878856,6671036,0.8467010946766891,1207820,0.1532989053233109,2009,2009.csv
4023,Inside Job,7871522,4312735,0.5478908653243935,3558787,0.4521091346756066,2010,2010.csv
4024,Goal II: Living the Dream,7864905,225067,0.028616620289755566,7639838,0.9713833797102445,2007,2007.csv
4025,For a Few Bullets,7860447,30142,0.0038346419739233657,7830305,0.9961653580260766,2016,2016.csv
4026,Salut d'Amour,7858183,22480,0.0028607122028082065,7835703,0.9971392877971917,2015,2015.csv
4027,Pele: Birth of a Legend,7846608,57046,0.007270147814189265,7789562,0.9927298521858108,2016,2016.csv
4028,Summer Hours,7835857,1657001,0.21146391517864607,6178856,0.788536084821354,2008,2008.csv
4029,The Lady,7832142,355391,0.04537596483822689,7476751,0.9546240351617731,2011,2011.csv
4030,Batman Begins 2012 Re-release,7826402,1508658,0.19276520679617531,6317744,0.8072347932038247,2005,2005.csv
4031,Renoir,7816573,2293798,0.2934531539589024,5522775,0.7065468460410975,2013,2013.csv
4032,Dongju: The Portrait of a Poet,7809531,56550,0.007241151869427242,7752981,0.9927588481305728,2016,2016.csv
4033,Tupac: Resurrection,7808524,7718961,0.9885300986460437,89563,0.011469901353956266,2003,2003.csv
4034,Qué León,7807916,2607916,0.33400922858288945,5200000,0.6659907714171105,2018,2018.csv
4035,Bad Words,7804337,7779614,0.9968321460234226,24723,0.0031678539765773828,2014,2014.csv
4036,Amazing Grace,7796112,4450456,0.5708558317274046,3345656,0.4291441682725954,2018,2018.csv
4037,In the Loop,7787487,2388804,0.30674901929210285,5398683,0.6932509807078971,2009,2009.csv
4038,The Children of Huang Shi,7785317,1031872,0.13254078157639568,6753445,0.8674592184236043,2008,2008.csv
4039,Real Women Have Curves,7777790,5853194,0.7525523317034788,1924596,0.24744766829652126,2002,2002.csv
4040,P2,7766240,3995018,0.5144082593378521,3771222,0.48559174066214794,2007,2007.csv
4041,By the Grace of God,7755652,67059,0.00864646840781407,7688593,0.991353531592186,2019,2019.csv
4042,3 idiotas,7738470,1249233,0.16143152328561072,6489237,0.8385684767143893,2017,2017.csv
4043,Certified Copy,7736632,1373975,0.17759342825146654,6362657,0.8224065717485335,2010,2010.csv
4044,Butterfly,7733894,2092682,0.27058581356299943,5641212,0.7294141864370005,2000,2000.csv
4045,Love Live! Sunshine!! The School Idol Movie: Over The Rainbow,7733048,34135,0.004414171488396296,7698913,0.9955858285116037,2019,2019.csv
4046,Explosion,7731410,122700,0.015870326369963564,7608710,0.9841296736300365,2017,2017.csv
4047,Cedar Rapids,7728936,6861102,0.8877162393374716,867834,0.11228376066252845,2011,2011.csv
4048,Mia madre,7723656,303002,0.03923038519581918,7420654,0.9607696148041808,2015,2015.csv
4049,Expelled: No Intelligence Allowed,7720487,7720487,1.0,0,0.0,2008,2008.csv
4050,Summer in Berlin,7718317,8340,0.0010805464455528324,7709977,0.9989194535544472,2006,2006.csv
4051,The Sweeney,7708312,26650,0.0034573068656276497,7681662,0.9965426931343724,2012,2012.csv
4052,Kevin Hart: Laugh at My Pain,7706436,7706436,1.0,0,0.0,2011,2011.csv
4053,BPM (Beats Per Minute),7704369,125189,0.01624909191135575,7579180,0.9837509080886443,2017,2017.csv
4054,Penguins,7699452,7699452,1.0,0,0.0,2019,2019.csv
4055,No,7699095,2343664,0.30440772584310233,5355431,0.6955922741568976,2012,2012.csv
4056,Declaration of War,7691610,59100,0.007683696911309856,7632510,0.9923163030886901,2011,2011.csv
4057,Finding Fanny,7685784,615691,0.08010776779571219,7070093,0.9198922322042878,2014,2014.csv
4058,Leave No Trace,7682928,6046104,0.7869530991309563,1636824,0.21304690086904368,2018,2018.csv
4059,Lolo,7663798,24134,0.0031490913513117125,7639664,0.9968509086486883,2015,2015.csv
4060,Steal,7662206,220944,0.02883555988967146,7441262,0.9711644401103285,2002,2002.csv
4061,A Scanner Darkly,7659918,5501616,0.7182343205240578,2158302,0.28176567947594217,2006,2006.csv
4062,The Hunting Party,7644409,969869,0.1268729865186439,6674540,0.8731270134813561,2007,2007.csv
4063,Sex and Lucía,7640680,1594779,0.2087221294439762,6045901,0.7912778705560238,2001,2001.csv
4064,Pandas,7635778,7574012,0.9919109748869074,61766,0.008089025113092601,2018,2018.csv
4065,Just Getting Started,7634022,6069605,0.7950730296559271,1564417,0.2049269703440729,2017,2017.csv
4066,Thoda Pyaar Thoda Magic,7631012,365401,0.04788368829717474,7265611,0.9521163117028253,2008,2008.csv
4067,The White Crow,7622595,1828784,0.23991619651837728,5793811,0.7600838034816227,2019,2019.csv
4068,Monkeybone,7622365,5411999,0.7100157234664044,2210366,0.28998427653359554,2001,2001.csv
4069,Fullmetal Alchemist: The Sacred Star of Milos,7621364,177802,0.023329419773153465,7443562,0.9766705802268465,2011,2011.csv
4070,Only Lovers Left Alive,7609187,1879534,0.24700851746710917,5729653,0.7529914825328908,2013,2013.csv
4071,Kidnap,7601003,0,0.0,7601003,1.0,2008,2008.csv
4072,The Flower of Evil,7587959,182163,0.024006850854096602,7405796,0.9759931491459034,2003,2003.csv
4073,Man on the Train,7585989,2542020,0.33509407936130675,5043969,0.6649059206386932,2002,2002.csv
4074,Klovn Forever,7585569,5700,0.0007514268211125625,7579869,0.9992485731788875,2015,2015.csv
4075,Burning,7576345,718991,0.0948994534963759,6857354,0.9051005465036241,2018,2018.csv
4076,Miss You Already,7573997,1162653,0.15350587015019942,6411344,0.8464941298498005,2015,2015.csv
4077,Club Dread,7565807,5001708,0.6610937868227408,2564099,0.3389062131772592,2004,2004.csv
4078,Partir,7556034,176113,0.023307597610068984,7379921,0.976692402389931,2009,2009.csv
4079,Hippocrates: Diary of a French Doctor,7555591,23050,0.003050720982647155,7532541,0.9969492790173529,2014,2014.csv
4080,"Kiki, Love to Love",7551282,12450,0.001648726666544833,7538832,0.9983512733334552,2016,2016.csv
4081,The Advocate: A Missing Body,7550177,50162,0.006643817754206292,7500015,0.9933561822457937,2015,2015.csv
4082,Take Me Home Tonight,7550073,6928068,0.9176160283483352,622005,0.08238397165166482,2011,2011.csv
4083,A Bigger Splash,7545758,2024099,0.2682432964322471,5521659,0.7317567035677529,2015,2015.csv
4084,12,7537453,125120,0.016599771832739786,7412333,0.9834002281672602,2007,2007.csv
4085,Albert Nobbs,7532259,3014696,0.4002379631396106,4517563,0.5997620368603894,2011,2011.csv
4086,Nothing Like the Holidays,7519490,7503736,0.9979049111043435,15754,0.0020950888956564875,2008,2008.csv
4087,DOA: Dead or Alive,7516532,480813,0.06396739879508262,7035719,0.9360326012049174,2006,2006.csv
4088,Beirut,7509436,5019226,0.6683892105878524,2490210,0.3316107894121476,2018,2018.csv
4089,Where Do We Go Now?,7507008,531997,0.07086671547439406,6975011,0.929133284525606,2011,2011.csv
4090,The Whistleblower,7505141,280851,0.037421149049698066,7224290,0.9625788509503019,2019,2019.csv
4091,The Girl from Monaco 2008 Re-release,7501546,602992,0.08038236384873199,6898554,0.919617636151268,2008,2008.csv
4092,Open Season 3,7487555,0,0.0,7487555,1.0,2010,2010.csv
4093,Cash,7481601,0,0.0,7481601,1.0,2007,2007.csv
4094,Frantz,7478354,880883,0.11779102727685799,6597471,0.882208972723142,2016,2016.csv
4095,The Tall Man,7462847,0,0.0,7462847,1.0,2012,2012.csv
4096,Running with Scissors,7460797,7022827,0.9412971563225752,437970,0.05870284367742481,2006,2006.csv
4097,Spellbound,7457710,5728581,0.7681420972389648,1729129,0.2318579027610352,2003,2003.csv
4098,Big Game,7455398,24752,0.0033200105480619547,7430646,0.996679989451938,2015,2015.csv
4099,Black Nativity,7454185,7018189,0.941509903497163,435996,0.058490096502837,2013,2013.csv
4100,I'll See You in My Dreams,7452512,7449681,0.999620128085671,2831,0.00037987191432902086,2015,2015.csv
4101,Yu-Gi-Oh!: The Dark Side of Dimensions,7445186,1015339,0.13637523629362652,6429847,0.8636247637063735,2016,2016.csv
4102,Five Times Two,7444906,128752,0.017293972549821315,7316154,0.9827060274501787,2004,2004.csv
4103,Brittany Runs a Marathon,7442106,7189808,0.9660985747851482,252298,0.033901425214851816,2019,2019.csv
4104,Mayday Life,7435496,85912,0.011554306531803662,7349584,0.9884456934681963,2019,2019.csv
4105,Genius,7435006,1361045,0.1830590318286226,6073961,0.8169409681713774,2016,2016.csv
4106,Mere Baap Pehle Aap,7433423,113576,0.015279098202806433,7319847,0.9847209017971935,2008,2008.csv
4107,Beatriz at Dinner,7425391,7115854,0.958313710348721,309537,0.04168628965127897,2017,2017.csv
4108,Dhan Dhana Dhan Goal,7415972,125547,0.016929271038240167,7290425,0.9830707289617598,2007,2007.csv
4109,God's Not Dead: A Light in Darkness,7414178,5728940,0.7727006284445828,1685238,0.2272993715554172,2018,2018.csv
4110,Antichrist,7413863,404122,0.05450896516431447,7009741,0.9454910348356855,2009,2009.csv
4111,Phat Girlz,7403491,7061128,0.9537565453918969,342363,0.04624345460810313,2006,2006.csv
4112,Goodbye Christopher Robin,7401949,1735251,0.23443163415473411,5666698,0.7655683658452659,2017,2017.csv
4113,The Innocents,7400324,1065665,0.14400247881038722,6334659,0.8559975211896128,2016,2016.csv
4114,Requiem for a Dream,7390108,3635482,0.49193895407211913,3754626,0.5080610459278809,2000,2000.csv
4115,Lemon Tree,7387488,569672,0.07711308634274601,6817816,0.922886913657254,2008,2008.csv
4116,It's a Boy Girl Thing,7385679,848,0.00011481679612666621,7384831,0.9998851832038733,2006,2006.csv
4117,Return of the Hero,7362730,37108,0.005039978377585488,7325622,0.9949600216224145,2018,2018.csv
4118,A Christmas Tale,7356393,1060922,0.1442176892941962,6295471,0.8557823107058038,2008,2008.csv
4119,I'm Not Scared,7354418,1615328,0.21964049364613217,5739090,0.7803595063538679,2003,2003.csv
4120,Compadres,7353544,3127773,0.4253422567404234,4225771,0.5746577432595766,2016,2016.csv
4121,Trust the Man,7353118,1530535,0.20814775446280068,5822583,0.7918522455371994,2006,2006.csv
4122,The Young Messiah,7330338,6490401,0.8854163341444828,839937,0.11458366585551717,2016,2016.csv
4123,I Served the King of England,7319210,617403,0.08435377588564887,6701807,0.9156462241143511,2006,2006.csv
4124,Even the Rain,7313485,518017,0.07083039070976423,6795468,0.9291696092902357,2011,2011.csv
4125,Dhoom,7312209,245756,0.033608995585328594,7066453,0.9663910044146714,2004,2004.csv
4126,Mean Machine,7310206,92770,0.012690476848395244,7217436,0.9873095231516048,2001,2001.csv
4127,Respiro,7309845,1072834,0.14676562909336655,6237011,0.8532343709066335,2002,2002.csv
4128,The Beaver,7294800,970816,0.13308329220814827,6323984,0.8669167077918517,2011,2011.csv
4129,The Midwife,7286136,603582,0.08283979327314231,6682554,0.9171602067268577,2017,2017.csv
4130,Krazzy 4,7274081,487215,0.06697959508561975,6786866,0.9330204049143802,2008,2008.csv
4131,Gigli,7266209,6087542,0.8377879028803052,1178667,0.16221209711969475,2003,2003.csv
4132,Venus,7261490,3347411,0.460981286209855,3914079,0.539018713790145,2006,2006.csv
4133,A Long Way Down,7257942,13347,0.0018389510414935804,7244595,0.9981610489585064,2014,2014.csv
4134,The Life Before Her Eyes,7248490,303439,0.041862374094466574,6945051,0.9581376259055334,2008,2008.csv
4135,Where the Money Is,7243669,5661798,0.7816201982724501,1581871,0.21837980172754995,2000,2000.csv
4136,Trolls World Tour,7238314,0,0.0,7238314,1.0,2020,2020.csv
4137,Let There Be Light,7233471,7233471,1.0,0,0.0,2017,2017.csv
4138,Golden Door,7226020,1070769,0.14818240193080007,6155251,0.8518175980691999,2006,2006.csv
4139,Birth of the Dragon,7215027,6901965,0.95660972578481,313062,0.043390274215190046,2017,2017.csv
4140,20th Century Women,7214806,5664764,0.785158187205588,1550042,0.21484181279441195,2016,2016.csv
4141,Animal Kingdom,7208231,1044039,0.14483983657016541,6164192,0.8551601634298346,2010,2010.csv
4142,Grandma,7205073,6980524,0.9688345975120585,224549,0.03116540248794148,2015,2015.csv
4143,Screwed,7201701,7027345,0.9757896085938585,174356,0.02421039140614141,2000,2000.csv
4144,The Widow of Saint-Pierre,7193889,3193889,0.44397251611749916,4000000,0.5560274838825008,2000,2000.csv
4145,Timbuktu,7179391,1076075,0.1498838829087314,6103316,0.8501161170912686,2014,2014.csv
4146,Rescue Dawn,7177143,5490423,0.7649872658242981,1686720,0.23501273417570195,2007,2007.csv
4147,The Jane Austen Book Club,7163566,3575227,0.49908481334575544,3588339,0.5009151866542445,2007,2007.csv
4148,Blade of the Immortal,7162617,150532,0.021016340815095937,7012085,0.978983659184904,2017,2017.csv
4149,The Flock,7155358,0,0.0,7155358,1.0,2007,2007.csv
4150,Wild Rose,7123449,1635117,0.22954007251262695,5488332,0.770459927487373,2019,2019.csv
4151,Jet Lag,7121171,250000,0.03510658570058211,6871171,0.9648934142994179,2002,2002.csv
4152,The Adventures of Pluto Nash,7103973,4420080,0.6221983107199309,2683893,0.3778016892800691,2002,2002.csv
4153,Postman Pat: The Movie,7102455,1519,0.00021386971124773055,7100936,0.9997861302887523,2014,2014.csv
4154,Incendies,7099598,2071334,0.2917537021110209,5028264,0.7082462978889791,2011,2011.csv
4155,Young@Heart,7097002,3992189,0.562517665910197,3104813,0.43748233408980297,2008,2008.csv
4156,Pride,7094650,7057600,0.9947777550689604,37050,0.005222244931039587,2007,2007.csv
4157,The Truth About Charlie,7093284,5350371,0.7542868719199739,1742913,0.24571312808002613,2002,2002.csv
4158,One Piece: Episode of Alabasta - The Desert Princess and the Pirates,7090891,6587,0.0009289382674194258,7084304,0.9990710617325805,2007,2007.csv
4159,In Safe Hands,7086596,1737,0.0002451106285725897,7084859,0.9997548893714274,2018,2018.csv
4160,Croupier,7075068,6201143,0.8764782190079304,873925,0.12352178099206962,2000,2000.csv
4161,Gosanja: Dae-dong-yeo Ji-do,7035812,34034,0.004837252615618496,7001778,0.9951627473843815,2016,2016.csv
4162,Outlander,7034698,166003,0.02359774364158916,6868695,0.9764022563584108,2008,2008.csv
4163,The Joneses,7031729,1475746,0.2098695783071276,5555983,0.7901304216928724,2010,2010.csv
4164,Cosmopolis,7029095,763556,0.10862792436295142,6265539,0.8913720756370486,2012,2012.csv
4165,The Killing of a Sacred Deer,7027336,2291901,0.3261408021474994,4735435,0.6738591978525006,2017,2017.csv
4166,Hard Candy,7022209,1024640,0.14591419879414014,5997569,0.8540858012058599,2006,2006.csv
4167,Innocent Voices,7015131,837878,0.11943868190059459,6177253,0.8805613180994054,2005,2005.csv
4168,An American Carol,7013191,7013191,1.0,0,0.0,2008,2008.csv
4169,The Kid with a Bike,7011798,1470000,0.20964665553685374,5541798,0.7903533444631463,2011,2011.csv
4170,Crossover,7009668,7009668,1.0,0,0.0,2006,2006.csv
4171,Jessabelle,6998359,0,0.0,6998359,1.0,2014,2014.csv
4172,Goon,6985158,4168528,0.5967693214670305,2816630,0.40323067853296946,2012,2012.csv
4173,Days and Clouds,6966224,112102,0.01609221868260337,6854122,0.9839077813173966,2007,2007.csv
4174,The Princess of Montpensier,6965201,352428,0.05059839622718713,6612773,0.9494016037728129,2010,2010.csv
4175,Strange Wilderness,6964734,6575282,0.9440822865596877,389452,0.055917713440312294,2008,2008.csv
4176,11-11-11,6963872,32771,0.004705859039339034,6931101,0.9952941409606609,2011,2011.csv
4177,"Spring, Summer, Fall, Winter... and Spring",6959791,2380788,0.34207751353453,4579003,0.65792248646547,2003,2003.csv
4178,The Salesman,6953604,2402067,0.3454420182685123,4551537,0.6545579817314877,2016,2016.csv
4179,Santa vs. the Snowman 3D 2003 Re-release,6952764,3045032,0.4379599250024882,3907732,0.5620400749975117,2003,2003.csv
4180,What We Do in the Shadows,6946808,3469224,0.49939828479497345,3477584,0.5006017152050265,2014,2014.csv
4181,Father and Sons,6935839,634968,0.09154883785508862,6300871,0.9084511621449114,2003,2003.csv
4182,Igby Goes Down,6919198,4777465,0.6904651377226089,2141733,0.30953486227739113,2002,2002.csv
4183,The Spectacular Now,6918591,6854611,0.9907524523418135,63980,0.009247547658186472,2013,2013.csv
4184,Don 2,6913518,3680306,0.5323347679141068,3233212,0.46766523208589317,2011,2011.csv
4185,Painted Fire,6906235,64029,0.00927118755733044,6842206,0.9907288124426695,2002,2002.csv
4186,Centurion,6890432,123570,0.01793356352693126,6766862,0.9820664364730688,2010,2010.csv
4187,Barbara,6889185,1013902,0.147172996515553,5875283,0.852827003484447,2012,2012.csv
4188,Veer-Zaara,6887221,2938532,0.4266643977302311,3948689,0.5733356022697689,2004,2004.csv
4189,Woman Thou Art Loosed,6879730,6879730,1.0,0,0.0,2004,2004.csv
4190,The Awakening,6879667,209696,0.03048054506126532,6669971,0.9695194549387347,2011,2011.csv
4191,Talvar,6879098,342370,0.049769606422237336,6536728,0.9502303935777626,2015,2015.csv
4192,A Good Woman,6878433,238609,0.034689441621369284,6639824,0.9653105583786307,2005,2005.csv
4193,Ladrón que roba a ladrón,6875089,4011254,0.5834475742786748,2863835,0.4165524257213252,2007,2007.csv
4194,Last Orders,6873892,2329631,0.33891003815596754,4544261,0.6610899618440325,2002,2002.csv
4195,The Unknown Woman,6868786,152114,0.02214568920912662,6716672,0.9778543107908734,2006,2006.csv
4196,Bee Season,6856989,1180560,0.17216886303886444,5676429,0.8278311369611355,2005,2005.csv
4197,Private Fears In Public Places (Coeurs),6855294,134636,0.019639712024021143,6720658,0.9803602879759789,2006,2006.csv
4198,Dog Days,6842356,6809080,0.995136762834322,33276,0.004863237165678021,2018,2018.csv
4199,Commitment,6834802,76543,0.011199007666937535,6758259,0.9888009923330625,2013,2013.csv
4200,Flawless,6819587,1200234,0.17599804797563254,5619353,0.8240019520243674,2007,2007.csv
4201,Collide,6817535,2280004,0.3344323131454404,4537531,0.6655676868545596,2016,2016.csv
4202,Race 3,6817391,1690861,0.2480217138785204,5126530,0.7519782861214797,2018,2018.csv
4203,North Face,6815056,711421,0.1043896044287824,6103635,0.8956103955712176,2008,2008.csv
4204,Bran Nue Dae,6812530,113568,0.016670458698897474,6698962,0.9833295413011025,2010,2010.csv
4205,The Aristocrats,6809089,6377461,0.9366100222805136,431628,0.06338997771948642,2005,2005.csv
4206,The Big Bounce,6808550,6489476,0.9531362771808976,319074,0.04686372281910245,2004,2004.csv
4207,The Names of Love,6803887,514237,0.07557988543901449,6289650,0.9244201145609855,2010,2010.csv
4208,Baahubali: The Beginning,6787855,6738000,0.9926552644392079,49855,0.007344735560792032,2015,2015.csv
4209,China: The Panda Adventure,6784985,3921642,0.5779883080065763,2863343,0.4220116919934237,2001,2001.csv
4210,The Road Home,6780490,1280490,0.1888491834660917,5500000,0.8111508165339083,2001,2001.csv
4211,A Little Bit of Heaven,6778388,15375,0.002268238407125706,6763013,0.9977317615928742,2011,2011.csv
4212,Aaja Nachle,6773493,484108,0.07147095302231803,6289385,0.928529046977682,2007,2007.csv
4213,The Sun Is Also a Star,6750029,4950029,0.7333344790074235,1800000,0.26666552099257645,2019,2019.csv
4214,The Piano Teacher,6749315,1012069,0.14995136543486265,5737246,0.8500486345651374,2001,2001.csv
4215,Séraphin: un homme et son péché,6749187,6749187,1.0,0,0.0,2002,2002.csv
4216,A Letter to Momo,6748888,71712,0.010625750494007309,6677176,0.9893742495059927,2012,2012.csv
4217,R-Point,6744984,0,0.0,6744984,1.0,2004,2004.csv
4218,Midnight Special,6740647,3712282,0.5507308126356416,3028365,0.44926918736435834,2016,2016.csv
4219,Wild Card,6738764,0,0.0,6738764,1.0,2015,2015.csv
4220,Kenny,6732051,69220,0.01028215621064071,6662831,0.9897178437893593,2006,2006.csv
4221,Churchill,6724365,1281258,0.19053962716182124,5443107,0.8094603728381787,2017,2017.csv
4222,Cesar Chavez 2014 Re-release,6719925,5571497,0.8291010688363337,1148428,0.17089893116366625,2014,2014.csv
4223,The Door in the Floor,6715067,3854624,0.5740261415113207,2860443,0.42597385848867925,2004,2004.csv
4224,Pati Patni Aur Woh,6712525,874044,0.13021091169120413,5838481,0.8697890883087959,2019,2019.csv
4225,What Just Happened,6710888,1090947,0.16256373225123114,5619941,0.8374362677487689,2008,2008.csv
4226,Jab Tak Hai Jaan,6703114,3047539,0.45464525890504026,3655575,0.5453547410949597,2012,2012.csv
4227,Bleed for This,6698679,5083906,0.7589415763914049,1614773,0.24105842360859506,2016,2016.csv
4228,Fragile,6680926,0,0.0,6680926,1.0,2005,2005.csv
4229,Fahrenheit 11/9,6674168,6352306,0.9517749628118441,321862,0.048225037188155885,2018,2018.csv
4230,Innocence,6662300,294039,0.044134758266664666,6368261,0.9558652417333353,2014,2014.csv
4231,Son of Saul,6659121,1777043,0.2668584937861919,4882078,0.7331415062138081,2015,2015.csv
4232,The Conquest,6637166,74474,0.011220752953896287,6562692,0.9887792470461038,2011,2011.csv
4233,Spider-Man/Men in Black II,6632970,6632970,1.0,0,0.0,2002,2002.csv
4234,Southside with You,6628603,6304223,0.9510635951496869,324380,0.04893640485031311,2016,2016.csv
4235,Duets,6620242,4739023,0.7158383334023137,1881219,0.2841616665976863,2000,2000.csv
4236,Pieta,6616296,22080,0.003337214659078131,6594216,0.9966627853409219,2012,2012.csv
4237,Against the Ropes,6596511,5884190,0.892015491219525,712321,0.10798450878047501,2004,2004.csv
4238,The Red Turtle,6591789,921974,0.13986703761300612,5669815,0.8601329623869939,2016,2016.csv
4239,Mambo Italiano 2003 Re-release,6590962,3205730,0.48638271621047124,3385232,0.5136172837895288,2003,2003.csv
4240,I Capture the Castle,6586341,1179035,0.1790121404281983,5407306,0.8209878595718016,2003,2003.csv
4241,Ned Kelly,6585516,86959,0.013204584120667233,6498557,0.9867954158793327,2003,2003.csv
4242,Soorma,6579645,390077,0.05928541737434163,6189568,0.9407145826256583,2018,2018.csv
4243,Nowhere Boy,6577779,1457248,0.22154103991636082,5120531,0.7784589600836391,2009,2009.csv
4244,The Raid 2,6566916,2627209,0.4000673984561398,3939707,0.5999326015438602,2014,2014.csv
4245,Grandma's Boy,6566277,6090172,0.9274923978991444,476105,0.07250760210085563,2006,2006.csv
4246,A Melody to Remember,6559996,44263,0.006747412650861372,6515733,0.9932525873491387,2016,2016.csv
4247,Ae Fond Kiss,6547641,30148,0.004604406380862971,6517493,0.995395593619137,2004,2004.csv
4248,Bon voyage,6536601,148727,0.022752956773711596,6387874,0.9772470432262884,2003,2003.csv
4249,Under the Sand,6531687,1452698,0.22240777918476498,5078989,0.777592220815235,2001,2001.csv
4250,From the Land of the Moon 2016 Re-release,6524799,47748,0.007317926575209443,6477051,0.9926820734247905,2016,2016.csv
4251,Midnight Eagle,6522186,7116,0.0010910452415800469,6515070,0.9989089547584199,2007,2007.csv
4252,The Measure of a Man,6518931,112391,0.017240710171652376,6406540,0.9827592898283476,2015,2015.csv
4253,The Lobster,6504366,376871,0.057941235164195866,6127495,0.9420587648358041,2015,2015.csv
4254,Wadjda,6499169,1347747,0.20737220404639423,5151422,0.7926277959536058,2012,2012.csv
4255,Teacher's Pet,6491969,6491969,1.0,0,0.0,2004,2004.csv
4256,It's Kind of a Funny Story,6491240,6363628,0.9803408901843099,127612,0.01965910981569007,2010,2010.csv
4257,Everybody Loves Somebody,6481798,1915789,0.2955644406073747,4566009,0.7044355593926254,2017,2017.csv
4258,Irreversible,6479328,792200,0.12226576583250609,5687128,0.877734234167494,2002,2002.csv
4259,Gloria,6461559,2107925,0.32622545116433976,4353634,0.6737745488356602,2013,2013.csv
4260,The Devil's Backbone,6459020,755249,0.11692934841508464,5703771,0.8830706515849154,2001,2001.csv
4261,Feel the Noise,6451106,5898393,0.9143227533387298,552713,0.08567724666127018,2007,2007.csv
4262,Lassie,6442854,652163,0.10122268795785222,5790691,0.8987773120421478,2005,2005.csv
4263,The September Issue,6442300,3820067,0.5929663319000978,2622233,0.4070336680999022,2009,2009.csv
4264,Waiting for 'Superman',6433688,6417135,0.9974271366594091,16553,0.002572863340590964,2010,2010.csv
4265,Run the Race,6424420,6424420,1.0,0,0.0,2019,2019.csv
4266,Same Kind of Different as Me,6423605,6423605,1.0,0,0.0,2017,2017.csv
4267,Eye See You,6416302,79161,0.01233748037420932,6337141,0.9876625196257907,2002,2002.csv
4268,Post Grad,6414729,6380019,0.9945890153738373,34710,0.005410984626162695,2009,2009.csv
4269,Slackers,6413915,5285941,0.8241364283748693,1127974,0.17586357162513067,2002,2002.csv
4270,Gotti,6412349,4343227,0.6773223041977284,2069122,0.3226776958022715,2018,2018.csv
4271,The Secret Life of Words,6410058,20678,0.003225867847061602,6389380,0.9967741321529384,2005,2005.csv
4272,The Mustang,6405816,5043620,0.7873501205779249,1362196,0.2126498794220752,2019,2019.csv
4273,The Company,6401690,2283914,0.3567673536206845,4117776,0.6432326463793154,2003,2003.csv
4274,A Journey Through Time with Antony,6389648,127381,0.01993552696486567,6262267,0.9800644730351343,2015,2015.csv
4275,"Farewell, My Queen",6366835,1597998,0.25098781419653565,4768837,0.7490121858034644,2012,2012.csv
4276,Fleabag,6361833,326283,0.051287577023791726,6035550,0.9487124229762083,2019,2019.csv
4277,The Chorus 2005 Re-release,6353810,1548036,0.2436390134423283,4805774,0.7563609865576717,2005,2005.csv
4278,Greenberg,6344112,4234170,0.6674172839319357,2109942,0.3325827160680644,2010,2010.csv
4279,Hector and the Search for Happiness,6337728,1124445,0.17742083598412553,5213283,0.8225791640158745,2014,2014.csv
4280,Hampstead,6335171,144396,0.02279275492326884,6190775,0.9772072450767312,2017,2017.csv
4281,Closed Circuit,6331939,5750401,0.9081579907829181,581538,0.09184200921708184,2013,2013.csv
4282,Goodbye Bafana,6317170,0,0.0,6317170,1.0,2007,2007.csv
4283,Life in a Metro,6316418,150212,0.02378120004090926,6166206,0.9762187999590908,2007,2007.csv
4284,Sheng zhe wei wang,6313827,163406,0.02588065843425865,6150421,0.9741193415657413,2015,2015.csv
4285,Lowriders,6312033,6303560,0.9986576432664405,8473,0.0013423567335595363,2017,2017.csv
4286,Blood and Chocolate,6311117,3526847,0.5588308694007733,2784270,0.44116913059922674,2007,2007.csv
4287,Absolutely Anything,6303792,20169,0.003199502775472287,6283623,0.9968004972245277,2015,2015.csv
4288,A Late Quartet,6303709,1562548,0.24787755906879586,4741161,0.7521224409312042,2012,2012.csv
4289,Las Pildoras De Mi Novio,6292780,2971116,0.47214680951820975,3321664,0.5278531904817902,2020,2020.csv
4290,High Tension,6291958,3681066,0.5850430025120956,2610892,0.4149569974879044,2003,2003.csv
4291,I Am Crazy About Love,6290342,1232228,0.19589205165633283,5058114,0.8041079483436672,2003,2003.csv
4292,Deuces Wild,6282446,6080065,0.9677862730535208,202381,0.03221372694647913,2002,2002.csv
4293,Max Steel,6272403,3818664,0.6088039942586597,2453739,0.3911960057413403,2016,2016.csv
4294,College,6265483,4694636,0.749285569843538,1570847,0.250714430156462,2008,2008.csv
4295,Norman,6217567,3814868,0.6135628293189281,2402699,0.38643717068107186,2017,2017.csv
4296,Unbroken: Path to Redemption,6216897,6216897,1.0,0,0.0,2018,2018.csv
4297,Attack the Block,6206022,1024175,0.16502922484000218,5181847,0.8349707751599978,2011,2011.csv
4298,Happily Ever After,6204504,252379,0.04067674063873599,5952125,0.9593232593612641,2005,2005.csv
4299,Great Expectations,6202879,258656,0.041699346384154845,5944223,0.9583006536158452,2012,2012.csv
4300,The Snitch Cartel,6197324,0,0.0,6197324,1.0,2012,2012.csv
4301,Copying Beethoven,6191746,384029,0.0620227315526186,5807717,0.9379772684473814,2006,2006.csv
4302,Yeh Jawaani Hai Deewani,6189998,3827466,0.6183307329016907,2362532,0.38166926709830923,2013,2013.csv
4303,Immortal Hero,6180032,43007,0.006959025454884376,6137025,0.9930409745451156,2019,2019.csv
4304,Flash Point,6177725,5151,0.0008338020873379764,6172574,0.999166197912662,2007,2007.csv
4305,The Autopsy of Jane Doe,6170043,10474,0.0016975570510610704,6159569,0.9983024429489389,2016,2016.csv
4306,Tiger & Bunny: The Rising,6168617,34471,0.005588124534235146,6134146,0.9944118754657648,2014,2014.csv
4307,Darker Than Night,6160114,870063,0.14124137962381866,5290051,0.8587586203761813,2014,2014.csv
4308,The Patriarch,6156936,2156047,0.3501818112125902,4000889,0.6498181887874098,2016,2016.csv
4309,Four Lions,6148687,304616,0.0495416338480069,5844071,0.9504583661519931,2010,2010.csv
4310,Ploey,6146292,77815,0.012660478870837898,6068477,0.9873395211291621,2018,2018.csv
4311,Battle for Terra,6129640,1647083,0.268707950222199,4482557,0.7312920497778009,2009,2009.csv
4312,Mobile Suit Gundam Narrative,6126259,259224,0.04231358811307194,5867035,0.957686411886928,2018,2018.csv
4313,Warriors of Heaven and Earth,6106178,82936,0.013582309588747659,6023242,0.9864176904112524,2003,2003.csv
4314,The Duelist,6101904,13450,0.0022042300239400684,6088454,0.9977957699760599,2016,2016.csv
4315,One Two Three,6090432,274589,0.04508530757752488,5815843,0.9549146924224752,2008,2008.csv
4316,The Trip to Italy,6089109,2880537,0.4730637930771152,3208572,0.5269362069228848,2014,2014.csv
4317,Van Wilder 2: The Rise of Taj,6086508,4300645,0.706586601052689,1785863,0.293413398947311,2006,2006.csv
4318,Vitus,6079556,187480,0.030837778285124767,5892076,0.9691622217148752,2006,2006.csv
4319,Rosenstrasse,6075609,734519,0.12089635787951462,5341090,0.8791036421204854,2003,2003.csv
4320,Megiddo,6047691,6047691,1.0,0,0.0,2001,2001.csv
4321,Meet the Mormons,6047363,6047363,1.0,0,0.0,2014,2014.csv
4322,Jindabyne,6044112,400438,0.06625257771530375,5643674,0.9337474222846962,2006,2006.csv
4323,She's Funny That Way,6034851,111996,0.01855820466818485,5922855,0.9814417953318152,2015,2015.csv
4324,East/West,6031521,2321029,0.384816533010496,3710492,0.615183466989504,2000,2000.csv
4325,Matru's Bijlee's Mandola,6009116,0,0.0,6009116,1.0,2013,2013.csv
4326,The Illusionist,6007194,2231474,0.3714669444669175,3775720,0.6285330555330825,2010,2010.csv
4327,Russian Ark,6001714,2326979,0.38771907491759855,3674735,0.6122809250824015,2002,2002.csv
4328,Blue Exorcist: The Movie,5994921,21796,0.0036357443242371335,5973125,0.9963642556757629,2012,2012.csv
4329,The Broken Circle Breakdown,5990754,175058,0.029221363454416588,5815696,0.9707786365455834,2012,2012.csv
4330,The Rhythm Section,5989583,5437971,0.9079047740051353,551612,0.09209522599486475,2020,2020.csv
4331,"Cyrano, My Love",5985822,351019,0.058641737091413675,5634803,0.9413582629085864,2019,2019.csv
4332,The Butterfly,5983780,189144,0.03160945088221826,5794636,0.9683905491177818,2002,2002.csv
4333,Learning to Drive,5967516,3447633,0.5777333483479559,2519883,0.4222666516520442,2015,2015.csv
4334,Harsh Times,5967038,3337931,0.5593949627939356,2629107,0.44060503720606436,2006,2006.csv
4335,The Immigrant,5952884,2025328,0.340226350790642,3927556,0.659773649209358,2013,2013.csv
4336,Chalte Chalte,5945422,836225,0.14065023475204955,5109197,0.8593497652479505,2003,2003.csv
4337,All Saints,5942565,5802208,0.9763810745023404,140357,0.02361892549765968,2017,2017.csv
4338,Transsiberian,5926410,2206405,0.3723004314585052,3720005,0.6276995685414948,2008,2008.csv
4339,For Your Consideration,5925637,5549923,0.9365951711183118,375714,0.06340482888168816,2006,2006.csv
4340,Coco Chanel & Igor Stravinsky,5925295,1621226,0.27361101852312836,4304069,0.7263889814768716,2009,2009.csv
4341,Don't Tell,5923415,29015,0.004898356775610016,5894400,0.99510164322439,2005,2005.csv
4342,Never Die Alone,5923000,5645298,0.9531146378524397,277702,0.04688536214756036,2004,2004.csv
4343,The Good German,5914908,1308696,0.22125382169934005,4606212,0.77874617830066,2006,2006.csv
4344,Callas Forever,5906353,446955,0.07567360095138236,5459398,0.9243263990486177,2002,2002.csv
4345,Death of a Nation,5885881,5885881,1.0,0,0.0,2018,2018.csv
4346,Maggie's Plan,5883891,3351735,0.5696460046591618,2532156,0.43035399534083824,2016,2016.csv
4347,Blue Story,5881391,0,0.0,5881391,1.0,2019,2019.csv
4348,Underclassman,5879555,5655459,0.9618855508622677,224096,0.03811444913773236,2005,2005.csv
4349,Testament of Youth,5874883,1822250,0.31017638989576474,4052633,0.6898236101042353,2015,2015.csv
4350,Blood: The Last Vampire,5874530,257412,0.043818313975756355,5617118,0.9561816860242437,2009,2009.csv
4351,My Life as a Zucchini,5872598,309766,0.05274769361022157,5562832,0.9472523063897784,2016,2016.csv
4352,Aim,5859242,753600,0.12861731944166158,5105642,0.8713826805583385,2004,2004.csv
4353,Tracks,5853509,510007,0.08712842160147016,5343502,0.9128715783985298,2014,2014.csv
4354,20 Feet from Stardom,5839368,4946445,0.847085677765128,892923,0.152914322234872,2013,2013.csv
4355,The Hero: Love Story of a Spy,5835846,285394,0.04890362082892523,5550452,0.9510963791710748,2003,2003.csv
4356,Young Goethe in Love,5826565,162138,0.027827373418128864,5664427,0.9721726265818711,2010,2010.csv
4357,Puella Magi Madoka Magica the Movie Part 1: Beginnings,5816330,180440,0.031022999038912855,5635890,0.9689770009610872,2012,2012.csv
4358,The Perfect Holiday,5812781,5812781,1.0,0,0.0,2007,2007.csv
4359,Spider,5808941,1642483,0.2827508490790318,4166458,0.7172491509209682,2002,2002.csv
4360,Carriers,5805279,104352,0.017975363457983673,5700927,0.9820246365420163,2009,2009.csv
4361,Phillauri,5805030,467596,0.08055014358237597,5337434,0.919449856417624,2017,2017.csv
4362,Strange Gardens,5793539,78668,0.013578574339449515,5714871,0.9864214256605505,2003,2003.csv
4363,Phoenix,5793245,3184472,0.5496870924671752,2608773,0.4503129075328249,2014,2014.csv
4364,The Wizard of Oz 2013 3D/IMAX Release,5787802,5633202,0.9732886508557135,154600,0.026711349144286554,2013,2013.csv
4365,Passengers,5787152,292437,0.05053210974932056,5494715,0.9494678902506795,2008,2008.csv
4366,Dylan Dog: Dead of Night,5782515,1186538,0.20519410671654115,4595977,0.7948058932834589,2011,2011.csv
4367,The Skeleton Twins,5776640,5284309,0.9147720820407711,492331,0.08522791795922889,2014,2014.csv
4368,Spirited Away Studio Ghibli Fest 2020,5769961,0,0.0,5769961,1.0,2020,2020.csv
4369,Untold Scandal,5762801,63332,0.010989794719616381,5699469,0.9890102052803836,2004,2004.csv
4370,The Good Thief,5756945,3517797,0.6110527371722329,2239148,0.38894726282776715,2003,2003.csv
4371,Thorns,5753991,1041228,0.18095753017340485,4712763,0.8190424698265951,2002,2002.csv
4372,The Golden Bowl,5753678,3050532,0.5301881683333687,2703146,0.4698118316666313,2001,2001.csv
4373,Nicotina,5751007,1117864,0.19437708909065837,4633143,0.8056229109093416,2003,2003.csv
4374,The Disappointments Room,5745040,2423468,0.42183657555038784,3321572,0.5781634244496122,2016,2016.csv
4375,Feast of Love,5741608,3511074,0.6115140566893456,2230534,0.38848594331065445,2007,2007.csv
4376,Under the Skin,5735963,2614251,0.4557649691952336,3121712,0.5442350308047663,2014,2014.csv
4377,The Devil's Double,5728213,1361512,0.2376852955712366,4366701,0.7623147044287634,2011,2011.csv
4378,Kingsglaive: Final Fantasy XV,5725482,269980,0.04715410859731984,5455502,0.9528458914026802,2016,2016.csv
4379,Furie,5717640,594788,0.10402683624712294,5122852,0.895973163752877,2019,2019.csv
4380,Like for Likes,5715555,50839,0.008894849231614427,5664716,0.9911051507683856,2016,2016.csv
4381,Who's Your Caddy?,5713425,5713425,1.0,0,0.0,2007,2007.csv
4382,Catch a Fire,5710236,4299773,0.7529939217923742,1410463,0.24700607820762574,2006,2006.csv
4383,Saaho,5708522,2872057,0.5031174444103045,2836465,0.4968825555896956,2019,2019.csv
4384,My Best Friend's Wedding,5707770,78578,0.013766847648030668,5629192,0.9862331523519693,2016,2016.csv
4385,Vincere,5701481,619162,0.10859669619174386,5082319,0.8914033038082562,2009,2009.csv
4386,The Viral Factor,5687319,220496,0.03876976128822737,5466823,0.9612302387117726,2012,2012.csv
4387,Wish I Was Here,5670776,3591299,0.6332993932400081,2079477,0.36670060675999194,2014,2014.csv
4388,Mission Mangal,5667057,3659413,0.6457342850089561,2007644,0.35426571499104387,2019,2019.csv
4389,Anomalisa,5659286,3759286,0.6642686020816053,1900000,0.3357313979183946,2015,2015.csv
4390,Incident in a Ghostland,5643957,0,0.0,5643957,1.0,2018,2018.csv
4391,The Burning Plain,5642478,200730,0.035574795329286174,5441748,0.9644252046707138,2008,2008.csv
4392,Things to Come,5638693,388140,0.0688351006164017,5250553,0.9311648993835983,2016,2016.csv
4393,Pagalpanti,5633633,423340,0.07514511506163074,5210293,0.9248548849383692,2019,2019.csv
4394,Wazir,5633588,1124045,0.19952559541095302,4509543,0.800474404589047,2016,2016.csv
4395,Dalida,5623134,3465,0.0006162044155447833,5619669,0.9993837955844552,2017,2017.csv
4396,Mother and Child,5621971,1110509,0.19753019003477607,4511462,0.802469809965224,2010,2010.csv
4397,Solitary Man,5615390,4360548,0.7765352005826843,1254842,0.22346479941731562,2010,2010.csv
4398,El Angel,5604680,109608,0.01955651348515883,5495072,0.9804434865148411,2018,2018.csv
4399,The Party,5597950,749827,0.13394671263587563,4848123,0.8660532873641243,2017,2017.csv
4400,A Fish Tale,5595327,563911,0.10078249224754872,5031416,0.8992175077524512,2001,2001.csv
4401,Fathers & Daughters,5587709,0,0.0,5587709,1.0,2015,2015.csv
4402,The French Minister,5586646,12027,0.0021528122598066892,5574619,0.9978471877401933,2013,2013.csv
4403,Princess Mononoke Studio Ghibli Fest 2020,5581380,0,0.0,5581380,1.0,2020,2020.csv
4404,Destroyer,5580940,1533324,0.2747429644468495,4047616,0.7252570355531506,2018,2018.csv
4405,Pawn Sacrifice,5578519,2436633,0.4367885096384901,3141886,0.56321149036151,2014,2014.csv
4406,Knock Knock,5567103,36336,0.00652691354911163,5530767,0.9934730864508884,2015,2015.csv
4407,Dheepan,5562575,261819,0.047067949645622754,5300756,0.9529320503543772,2014,2014.csv
4408,Escobar: Paradise Lost,5552496,195792,0.03526197947733776,5356704,0.9647380205226622,2014,2014.csv
4409,The Contract,5549200,0,0.0,5549200,1.0,2007,2007.csv
4410,Ek Tha Tiger,5543117,2347774,0.42354761770318033,3195343,0.5764523822968196,2012,2012.csv
4411,Last Cab to Darwin,5543036,34193,0.006168641156218361,5508843,0.9938313588437816,2015,2015.csv
4412,Black & White,5541431,5277299,0.9523350556922932,264132,0.0476649443077068,2000,2000.csv
4413,The Brothers Bloom,5530764,3531756,0.6385656665155122,1999008,0.36143433348448784,2009,2009.csv
4414,Shortbus,5526675,1985292,0.3592199649879901,3541383,0.64078003501201,2006,2006.csv
4415,Aqua Teen Hunger Force Colon Movie Film for Theaters,5520368,5520368,1.0,0,0.0,2007,2007.csv
4416,Severance,5515163,137221,0.024880678957267446,5377942,0.9751193210427326,2006,2006.csv
4417,Mademoiselle Chambon,5511371,531685,0.09647055151975797,4979686,0.9035294484802421,2009,2009.csv
4418,The Child,5507396,651941,0.11837554444968185,4855455,0.8816244555503182,2005,2005.csv
4419,On My Way,5505705,317324,0.057635489006403355,5188381,0.9423645109935966,2013,2013.csv
4420,Warriors of the Dawn,5497176,84532,0.015377350115768533,5412644,0.9846226498842314,2017,2017.csv
4421,Tale of Tales,5497104,118925,0.021634118619549492,5378179,0.9783658813804506,2015,2015.csv
4422,A Wizard's Tale,5487261,2150,0.0003918166094158816,5485111,0.9996081833905841,2018,2018.csv
4423,People I Know,5484302,126793,0.023119259296807505,5357509,0.9768807407031925,2002,2002.csv
4424,Made,5480653,5313300,0.9694647699827009,167353,0.030535230017299034,2001,2001.csv
4425,The Legend of Drona,5476404,475104,0.08675473905869618,5001300,0.9132452609413039,2008,2008.csv
4426,Chalet Girl,5468650,1710,0.00031269143207190075,5466940,0.9996873085679281,2011,2011.csv
4427,Micmacs 2009 Re-release,5467891,1262079,0.23081641532356809,4205812,0.7691835846764319,2009,2009.csv
4428,Man of Tai Chi,5464885,100144,0.018324996774863513,5364741,0.9816750032251365,2013,2013.csv
4429,Shinjuku Incident,5461200,0,0.0,5461200,1.0,2009,2009.csv
4430,Frozen River,5457664,2511476,0.46017416975467895,2946188,0.539825830245321,2008,2008.csv
4431,Thank You,5452347,463540,0.08501659927367058,4988807,0.9149834007263294,2011,2011.csv
4432,Harry Potter and the Sorcerer's Stone 2018 Re-release,5449287,295917,0.054303801579913116,5153370,0.9456961984200869,2001,2001.csv
4433,OK Jaanu,5445281,355922,0.0653633852871872,5089359,0.9346366147128128,2017,2017.csv
4434,Hara-Kiri: Death of a Samurai,5435358,75688,0.013925117719936755,5359670,0.9860748822800632,2011,2011.csv
4435,An Inconvenient Sequel: Truth to Power,5433926,3496795,0.6435117077413274,1937131,0.3564882922586726,2017,2017.csv
4436,Devdas,5427830,2745382,0.5057973444267783,2682448,0.49420265557322174,2002,2002.csv
4437,The Salt of the Earth,5412189,1343349,0.24820807255622448,4068840,0.7517919274437755,2014,2014.csv
4438,The Student and Mister Henri,5411932,761,0.00014061521837303203,5411171,0.999859384781627,2015,2015.csv
4439,Virgin Territory,5410749,0,0.0,5410749,1.0,2008,2008.csv
4440,Dolls,5405725,4067,0.000752350517275666,5401658,0.9992476494827244,2002,2002.csv
4441,Lady Macbeth,5401447,1129408,0.2090936002889596,4272039,0.7909063997110404,2017,2017.csv
4442,Read My Lips,5393526,1471911,0.2729032918354338,3921615,0.7270967081645662,2001,2001.csv
4443,Exit Through the Gift Shop,5386242,3291250,0.6110475541202939,2094992,0.3889524458797061,2010,2010.csv
4444,Truth,5383097,2541854,0.4721917513282781,2841243,0.5278082486717218,2015,2015.csv
4445,After the Storm,5382886,272132,0.05055503683340126,5110754,0.9494449631665988,2016,2016.csv
4446,Won't Back Down,5378228,5310554,0.9874170451680367,67674,0.012582954831963242,2012,2012.csv
4447,The Lookout,5371181,4600585,0.8565313661930216,770596,0.14346863380697839,2007,2007.csv
4448,Diary of the Dead,5364858,958961,0.1787486267110891,4405897,0.821251373288911,2008,2008.csv
4449,Equilibrium,5359645,1203794,0.22460330861465638,4155851,0.7753966913853436,2002,2002.csv
4450,Intruders,5348049,69136,0.01292733106970411,5278913,0.9870726689302959,2011,2011.csv
4451,The Real Cancun,5345083,3825421,0.7156897282979516,1519662,0.2843102717020484,2003,2003.csv
4452,Much Ado About Nothing,5341221,4328849,0.8104605669752291,1012372,0.18953943302477091,2013,2013.csv
4453,Trollhunter,5341098,253444,0.04745166630531775,5087654,0.9525483336946823,2010,2010.csv
4454,Sky on fire,5335450,78366,0.014687795781049395,5257084,0.9853122042189506,2016,2016.csv
4455,He Loves Me... He Loves Me Not,5324097,1011102,0.18991051440272408,4312995,0.8100894855972759,2002,2002.csv
4456,Charlotte Gray,5323109,741394,0.139278380360049,4581715,0.860721619639951,2001,2001.csv
4457,The Meddler 2016 Re-release,5294643,4267218,0.80595008955278,1027425,0.19404991044721995,2016,2016.csv
4458,Don't Let Go,5288011,5215062,0.9862048320247443,72949,0.013795167975255724,2019,2019.csv
4459,Whisper,5285197,0,0.0,5285197,1.0,2007,2007.csv
4460,The In Crowd,5280035,5280035,1.0,0,0.0,2000,2000.csv
4461,Talaash,5277766,2871956,0.5441612985494241,2405810,0.45583870145057587,2012,2012.csv
4462,My Spy,5277630,0,0.0,5277630,1.0,2020,2020.csv
4463,Mustang,5274664,845464,0.16028774534264173,4429200,0.8397122546573582,2015,2015.csv
4464,Glitter,5271666,4274407,0.8108265963738978,997259,0.18917340362610227,2001,2001.csv
4465,True Story,5261595,4719695,0.8970084166493241,541900,0.10299158335067599,2015,2015.csv
4466,Man on Wire,5258569,2962242,0.5633171305729753,2296327,0.4366828694270247,2008,2008.csv
4467,Charlie Bartlett,5254986,3951699,0.7519903954073331,1303287,0.24800960459266685,2008,2008.csv
4468,Nathalie...,5254422,31008,0.0059013151208639125,5223414,0.9940986848791361,2004,2004.csv
4469,Les Misérables: The Staged Concert,5251642,459478,0.08749225480335483,4792164,0.9125077451966451,2019,2019.csv
4470,The Biggest Little Farm,5248412,4366949,0.8320514852873593,881463,0.1679485147126407,2019,2019.csv
4471,The Truth,5234914,8771,0.0016754812017924267,5226143,0.9983245187982076,2019,2019.csv
4472,Kick,5233794,2472695,0.4724479029935072,2761099,0.5275520970064929,2014,2014.csv
4473,The Dancer Upstairs,5227348,2377348,0.4547904597130323,2850000,0.5452095402869677,2002,2002.csv
4474,Tucker and Dale vs Evil,5224938,223838,0.042840316956871065,5001100,0.9571596830431289,2010,2010.csv
4475,Kill the Messenger,5218973,2450846,0.4696031192343781,2768127,0.5303968807656219,2014,2014.csv
4476,The New Girlfriend,5215796,146754,0.028136453189503578,5069042,0.9718635468104965,2014,2014.csv
4477,Mountains May Depart,5210160,82913,0.015913714741965696,5127247,0.9840862852580343,2015,2015.csv
4478,Zindagi Na Milegi Dobara,5192743,3108485,0.5986209985743566,2084258,0.4013790014256434,2011,2011.csv
4479,Atanarjuat: The Fast Runner,5188289,3789952,0.7304820529465494,1398337,0.26951794705345056,2002,2002.csv
4480,Oldboy,5186767,2193658,0.422933592351459,2993109,0.577066407648541,2013,2013.csv
4481,The Ex,5178640,3093394,0.5973371387082322,2085246,0.4026628612917677,2007,2007.csv
4482,Intermission,5175215,896993,0.17332477974345029,4278222,0.8266752202565497,2003,2003.csv
4483,My Wife Is an Actress,5169438,1121233,0.2168964982266931,4048205,0.7831035017733069,2001,2001.csv
4484,Prince,5167952,570090,0.11031255708257352,4597862,0.8896874429174265,2008,2008.csv
4485,The House of Mirth,5164404,3043284,0.5892807766394729,2121120,0.4107192233605272,2000,2000.csv
4486,MI-5,5161464,0,0.0,5161464,1.0,2015,2015.csv
4487,October Baby 2012 Re-release,5157886,5157886,1.0,0,0.0,2012,2012.csv
4488,Grind,5141166,5123696,0.9966019381595537,17470,0.003398061840446311,2003,2003.csv
4489,Rabbit Hole,5140925,2229058,0.43359084211498905,2911867,0.566409157885011,2010,2010.csv
4490,The Legend of Chupacabras,5138140,0,0.0,5138140,1.0,2016,2016.csv
4491,Lorna's Silence,5123676,338795,0.0661234238855072,4784881,0.9338765761144928,2008,2008.csv
4492,Never Look Away,5105444,1304042,0.25542185948959584,3801402,0.7445781405104042,2018,2018.csv
4493,The Professor and the Madman,5105195,0,0.0,5105195,1.0,2019,2019.csv
4494,In the Fade,5104991,321011,0.06288179548210761,4783980,0.9371182045178924,2017,2017.csv
4495,"Good Day, Ramon",5104868,154356,0.030237020820126984,4950512,0.969762979179873,2014,2014.csv
4496,Action Point,5103663,5059608,0.9913679645384109,44055,0.008632035461589058,2018,2018.csv
4497,Sin Nombre,5102705,2536665,0.49712162470689564,2566040,0.5028783752931043,2009,2009.csv
4498,The Grocer's Son,5095496,264889,0.05198492943572127,4830607,0.9480150705642787,2007,2007.csv
4499,Serena,5092129,176391,0.03463993154925965,4915738,0.9653600684507403,2014,2014.csv
4500,Kabul Express,5091289,302458,0.05940695961278175,4788831,0.9405930403872182,2006,2006.csv
4501,Dark Places,5090852,208588,0.04097310234121911,4882264,0.9590268976587809,2014,2014.csv
4502,Locke,5090608,1375769,0.2702563230168184,3714839,0.7297436769831815,2014,2014.csv
4503,The Liberator,5082098,113067,0.02224809517644091,4969031,0.9777519048235591,2014,2014.csv
4504,The Sense of an Ending,5081495,1274420,0.2507962715696857,3807075,0.7492037284303144,2017,2017.csv
4505,Dogman,5080147,148225,0.029177305302385936,4931922,0.9708226946976141,2018,2018.csv
4506,Anthropoid,5079219,2964845,0.583720646815977,2114374,0.416279353184023,2016,2016.csv
4507,L'auberge espagnole 2003 Re-release,5079086,2830361,0.5572579397159253,2248725,0.44274206028407476,2003,2003.csv
4508,Konosuba!: God's Blessing on This Wonderful World! - Legend of Crimson,5078942,1134786,0.22342960403958148,3944156,0.7765703959604185,2019,2019.csv
4509,Doctor Who: The Day of the Doctor,5074950,0,0.0,5074950,1.0,2013,2013.csv
4510,Stand Up Guys,5072654,3310031,0.652524497038434,1762623,0.3474755029615661,2013,2013.csv
4511,Mr. X,5061387,44995,0.008889855685803121,5016392,0.9911101443141969,2015,2015.csv
4512,Monsters,5060438,237301,0.04689337168047509,4823137,0.9531066283195249,2010,2010.csv
4513,The Proposition,5048693,1903434,0.37701519977546666,3145259,0.6229848002245334,2005,2005.csv
4514,Vision,5043878,435274,0.08629748776635755,4608604,0.9137025122336424,2009,2009.csv
4515,Table 19,5042014,3614896,0.7169547724381566,1427118,0.28304522756184336,2017,2017.csv
4516,The Fog of War: Eleven Lessons from the Life of Robert S. McNamara,5038841,4198566,0.8332404217557172,840275,0.16675957824428275,2003,2003.csv
4517,Kedi,5037923,2835047,0.562741232845361,2202876,0.4372587671546389,2017,2017.csv
4518,Breathe,5026154,490131,0.09751611271759679,4536023,0.9024838872824033,2017,2017.csv
4519,Oranges and Sunshine,5017653,143480,0.028595042343502033,4874173,0.9714049576564979,2011,2011.csv
4520,Double Lover,5012423,167581,0.03343313204013309,4844842,0.9665668679598669,2017,2017.csv
4521,Worlds Apart,5011560,60298,0.012031782518816496,4951262,0.9879682174811835,2015,2015.csv
4522,Bubble Boy,5007898,5007898,1.0,0,0.0,2001,2001.csv
4523,Blindspotting,5006989,4333394,0.8654690473655924,673595,0.13453095263440762,2018,2018.csv
4524,Alien 2003 Director's Cut,4999112,1986910,0.39745258757955415,3012202,0.6025474124204458,2003,2003.csv
4525,Hands of Stone,4978353,4712792,0.9466568561932028,265561,0.053343143806797146,2016,2016.csv
4526,Take This Waltz,4965950,1239692,0.24963843776115346,3726258,0.7503615622388465,2012,2012.csv
4527,Shrooms,4954621,2863,0.0005778444002074024,4951758,0.9994221555997926,2007,2007.csv
4528,Black Sheep,4947717,84283,0.01703472530866256,4863434,0.9829652746913374,2007,2007.csv
4529,Swiss Army Man,4935501,4210454,0.8530955621323955,725047,0.14690443786760451,2016,2016.csv
4530,Nymphomaniac: Vol. II,4934725,327167,0.06629893256463126,4607558,0.9337010674353687,2014,2014.csv
4531,Sgt. Stubby: An American Hero,4932694,4015935,0.8141463873493876,916759,0.18585361265061243,2018,2018.csv
4532,The Anniversary Party,4931888,4047329,0.8206449538189026,884559,0.17935504618109738,2001,2001.csv
4533,From Justin to Kelly,4928883,4928883,1.0,0,0.0,2003,2003.csv
4534,Hamlet 2,4925288,4886216,0.9920670628803838,39072,0.007932937119616153,2008,2008.csv
4535,Desierto,4924990,2002036,0.4065055969656791,2922954,0.5934944030343209,2016,2016.csv
4536,[REC] 4: Apocalypse,4915757,837,0.00017026879074779326,4914920,0.9998297312092522,2014,2014.csv
4537,Confetti,4903131,228498,0.046602466872698284,4674633,0.9533975331273017,2006,2006.csv
4538,Sleuth,4889751,342895,0.07012524768643638,4546856,0.9298747523135636,2007,2007.csv
4539,Panga,4886124,582720,0.11926017432222351,4303404,0.8807398256777765,2020,2020.csv
4540,Samson,4873825,4719928,0.9684237739352561,153897,0.03157622606474381,2018,2018.csv
4541,The Young Karl Marx,4870373,125659,0.02580069329392225,4744714,0.9741993067060778,2017,2017.csv
4542,Cloud 9,4864463,91675,0.018845862328483124,4772788,0.9811541376715168,2008,2008.csv
4543,No Man's Land,4858869,1012153,0.20831041133234915,3846716,0.7916895886676508,2001,2001.csv
4544,Into Great Silence,4857107,790452,0.16274131906091424,4066655,0.8372586809390857,2005,2005.csv
4545,Silmido,4855181,298347,0.06144920240872585,4556834,0.9385507975912741,2004,2004.csv
4546,Enron: The Smartest Guys in the Room,4854164,4071700,0.8388056110176747,782464,0.16119438898232527,2005,2005.csv
4547,Water,4842898,2250329,0.46466578482553217,2592569,0.5353342151744679,2005,2005.csv
4548,90 Minutes in Heaven,4842699,4842699,1.0,0,0.0,2015,2015.csv
4549,Roman de gare,4841132,1852764,0.3827129687849867,2988368,0.6172870312150134,2007,2007.csv
4550,RamLeela,4840059,2738863,0.565873887074517,2101196,0.4341261129254829,2013,2013.csv
4551,Wild Grass,4826090,403952,0.08370171298090172,4422138,0.9162982870190983,2009,2009.csv
4552,Jimmy's Hall,4825184,560592,0.11618043995835185,4264592,0.8838195600416482,2014,2014.csv
4553,Predestination,4824499,68372,0.014171834215324742,4756127,0.9858281657846752,2014,2014.csv
4554,Capital,4822849,101700,0.021087120911311964,4721149,0.9789128790886881,2012,2012.csv
4555,Mazinger Z: INFINITY,4812371,220682,0.04585722921196225,4591689,0.9541427707880378,2017,2017.csv
4556,Trash,4809022,17484,0.00363566646191263,4791538,0.9963643335380874,2014,2014.csv
4557,God You Are Great,4807638,163756,0.03406163276020366,4643882,0.9659383672397963,2008,2008.csv
4558,Robot & Frank,4806423,3325038,0.6917905477732609,1481385,0.3082094522267391,2012,2012.csv
4559,Flash of Genius,4802953,4442377,0.9249261860359658,360576,0.07507381396403422,2008,2008.csv
4560,Burke and Hare,4791599,4833,0.0010086403307121485,4786766,0.9989913596692879,2010,2010.csv
4561,Ultimate X: The Movie,4786084,4197492,0.8770201275197008,588592,0.12297987248029914,2002,2002.csv
4562,A Royal Night Out,4779170,228136,0.04773548545040247,4551034,0.9522645145495975,2015,2015.csv
4563,Martha Marcy May Marlene,4778439,2990625,0.6258581515846493,1787814,0.3741418484153507,2011,2011.csv
4564,Talk to Me,4778376,4533261,0.948703283291227,245115,0.051296716708773026,2007,2007.csv
4565,Whipped,4775009,4159986,0.8711996144928732,615023,0.1288003855071268,2000,2000.csv
4566,Men & Chicken,4765472,30207,0.00633872153692226,4735265,0.9936612784630777,2015,2015.csv
4567,Force,4763946,0,0.0,4763946,1.0,2011,2011.csv
4568,Slack Bay,4734494,112621,0.023787336091248612,4621873,0.9762126639087514,2016,2016.csv
4569,The Magdalene Sisters 2003 Re-release,4734466,4583889,0.9681955684125728,150577,0.03180443158742718,2003,2003.csv
4570,The Double,4729855,137921,0.02915966768537302,4591934,0.970840332314627,2011,2011.csv
4571,Clouds of Sils Maria,4728401,1851517,0.3915735996164454,2876884,0.6084264003835546,2014,2014.csv
4572,The Other Side of Heaven,4720371,4720371,1.0,0,0.0,2001,2001.csv
4573,Sweet Bean,4720010,124800,0.026440621947834857,4595210,0.9735593780521652,2015,2015.csv
4574,A Housekeeper,4719781,467288,0.09900628863923983,4252493,0.9009937113607601,2002,2002.csv
4575,Girl in Progress,4709246,2609412,0.5541039903203188,2099834,0.4458960096796812,2012,2012.csv
4576,Held Up,4705631,4705631,1.0,0,0.0,2000,2000.csv
4577,"Jeff, Who Lives at Home",4704757,4269426,0.9074700351155225,435331,0.09252996488447757,2012,2012.csv
4578,Unlocked,4699125,0,0.0,4699125,1.0,2017,2017.csv
4579,Menteur,4697364,4697364,1.0,0,0.0,2019,2019.csv
4580,Kickin' It Old Skool,4692108,4502604,0.9596121828397812,189504,0.04038781716021882,2007,2007.csv
4581,Jay and Silent Bob Reboot,4691248,4589490,0.9783089702356388,101758,0.02169102976436121,2019,2019.csv
4582,Bodyguard,4690492,1834384,0.3910856259855043,2856108,0.6089143740144957,2011,2011.csv
4583,Keith Lemon: The Film,4682943,0,0.0,4682943,1.0,2012,2012.csv
4584,The Runaways,4681651,3573673,0.7633360538835552,1107978,0.2366639461164448,2010,2010.csv
4585,The Woodsman,4678405,1576231,0.33691632084011536,3102174,0.6630836791598846,2004,2004.csv
4586,Lovely & Amazing,4677852,4222923,0.9027483126871051,454929,0.0972516873128949,2002,2002.csv
4587,Warriors of the Rainbow: Seediq Bale I,4670432,136166,0.029154904728299225,4534266,0.9708450952717008,2011,2011.csv
4588,Where to Invade Next,4664756,3827261,0.8204632782507809,837495,0.17953672174921903,2016,2016.csv
4589,Don't Come Knocking,4663501,440793,0.09451976101216661,4222708,0.9054802389878334,2005,2005.csv
4590,A Simple Life,4663094,191826,0.041137064790029966,4471268,0.95886293520997,2012,2012.csv
4591,Half Nelson,4660481,2697938,0.5788968992685519,1962543,0.42110310073144813,2006,2006.csv
4592,Tubelight,4650456,930058,0.19999286091514468,3720398,0.8000071390848553,2017,2017.csv
4593,Blood and Bones,4649617,0,0.0,4649617,1.0,2004,2004.csv
4594,Rize,4646889,3336391,0.717983795179958,1310498,0.28201620482004197,2005,2005.csv
4595,Gemma Bovery,4644525,191533,0.04123844741927323,4452992,0.9587615525807268,2014,2014.csv
4596,Everybody Wants Some!!,4644472,3400278,0.7321129290907556,1244194,0.26788707090924435,2016,2016.csv
4597,Dear White People,4633961,4404154,0.9504080850054629,229807,0.04959191499453707,2014,2014.csv
4598,Killer Joe,4633668,1987762,0.428982395803929,2645906,0.5710176041960711,2012,2012.csv
4599,Rogue,4631926,10452,0.0022565127335799407,4621474,0.99774348726642,2007,2007.csv
4600,Hamlet 2018 Re-release,4630718,235229,0.050797522112121705,4395489,0.9492024778878783,2018,2018.csv
4601,Let's Go to Prison,4630045,4630045,1.0,0,0.0,2006,2006.csv
4602,Bottle Shock,4628553,4078607,0.8811840331092676,549946,0.11881596689073237,2008,2008.csv
4603,Atlas Shrugged: Part I,4627375,4627375,1.0,0,0.0,2011,2011.csv
4604,Heneral Luna,4625639,206040,0.044543035027160574,4419599,0.9554569649728394,2015,2015.csv
4605,Housefull 4,4625481,2109160,0.455987171928714,2516321,0.544012828071286,2019,2019.csv
4606,Bad Samaritan,4623836,3435047,0.742899834682718,1188789,0.257100165317282,2018,2018.csv
4607,A Hidden Life,4614219,1730597,0.3750574040807339,2883622,0.624942595919266,2019,2019.csv
4608,The Last Black Man in San Francisco,4607017,4515719,0.9801828384831226,91298,0.019817161516877405,2019,2019.csv
4609,"Food, Inc.",4606199,4417674,0.9590714600042247,188525,0.04092853999577526,2009,2009.csv
4610,Whitney,4605123,3026351,0.6571705033720054,1578772,0.3428294966279945,2018,2018.csv
4611,The Guilty,4598051,207140,0.04504952206924195,4390911,0.954950477930758,2018,2018.csv
4612,The Book of Henry,4596705,4504974,0.9800441838229775,91731,0.019955816177022453,2017,2017.csv
4613,Miss March,4591629,4543320,0.9894788973586498,48309,0.010521102641350161,2009,2009.csv
4614,Tortilla Soup,4574762,4467615,0.9765786722894,107147,0.023421327710600025,2001,2001.csv
4615,Labyrinth of Lies,4574756,794452,0.17365997224770022,3780304,0.8263400277522998,2014,2014.csv
4616,Find a Boyfriend for My Wife... PLEASE!,4570757,1741889,0.38109420387038734,2828868,0.6189057961296127,2016,2016.csv
4617,The Beach Bum,4554416,3502600,0.7690557911266779,1051816,0.23094420887332207,2019,2019.csv
4618,The Iceman,4552970,1969193,0.432507352343635,2583777,0.567492647656365,2013,2013.csv
4619,Paranoid Park,4545747,486767,0.10708185035374825,4058980,0.8929181496462517,2007,2007.csv
4620,The Keys to the House,4537451,0,0.0,4537451,1.0,2004,2004.csv
4621,Colossal,4531320,3029287,0.6685219759363717,1502033,0.33147802406362825,2017,2017.csv
4622,Cezanne et Moi,4529583,257597,0.05686991495685144,4271986,0.9431300850431485,2016,2016.csv
4623,Maps to the Stars,4510934,350741,0.07775352066778188,4160193,0.9222464793322181,2014,2014.csv
4624,"Juliet, Naked",4508260,3444895,0.7641296198533358,1063365,0.23587038014666412,2018,2018.csv
4625,Beyond a Reasonable Doubt,4508114,32917,0.007301723070889512,4475197,0.9926982769291105,2009,2009.csv
4626,Day Watch 2007 Re-release,4506717,450897,0.10004999204520719,4055820,0.8999500079547929,2007,2007.csv
4627,Simon and the Oaks,4505573,150664,0.03343947595566646,4354909,0.9665605240443336,2011,2011.csv
4628,Luck by Chance,4504365,356019,0.07903866582748068,4148346,0.9209613341725194,2009,2009.csv
4629,Barfi!,4490134,2804874,0.6246748983437911,1685260,0.3753251016562089,2012,2012.csv
4630,Bullhead,4483147,151840,0.03386906563625953,4331307,0.9661309343637404,2011,2011.csv
4631,The Wall,4476705,1803064,0.4027658735610231,2673641,0.5972341264389769,2017,2017.csv
4632,Woman at War,4474828,847495,0.18939163695230296,3627333,0.810608363047697,2018,2018.csv
4633,"Synecdoche, New York",4471324,3083538,0.6896252653576435,1387786,0.3103747346423565,2008,2008.csv
4634,Batman: The Killing Joke,4462034,3775000,0.8460267223423219,687034,0.1539732776576781,2016,2016.csv
4635,Flypaper,4453634,5043,0.0011323337301628288,4448591,0.9988676662698371,2011,2011.csv
4636,Scoob!,4452295,0,0.0,4452295,1.0,2020,2020.csv
4637,Buck,4448728,4038912,0.9078801850776221,409816,0.09211981492237781,2011,2011.csv
4638,In Harm's Way,4447734,0,0.0,4447734,1.0,2017,2017.csv
4639,Mental,4446852,17669,0.003973372624049553,4429183,0.9960266273759505,2012,2012.csv
4640,Walk on Water,4444265,2713932,0.6106593553714731,1730333,0.38934064462852686,2004,2004.csv
4641,Leviathan,4439481,1092800,0.24615489963804327,3346681,0.7538451003619567,2014,2014.csv
4642,The Return,4429093,504256,0.11385084937254648,3924837,0.8861491506274535,2003,2003.csv
4643,Swift,4428275,0,0.0,4428275,1.0,2019,2019.csv
4644,Samsara,4426444,2672413,0.6037381247791681,1754031,0.3962618752208319,2012,2012.csv
4645,The Assassination of Richard Nixon,4426087,708776,0.1601360298611392,3717311,0.8398639701388608,2004,2004.csv
4646,Safety Not Guaranteed,4424699,4010957,0.906492622436012,413742,0.09350737756398797,2012,2012.csv
4647,I'm Screwed by Getting Married,4423137,223137,0.050447680006294175,4200000,0.9495523199937058,2006,2006.csv
4648,Don't Think Twice,4417667,4417667,1.0,0,0.0,2016,2016.csv
4649,Laurel Canyon,4412203,3663356,0.8302782079609664,748847,0.16972179203903356,2003,2003.csv
4650,The Commune,4410339,38737,0.008783225053675013,4371602,0.991216774946325,2016,2016.csv
4651,Keeping Up with the Steins,4409374,4339241,0.9840945676188956,70133,0.015905432381104437,2006,2006.csv
4652,Thérèse,4408087,101944,0.02312658529652432,4306143,0.9768734147034757,2012,2012.csv
4653,When Harry Met Sejal,4407775,1664648,0.37766174543845815,2743127,0.6223382545615418,2017,2017.csv
4654,The Tao of Steve,4406030,4342203,0.9855137164295296,63827,0.014486283570470469,2000,2000.csv
4655,On the Line,4403019,4365455,0.9914685809895437,37564,0.008531419010456235,2001,2001.csv
4656,The Eagle Huntress,4400140,3169351,0.7202841273232216,1230789,0.27971587267677844,2016,2016.csv
4657,360,4396975,100343,0.02282091665292616,4296632,0.9771790833470738,2012,2012.csv
4658,Kabali,4388789,3903095,0.8893330255794936,485694,0.11066697442050644,2016,2016.csv
4659,White Elephant,4387907,8884,0.0020246554906473632,4379023,0.9979753445093527,2012,2012.csv
4660,The Lost City,4386236,2484186,0.5663594024580528,1902050,0.4336405975419471,2006,2006.csv
4661,Clown,4381603,55007,0.012554081234653163,4326596,0.9874459187653468,2014,2014.csv
4662,Brian Banks,4376819,4376819,1.0,0,0.0,2019,2019.csv
4663,Seven Days in Utopia,4373074,4373074,1.0,0,0.0,2011,2011.csv
4664,There Be Dragons,4372642,1069334,0.24455100600506513,3303308,0.7554489939949349,2011,2011.csv
4665,Mark Felt: The Man Who Brought Down the White House,4372130,768946,0.17587445935962562,3603184,0.8241255406403744,2017,2017.csv
4666,Demolition,4366460,1978592,0.4531341177979416,2387868,0.5468658822020585,2016,2016.csv
4667,King of Devil's Island,4360391,7615,0.0017464030175275566,4352776,0.9982535969824724,2010,2010.csv
4668,Blinky Bill the Movie,4344536,0,0.0,4344536,1.0,2015,2015.csv
4669,Standing Tall,4323120,26144,0.006047484224356484,4296976,0.9939525157756435,2015,2015.csv
4670,Please Give,4313829,4033574,0.9350333543587379,280255,0.06496664564126209,2010,2010.csv
4671,Uri: The Surgical Strike 2019 Re-release,4302454,4186168,0.9729721689063963,116286,0.02702783109360379,2019,2019.csv
4672,Soul Survivors,4299141,3111545,0.7237596999028411,1187596,0.27624030009715894,2001,2001.csv
4673,The Grand Seduction,4292517,3430018,0.7990691708384614,862499,0.20093082916153857,2014,2014.csv
4674,High-Rise,4286576,346472,0.08082721500796906,3940104,0.9191727849920309,2016,2016.csv
4675,Caterina in the Big City,4285937,296464,0.0691713387294307,3989473,0.9308286612705693,2003,2003.csv
4676,The Other Side of Hope,4282973,183943,0.042947503988467826,4099030,0.9570524960115322,2017,2017.csv
4677,Storm Boy,4281218,71760,0.016761585137687454,4209458,0.9832384148623126,2018,2018.csv
4678,Mohabbatein,4279351,1070000,0.25003791462770875,3209351,0.7499620853722913,2000,2000.csv
4679,Wake Up Sid,4278081,718766,0.16801131161378197,3559315,0.831988688386218,2009,2009.csv
4680,Linda Ronstadt: The Sound of My Voice,4252657,4252657,1.0,0,0.0,2019,2019.csv
4681,Men with Brooms,4245870,4245870,1.0,0,0.0,2002,2002.csv
4682,I Hate Valentine's Day,4243957,11004,0.002592863217040135,4232953,0.9974071367829599,2009,2009.csv
4683,Santa vs. the Snowman 3D 2004 Re-release,4243755,1926034,0.4538513651235757,2317721,0.5461486348764243,2004,2004.csv
4684,Heaven,4243537,784399,0.18484556632827756,3459138,0.8151544336717225,2002,2002.csv
4685,"Don't Worry, He Won't Get Far on Foot",4241656,1441705,0.3398920138738266,2799951,0.6601079861261734,2018,2018.csv
4686,"Good Morning, Night",4234655,10093,0.002383429110517858,4224562,0.9976165708894822,2003,2003.csv
4687,Heroes,4229775,655538,0.1549817661695953,3574237,0.8450182338304046,2008,2008.csv
4688,Branded,4227984,353513,0.08361266267800446,3874471,0.9163873373219955,2012,2012.csv
4689,Left Behind: The Movie,4224065,4224065,1.0,0,0.0,2001,2001.csv
4690,Fearless 2,4216988,2519190,0.5973908391487004,1697798,0.40260916085129955,2012,2012.csv
4691,The Rabbi's Cat,4208573,23392,0.005558178508487319,4185181,0.9944418214915127,2011,2011.csv
4692,Diplomacy,4207242,230880,0.05487680528003856,3976362,0.9451231947199614,2014,2014.csv
4693,Let the Sunshine In,4192590,892421,0.2128567305651161,3300169,0.7871432694348839,2017,2017.csv
4694,Harry Potter and the Prisoner of Azkaban 2018 Re-release,4190987,218774,0.05220106862655503,3972213,0.947798931373445,2004,2004.csv
4695,Sheep & Wolves,4190750,0,0.0,4190750,1.0,2016,2016.csv
4696,Song of the Sea,4190670,857522,0.20462646784404404,3333148,0.795373532155956,2014,2014.csv
4697,Evelyn,4186916,1487645,0.3553080596792484,2699271,0.6446919403207516,2002,2002.csv
4698,Tanu Weds Manu Returns,4180081,3043479,0.7280909149846618,1136602,0.2719090850153382,2015,2015.csv
4699,Changing Times,4178714,545255,0.13048392400149902,3633459,0.869516075998501,2004,2004.csv
4700,East Is East,4177818,4177818,1.0,0,0.0,2000,2000.csv
4701,Nitro Circus: The Movie,4174269,3377618,0.8091519736749117,796651,0.1908480263250883,2012,2012.csv
4702,Welcome to Collinwood,4172703,336620,0.08067192896307261,3836083,0.9193280710369274,2002,2002.csv
4703,Krrish 3,4170204,2191534,0.5255220128319862,1978670,0.47447798716801387,2013,2013.csv
4704,The Guardians,4167608,177331,0.04254982714305184,3990277,0.9574501728569481,2017,2017.csv
4705,It's a Wonderful Life 2007 Re-release,4163338,0,0.0,4163338,1.0,2007,2007.csv
4706,Good Hair,4163135,4157223,0.9985799163370873,5912,0.0014200836629126848,2009,2009.csv
4707,Dil Dhadakne Do,4161630,3066100,0.7367545889471193,1095530,0.26324541105288074,2015,2015.csv
4708,Witless Protection,4161625,4161625,1.0,0,0.0,2008,2008.csv
4709,A Quiet Passion,4159246,1865396,0.44849378949934676,2293850,0.5515062105006533,2016,2016.csv
4710,The Abandoned,4153578,1331137,0.3204795961457808,2822441,0.6795204038542192,2007,2007.csv
4711,King's Ransom,4143652,4008527,0.9673898773352588,135125,0.03261012266474115,2005,2005.csv
4712,Edison,4143414,0,0.0,4143414,1.0,2005,2005.csv
4713,Savage,4140502,74491,0.01799081367428394,4066011,0.9820091863257161,2019,2019.csv
4714,The Last Princess,4135255,29259,0.007075500785320373,4105996,0.9929244992146796,2016,2016.csv
4715,Ghost Stories,4131358,148747,0.03600438403062625,3982611,0.9639956159693738,2018,2018.csv
4716,Apartment 143,4126744,383,9.280924622414184e-05,4126361,0.9999071907537759,2012,2012.csv
4717,Arctic 2019 Re-release,4124015,2410795,0.5845747408775186,1713220,0.41542525912248135,2019,2019.csv
4718,Carancho,4120012,85526,0.02075867740191048,4034486,0.9792413225980895,2010,2010.csv
4719,The Fall of the American Empire,4110928,2178460,0.5299192785667859,1932468,0.4700807214332141,2018,2018.csv
4720,Naam Hai Akira,4108063,219401,0.05340740879582421,3888662,0.9465925912041758,2016,2016.csv
4721,The Hero,4101699,4077333,0.9940595348415376,24366,0.005940465158462384,2017,2017.csv
4722,Japanese Story,4095954,647054,0.15797394209016996,3448900,0.8420260579098301,2003,2003.csv
4723,Force Majeure,4094339,1359497,0.3320430965779824,2734842,0.6679569034220175,2014,2014.csv
4724,The White Countess,4092682,1669971,0.4080382986022369,2422711,0.5919617013977632,2005,2005.csv
4725,The Damned United,4091378,449865,0.10995439678269767,3641513,0.8900456032173023,2009,2009.csv
4726,American Animals,4080073,2856954,0.700221295060162,1223119,0.2997787049398381,2018,2018.csv
4727,Katti Batti,4079135,364932,0.08946308469810389,3714203,0.9105369153018961,2015,2015.csv
4728,Capturing the Friedmans,4076990,3119113,0.7650528944147521,957877,0.23494710558524795,2003,2003.csv
4729,Bossa Nova,4069261,1823297,0.4480658773177734,2245964,0.5519341226822265,2000,2000.csv
4730,The Visual Bible: The Gospel of John,4069090,4069090,1.0,0,0.0,2003,2003.csv
4731,Grizzly Man,4061305,3178403,0.7826063297388401,882902,0.2173936702611599,2005,2005.csv
4732,From Prada to Nada,4058694,3033623,0.7474382153471043,1025071,0.25256178465289575,2011,2011.csv
4733,2 Days in New York,4058113,633210,0.15603557614093053,3424903,0.8439644238590694,2012,2012.csv
4734,The Killer Inside Me,4050140,217277,0.053646787518456154,3832863,0.9463532124815438,2010,2010.csv
4735,Dev.D,4047969,18613,0.004598108335315809,4029356,0.9954018916646842,2009,2009.csv
4736,Film Stars Don't Die in Liverpool,4047917,1026124,0.2534943280704619,3021793,0.7465056719295381,2017,2017.csv
4737,Love in the Buff,4045381,256451,0.06339353450268342,3788930,0.9366064654973165,2012,2012.csv
4738,Step Into Liquid,4041588,3681803,0.9109792982362378,359785,0.08902070176376216,2003,2003.csv
4739,Inland Empire,4037577,861355,0.21333463114139992,3176222,0.7866653688586001,2006,2006.csv
4740,Metropolis,4035192,722932,0.17915677866133756,3312260,0.8208432213386625,2002,2002.csv
4741,Housefull 2,4035090,1791780,0.44404957510241405,2243310,0.555950424897586,2012,2012.csv
4742,Schultze Gets the Blues,4034232,595071,0.14750539879709446,3439161,0.8524946012029055,2004,2004.csv
4743,Junglee,4033587,295784,0.07333026410487738,3737803,0.9266697358951226,2019,2019.csv
4744,Rare Exports,4028971,236347,0.05866187669258478,3792624,0.9413381233074152,2010,2010.csv
4745,Vulgaria,4028543,59059,0.014660138913746235,3969484,0.9853398610862537,2012,2012.csv
4746,Jeepers Creepers III,4017852,2335162,0.5811966194872284,1682690,0.4188033805127715,2017,2017.csv
4747,A Perfect Day,4009440,14044,0.0035027335488247734,3995396,0.9964972664511752,2015,2015.csv
4748,Penguin Highway,4006647,104567,0.026098381015347744,3902080,0.9739016189846522,2018,2018.csv
4749,Peninsula,4000000,0,0.0,4000000,1.0,2020,2020.csv
4750,Faces Places,3998450,953717,0.23852167714989558,3044733,0.7614783228501044,2017,2017.csv
4751,Ride Your Wave,3995885,332432,0.08319358540098126,3663453,0.9168064145990188,2019,2019.csv
4752,Sleight,3989705,3986245,0.999132767961541,3460,0.0008672320384589838,2017,2017.csv
4753,The Invisible Woman,3986888,1234254,0.3095782976597286,2752634,0.6904217023402714,2013,2013.csv
4754,Le petit lieutenant,3984265,216724,0.054394976237775346,3767541,0.9456050237622247,2005,2005.csv
4755,Eden Lake,3983997,7321,0.0018376017853427098,3976676,0.9981623982146572,2008,2008.csv
4756,Choke,3982459,2926565,0.7348638115295097,1055894,0.2651361884704902,2008,2008.csv
4757,The Nile Hilton Incident,3979536,81089,0.02037649615432553,3898447,0.9796235038456744,2017,2017.csv
4758,Ip Man: The Final Fight,3967001,37884,0.009549783324985298,3929117,0.9904502166750146,2013,2013.csv
4759,Digimon Adventure: Last Evolution Kizuna,3966107,0,0.0,3966107,1.0,2020,2020.csv
4760,Lucifer,3956978,0,0.0,3956978,1.0,2019,2019.csv
4761,The Devil's Violinist,3952097,11294,0.002857723380777344,3940803,0.9971422766192226,2013,2013.csv
4762,Bully 2012 Re-release,3950244,3863446,0.978027180093179,86798,0.021972819906820946,2012,2012.csv
4763,2:22,3945729,422,0.00010695108559153454,3945307,0.9998930489144084,2017,2017.csv
4764,Breakfast on Pluto,3942254,828699,0.2102094385597681,3113555,0.7897905614402319,2005,2005.csv
4765,Tristram Shandy: A Cock and Bull Story,3931982,1253413,0.31877383975816775,2678569,0.6812261602418322,2006,2006.csv
4766,Terminator 2: Judgment Day 2017 Re-release,3931111,1037809,0.2639989051441183,2893302,0.7360010948558817,2017,2017.csv
4767,Welcome to the Punch,3926386,9747,0.002482435501756577,3916639,0.9975175644982435,2013,2013.csv
4768,Loveless,3925992,566356,0.1442580626756244,3359636,0.8557419373243756,2017,2017.csv
4769,Indignation,3924527,3401155,0.86664074422217,523372,0.13335925577783003,2016,2016.csv
4770,Mrs. Palfrey at the Claremont,3919275,1720953,0.43909983351512716,2198322,0.5609001664848728,2005,2005.csv
4771,Brick,3919254,2075743,0.5296270667836277,1843511,0.4703729332163723,2006,2006.csv
4772,A Private War,3915207,1633208,0.4171447384518877,2281999,0.5828552615481123,2018,2018.csv
4773,The To Do List,3909596,3491669,0.8931022540436403,417927,0.10689774595635969,2013,2013.csv
4774,The Starving Games,3906308,0,0.0,3906308,1.0,2013,2013.csv
4775,Taxi,3906227,321642,0.08234083682284721,3584585,0.9176591631771528,2015,2015.csv
4776,Camping sauvage,3900099,3894585,0.9985861897351836,5514,0.0014138102648163548,2004,2004.csv
4777,The Wall,3889260,38674,0.009943793935093051,3850586,0.990056206064907,2012,2012.csv
4778,Osama,3888902,1270904,0.32680278392204276,2617998,0.6731972160779572,2003,2003.csv
4779,Rules Don't Apply,3885342,3652206,0.9399960157947486,233136,0.06000398420525143,2016,2016.csv
4780,Neruda,3884746,939101,0.2417406440472556,2945645,0.7582593559527444,2016,2016.csv
4781,The Perfect Game,3878993,1037071,0.26735572866463025,2841922,0.7326442713353698,2010,2010.csv
4782,"The Night Is Short, Walk on Girl",3878208,406490,0.10481387279898345,3471718,0.8951861272010165,2017,2017.csv
4783,Django,3876874,56556,0.014588041808941946,3820318,0.9854119581910581,2017,2017.csv
4784,Horns,3875442,173948,0.044884686701542685,3701494,0.9551153132984573,2014,2014.csv
4785,Submarine,3875173,467602,0.1206660967136177,3407571,0.8793339032863823,2011,2011.csv
4786,Trailer Park Boys: The Movie,3868567,3860678,0.9979607436035101,7889,0.0020392563964899664,2006,2006.csv
4787,First Reformed,3862498,3448256,0.8927528247263817,414242,0.10724717527361827,2018,2018.csv
4788,Lan Yu,3847964,116325,0.030230272424586094,3731639,0.9697697275754139,2001,2001.csv
4789,Frozen,3843774,246176,0.06404538872472731,3597598,0.9359546112752727,2010,2010.csv
4790,Marley,3842919,1413480,0.36781415377217164,2429439,0.6321858462278284,2012,2012.csv
4791,Gracie,3826568,2956339,0.7725823766884582,870229,0.22741762331154183,2007,2007.csv
4792,To Save a Life,3824868,3777210,0.9875399621634001,47658,0.012460037836599852,2010,2010.csv
4793,2001: A Space Odyssey 2017 Re-release,3823450,3236321,0.8464399952922099,587129,0.15356000470779008,2017,2017.csv
4794,Elles,3822241,157508,0.04120828592440927,3664733,0.9587917140755907,2012,2012.csv
4795,The Other Son,3820405,1285918,0.3365920628833854,2534487,0.6634079371166146,2012,2012.csv
4796,The Homesman,3819421,2429989,0.6362192070473509,1389432,0.3637807929526491,2014,2014.csv
4797,Benji: Off the Leash!,3817362,3817362,1.0,0,0.0,2004,2004.csv
4798,Brad's Status,3816527,2133158,0.558926479493005,1683369,0.441073520506995,2017,2017.csv
4799,Green Street Hooligans,3814717,346830,0.09091893317381079,3467887,0.9090810668261892,2005,2005.csv
4800,Sweet 20,3810429,71775,0.01883646172123926,3738654,0.9811635382787607,2015,2015.csv
4801,Better Luck Tomorrow,3809226,3802390,0.998205409707904,6836,0.0017945902920960845,2003,2003.csv
4802,Brick Lane,3794592,1095398,0.28867345949182416,2699194,0.7113265405081759,2007,2007.csv
4803,Custody,3790303,83882,0.022130684538940553,3706421,0.9778693154610595,2018,2018.csv
4804,The Paperboy,3783865,693286,0.18322165299237683,3090579,0.8167783470076232,2012,2012.csv
4805,Donnie Darko 2004 Director's Cut,3782231,753147,0.19912771060255177,3029084,0.8008722893974483,2004,2004.csv
4806,Nitro,3780889,3768878,0.9968232339008101,12011,0.0031767660991898995,2007,2007.csv
4807,Citizenfour,3780692,2800870,0.7408352756585302,979822,0.25916472434146975,2014,2014.csv
4808,Green Room,3769214,3220371,0.8543879440116693,548843,0.1456120559883307,2016,2016.csv
4809,The Polar Express 2006 IMAX Release,3765011,2940722,0.7810659782932905,824289,0.21893402170670948,2006,2006.csv
4810,The Secret Lives of Dentists,3764286,3707346,0.984873625436537,56940,0.015126374563463031,2003,2003.csv
4811,Before the Fall,3764219,144254,0.038322424917360015,3619965,0.96167757508264,2005,2005.csv
4812,Kings & Queen,3761583,290973,0.0773538693682952,3470610,0.9226461306317048,2004,2004.csv
4813,Black Sea,3758103,1171559,0.3117421209583665,2586544,0.6882578790416335,2014,2014.csv
4814,Riding Alone for Thousands of Miles,3752325,252325,0.06724497478230164,3500000,0.9327550252176984,2006,2006.csv
4815,You Kill Me,3748295,2429367,0.6481258812340011,1318928,0.35187411876599894,2007,2007.csv
4816,The Trip,3741198,2030962,0.542864077228738,1710236,0.457135922771262,2011,2011.csv
4817,Take Shelter,3741098,1730296,0.46251020422346595,2010802,0.5374897957765341,2011,2011.csv
4818,Up at the Villa,3740113,2933161,0.7842439519875469,806952,0.2157560480124531,2000,2000.csv
4819,Like Crazy,3731489,3395391,0.9099292534427945,336098,0.09007074655720544,2011,2011.csv
4820,The Big Kahuna,3728888,3165544,0.8489243978365668,563344,0.1510756021634332,2000,2000.csv
4821,Ragnarok,3721345,1369,0.00036787774312782074,3719976,0.9996321222568721,2013,2013.csv
4822,Free Fire,3719383,1799312,0.4837662590811433,1920071,0.5162337409188567,2017,2017.csv
4823,Summertime,3719031,35322,0.009497635271123043,3683709,0.990502364728877,2015,2015.csv
4824,Night of 7 Years,3716820,24281,0.006532734972368853,3692539,0.9934672650276312,2018,2018.csv
4825,Thirteen Conversations About One Thing,3706652,3288164,0.8870981144169995,418488,0.1129018855830005,2002,2002.csv
4826,The Last King,3705618,8905,0.0024031079296354886,3696713,0.9975968920703645,2016,2016.csv
4827,A Fantastic Woman,3702353,2020988,0.5458658318102029,1681365,0.4541341681897971,2017,2017.csv
4828,Spare Parts,3701281,3618912,0.9777458128685718,82369,0.02225418713142828,2015,2015.csv
4829,Crush,3695710,1084935,0.29356605361351407,2610775,0.7064339463864859,2002,2002.csv
4830,Western Stars,3681681,1581681,0.4296083772602787,2100000,0.5703916227397213,2019,2019.csv
4831,Inspector Bellamy,3681654,107612,0.029229254025500494,3574042,0.9707707459744995,2009,2009.csv
4832,1911,3680151,135739,0.03688408437588566,3544412,0.9631159156241144,2011,2011.csv
4833,Gosnell: The Trial of America's Biggest Serial Killer,3679893,3679893,1.0,0,0.0,2018,2018.csv
4834,5 Flights Up,3679847,1020921,0.2774357194742064,2658926,0.7225642805257936,2015,2015.csv
4835,Crossing Over,3676533,455654,0.12393578406612969,3220879,0.8760642159338703,2009,2009.csv
4836,The Fall,3669465,2266905,0.6177753432721119,1402560,0.38222465672788813,2008,2008.csv
4837,Love Crime,3663918,539792,0.1473264412576919,3124126,0.8526735587423081,2010,2010.csv
4838,Ju-on: The Grudge,3657876,325680,0.08903527620947238,3332196,0.9109647237905276,2003,2003.csv
4839,"Lucía, Lucía",3653588,269586,0.07378664479957783,3384002,0.9262133552004221,2003,2003.csv
4840,Nicholas Nickleby,3651462,1587173,0.4346678125090717,2064289,0.5653321874909283,2002,2002.csv
4841,Number One Fan,3650598,15549,0.004259302174602627,3635049,0.9957406978253974,2014,2014.csv
4842,BloodRayne,3650275,2405420,0.6589695296929683,1244855,0.34103047030703165,2006,2006.csv
4843,Non-Fiction,3649042,704919,0.19317919607392844,2944123,0.8068208039260716,2018,2018.csv
4844,The Cat's Meow,3646994,3209481,0.8800346257767356,437513,0.11996537422326442,2002,2002.csv
4845,A la mala,3646627,3629842,0.9953971162940438,16785,0.0046028837059562165,2015,2015.csv
4846,Hedwig and the Angry Inch,3644200,3067312,0.8416969430876461,576888,0.15830305691235388,2001,2001.csv
4847,Celeste & Jesse Forever,3640975,3094813,0.84999567423561,546162,0.15000432576439005,2012,2012.csv
4848,Bhoot,3640472,106774,0.029329713289925043,3533698,0.9706702867100749,2003,2003.csv
4849,The German Doctor,3635718,418392,0.11507823214011648,3217326,0.8849217678598835,2013,2013.csv
4850,Sweet Sixteen,3633509,316319,0.08705606618835952,3317190,0.9129439338116405,2002,2002.csv
4851,Crooked House,3625952,0,0.0,3625952,1.0,2017,2017.csv
4852,Colonia,3621046,15709,0.004338249224119219,3605337,0.9956617507758808,2016,2016.csv
4853,The Last Circus,3604598,40548,0.011248965904103592,3564050,0.9887510340958964,2010,2010.csv
4854,Everything Is Illuminated,3601974,1712337,0.4753884953084059,1889637,0.5246115046915941,2005,2005.csv
4855,The Insult,3601603,1001305,0.2780164832159458,2600298,0.7219835167840543,2017,2017.csv
4856,Phoenix Forgotten,3600146,3600146,1.0,0,0.0,2017,2017.csv
4857,Heart Blackened,3593480,37047,0.010309504992375079,3556433,0.989690495007625,2017,2017.csv
4858,Badla,3590894,1861000,0.5182553425414396,1729894,0.48174465745856043,2019,2019.csv
4859,Indivisible,3589633,3511417,0.9782105858732634,78216,0.02178941412673663,2018,2018.csv
4860,Agneepath,3582446,1986748,0.5545786314713467,1595698,0.4454213685286533,2012,2012.csv
4861,Ghostbusters 30th Anniversary Release,3580343,3580343,1.0,0,0.0,2014,2014.csv
4862,Lemming,3580017,81698,0.022820562025264127,3498319,0.9771794379747358,2005,2005.csv
4863,Paradise Now,3579902,1457843,0.40722986271691236,2122059,0.5927701372830876,2005,2005.csv
4864,Factory Girl,3572632,1675241,0.46890947626287843,1897391,0.5310905237371215,2006,2006.csv
4865,The Apparition,3562793,28293,0.007941241604550137,3534500,0.9920587583954499,2018,2018.csv
4866,2 States,3558887,2238174,0.6288971804949132,1320713,0.37110281950508683,2014,2014.csv
4867,Les Boys III,3557100,3557100,1.0,0,0.0,2001,2001.csv
4868,Price of Glory,3548556,3440228,0.9694726531017124,108328,0.030527346898287643,2000,2000.csv
4869,The Oscar Nominated Short Films 2019: Documentary,3538550,3531094,0.9978929222421613,7456,0.0021070777578386627,2019,2019.csv
4870,Bacurau,3537287,58115,0.016429257789939013,3479172,0.983570742210061,2019,2019.csv
4871,The Midnight Meat Train,3534313,83361,0.023586196242381476,3450952,0.9764138037576185,2008,2008.csv
4872,Catfish,3533711,3237343,0.9161312286149037,296368,0.0838687713850963,2010,2010.csv
4873,Ek Ladki Ko Dekha Toh Aisa Laga,3531837,1182636,0.33485010774846063,2349201,0.6651498922515393,2019,2019.csv
4874,Born Into Brothels: Calcutta's Red Light Kids,3529201,3515061,0.9959934274075067,14140,0.004006572592493315,2004,2004.csv
4875,Ten Stories,3526678,219071,0.06211823137808442,3307607,0.9378817686219156,2007,2007.csv
4876,Sidewalks of New York,3520373,2402652,0.6824992692535706,1117721,0.3175007307464294,2001,2001.csv
4877,The Riot Club,3517925,7734,0.0021984550551816767,3510191,0.9978015449448183,2014,2014.csv
4878,The Oscar Nominated Short Films 2018: Live Action,3511123,3508777,0.9993318377054863,2346,0.0006681622945137496,2018,2018.csv
4879,Still Walking,3511120,167047,0.047576556768210716,3344073,0.9524234432317893,2008,2008.csv
4880,Head in the Clouds,3510605,398278,0.11344996090417464,3112327,0.8865500390958254,2004,2004.csv
4881,Lovewrecked,3505963,0,0.0,3505963,1.0,2006,2006.csv
4882,Ladrones,3504414,3063505,0.8741846711033571,440909,0.12581532889664293,2015,2015.csv
4883,Military Wives,3500918,0,0.0,3500918,1.0,2020,2020.csv
4884,Thanks for Sharing,3499442,1065881,0.3045859882804173,2433561,0.6954140117195827,2013,2013.csv
4885,Faustina: Love and Mercy,3498887,2243180,0.6411124451861406,1255707,0.35888755481385937,2019,2019.csv
4886,Maiden,3495241,3168978,0.9066550775754805,326263,0.09334492242451951,2019,2019.csv
4887,Wild Target,3494154,108589,0.031077336602794266,3385565,0.9689226633972058,2010,2010.csv
4888,Where the Truth Lies,3487678,872142,0.2500637960270415,2615536,0.7499362039729585,2005,2005.csv
4889,Veronica Mars: The Movie,3485383,3322127,0.9531598105574051,163256,0.04684018944259497,2014,2014.csv
4890,3,3484446,59954,0.01720617854316009,3424492,0.9827938214568399,2010,2010.csv
4891,Jack and the Cuckoo-Clock Heart,3484370,0,0.0,3484370,1.0,2014,2014.csv
4892,Miles Ahead,3473958,2610896,0.7515623389804943,863062,0.2484376610195057,2016,2016.csv
4893,Great Performances at the Met: Puccini: Tosca,3473616,2023749,0.5826058493512236,1449867,0.4173941506487764,2018,2018.csv
4894,The Aeronauts,3472708,0,0.0,3472708,1.0,2019,2019.csv
4895,The Method,3470651,7017,0.002021810893691126,3463634,0.9979781891063089,2005,2005.csv
4896,Hors la loi,3470487,96933,0.027930662180840903,3373554,0.972069337819159,2010,2010.csv
4897,Enemy,3468224,1008726,0.2908479959771918,2459498,0.7091520040228082,2014,2014.csv
4898,The Long Weekend,3467374,1286,0.00037088586348054753,3466088,0.9996291141365194,2005,2005.csv
4899,Til Death Do Us Part,3455267,3455267,1.0,0,0.0,2017,2017.csv
4900,Obsession,3454709,528799,0.1530661482631388,2925910,0.8469338517368612,2016,2016.csv
4901,Separate Lies,3452023,924260,0.2677444501383681,2527763,0.7322555498616319,2005,2005.csv
4902,Racetime,3439053,1875283,0.5452905203845361,1563770,0.45470947961546393,2018,2018.csv
4903,Words and Pictures,3438874,2171257,0.63138602926423,1267617,0.3686139707357699,2014,2014.csv
4904,Full Frontal,3438804,2512846,0.7307325453849652,925958,0.26926745461503476,2002,2002.csv
4905,A Gentleman,3438746,410055,0.11924550402966663,3028691,0.8807544959703334,2017,2017.csv
4906,The Ultimate Gift,3438735,3438735,1.0,0,0.0,2007,2007.csv
4907,The Rider,3434963,2419031,0.7042378622418931,1015932,0.29576213775810684,2018,2018.csv
4908,2001: A Space Odyssey 2001 Re-release,3434270,239621,0.06977348898019084,3194649,0.9302265110198091,2001,2001.csv
4909,He Named Me Malala,3433606,2668936,0.7772982689335934,764670,0.22270173106640656,2015,2015.csv
4910,Borg vs. McEnroe,3430165,231346,0.06744456899303677,3198819,0.9325554310069633,2017,2017.csv
4911,Disconnect,3428048,1436900,0.41915982506662686,1991148,0.5808401749333731,2013,2013.csv
4912,Special Forces,3424648,10759,0.0031416367463167017,3413889,0.9968583632536833,2011,2011.csv
4913,Next Time I'll Aim for the Heart,3418213,815,0.00023842867603627977,3417398,0.9997615713239637,2014,2014.csv
4914,The Cave of the Yellow Dog,3417511,141803,0.04149306322642414,3275708,0.9585069367735759,2005,2005.csv
4915,Days of Darkness,3414681,1491525,0.4367977565107839,1923156,0.5632022434892161,2007,2007.csv
4916,Midnight Diner,3412771,18555,0.005436930869372718,3394216,0.9945630691306273,2019,2019.csv
4917,3-Iron,3403957,241914,0.07106846531845144,3162043,0.9289315346815485,2004,2004.csv
4918,Friends 25th: The One With The Anniversary,3403406,2884827,0.8476294041909781,518579,0.1523705958090219,2019,2019.csv
4919,Honey Boy,3400977,3012615,0.8858086955601288,388362,0.11419130443987124,2019,2019.csv
4920,The Protector 2,3399790,2463,0.000724456510549181,3397327,0.9992755434894508,2013,2013.csv
4921,Junebug,3399228,2678691,0.7880292231059522,720537,0.2119707768940477,2005,2005.csv
4922,The Good Lie,3396345,2722209,0.8015113305627078,674136,0.19848866943729215,2014,2014.csv
4923,Rock the Kasbah,3394174,3020664,0.889955553250953,373510,0.11004444674904704,2015,2015.csv
4924,"All's Well, Ends Well 2012",3390232,47919,0.014134430918002072,3342313,0.985865569081998,2012,2012.csv
4925,Gauguin: Voyage to Tahiti,3389322,200140,0.059050158114218716,3189182,0.9409498418857812,2017,2017.csv
4926,Anything for Alice,3387582,1092,0.00032235382051268427,3386490,0.9996776461794873,2014,2014.csv
4927,Apartment 1303 3D,3377891,0,0.0,3377891,1.0,2012,2012.csv
4928,The Neon Demon,3377430,1333124,0.39471550853755666,2044306,0.6052844914624433,2016,2016.csv
4929,Red Satin,3375341,231879,0.06869794785178741,3143462,0.9313020521482126,2002,2002.csv
4930,The King's Speech PG-13 Version,3375215,3344306,0.9908423611532895,30909,0.009157638846710506,2011,2011.csv
4931,The Hole in the Ground,3373474,21072,0.006246379844634937,3352402,0.9937536201553651,2019,2019.csv
4932,Bunty Aur Babli,3370142,942756,0.2797377677261077,2427386,0.7202622322738923,2005,2005.csv
4933,Sunshine State,3369654,3065921,0.9098622588550634,303733,0.09013774114493654,2002,2002.csv
4934,Patrick the Pug,3369468,6290,0.0018667635365582935,3363178,0.9981332364634417,2018,2018.csv
4935,Is Anybody There?,3368300,2026756,0.6017148116260428,1341544,0.3982851883739572,2009,2009.csv
4936,We Don't Live Here Anymore,3361213,2041014,0.6072254272490318,1320199,0.39277457275096817,2004,2004.csv
4937,Ten Canoes,3360030,283654,0.08442007958262278,3076376,0.9155799204173772,2006,2006.csv
4938,Echo in the Canyon,3355324,3355324,1.0,0,0.0,2019,2019.csv
4939,Reality,3350996,72577,0.021658336804937995,3278419,0.978341663195062,2012,2012.csv
4940,Boynton Beach Club,3350115,3127472,0.9335416843899389,222643,0.06645831561006114,2006,2006.csv
4941,Panipat,3349899,461863,0.13787370902824234,2888036,0.8621262909717576,2019,2019.csv
4942,The Work and the Glory,3347647,3347647,1.0,0,0.0,2004,2004.csv
4943,Supercross,3344431,3102550,0.9276764866729198,241881,0.07232351332708015,2005,2005.csv
4944,Mistress America,3340737,2500431,0.7484668802123603,840306,0.25153311978763965,2015,2015.csv
4945,No News from God,3340382,77858,0.023308112664958677,3262524,0.9766918873350413,2002,2002.csv
4946,Machine Gun Preacher,3338690,538690,0.16134771422324326,2800000,0.8386522857767568,2011,2011.csv
4947,Unknown,3338228,26403,0.007909286004431094,3311825,0.9920907139955689,2006,2006.csv
4948,Atlas Shrugged II: The Strike,3336053,3336053,1.0,0,0.0,2012,2012.csv
4949,On Chesil Beach,3335913,745971,0.22361824184263798,2589942,0.776381758157362,2018,2018.csv
4950,The Program,3335613,13074,0.003919519440654536,3322539,0.9960804805593455,2015,2015.csv
4951,By the Sea,3334927,538460,0.16146080558884798,2796467,0.838539194411152,2015,2015.csv
4952,Everlasting Moments,3334754,610825,0.18316943318757545,2723929,0.8168305668124245,2008,2008.csv
4953,Raiders of the Lost Ark 2012 IMAX Release,3332854,3125613,0.9378187583374489,207241,0.062181241662551075,2012,2012.csv
4954,Last Ounce of Courage,3329674,3329674,1.0,0,0.0,2012,2012.csv
4955,Vanishing Time: A Boy Who Returned,3328517,57759,0.017352773021739112,3270758,0.9826472269782609,2016,2016.csv
4956,The Death & Life of John F. Donovan,3326364,152713,0.04590988839465555,3173651,0.9540901116053444,2019,2019.csv
4957,Obvious Child,3325417,3123963,0.9394199283879285,201454,0.06058007161207151,2014,2014.csv
4958,Flying Swords of Dragon Gate,3323381,170276,0.051235774652379606,3153105,0.9487642253476204,2011,2011.csv
4959,Breath,3322479,37108,0.01116876886204548,3285371,0.9888312311379546,2018,2018.csv
4960,Wildlife,3321367,1050616,0.31632035845481693,2270751,0.683679641545183,2018,2018.csv
4961,Pootie Tang,3313583,3313583,1.0,0,0.0,2001,2001.csv
4962,Chhichhore,3307350,2004400,0.6060441138675979,1302950,0.39395588613240207,2019,2019.csv
4963,Art School Confidential,3306629,3297137,0.9971294027845277,9492,0.0028705972154723135,2006,2006.csv
4964,2020 Oscar Nominated Short Films,3306611,3306611,1.0,0,0.0,2020,2020.csv
4965,Heist,3294317,50136,0.015218936125454836,3244181,0.9847810638745451,2015,2015.csv
4966,Heading South,3294052,898468,0.2727546498962372,2395584,0.7272453501037628,2006,2006.csv
4967,Bluff Master,3289047,722847,0.21977399532448152,2566200,0.7802260046755185,2005,2005.csv
4968,Wonderstruck,3285916,1060377,0.32270362358623894,2225539,0.6772963764137611,2017,2017.csv
4969,Good Time,3283369,2026499,0.6172011126376596,1256870,0.3827988873623403,2017,2017.csv
4970,Bharath Ane Nenu,3276257,2663090,0.8128452682436085,613167,0.18715473175639152,2018,2018.csv
4971,Pieces of April,3272028,2528664,0.7728124575951062,743364,0.22718754240489383,2003,2003.csv
4972,Marianne & Leonard: Words of Love,3271888,1012034,0.30931193243778515,2259854,0.6906880675622148,2019,2019.csv
4973,Skinwalkers,3269736,1018965,0.3116352512863424,2250771,0.6883647487136576,2007,2007.csv
4974,Chicken With Plums,3265941,253874,0.077733798620367,3012067,0.922266201379633,2011,2011.csv
4975,Peaceful Warrior 2007 Re-release,3260179,2893666,0.8875788722030293,366513,0.11242112779697065,2007,2007.csv
4976,"Patrik, Age 1.5",3259068,57468,0.017633262024603354,3201600,0.9823667379753966,2008,2008.csv
4977,The Last Full Measure,3257485,2949212,0.905364721556661,308273,0.09463527844333895,2020,2020.csv
4978,Clifford's Really Big Movie,3255426,2922354,0.8976871229756106,333072,0.10231287702438943,2004,2004.csv
4979,Bilal: A New Breed of Hero,3254027,0,0.0,3254027,1.0,2016,2016.csv
4980,The Boys Are Back,3252136,809752,0.2489908171121995,2442384,0.7510091828878005,2009,2009.csv
4981,Little Fish,3248506,8148,0.0025082299370849247,3240358,0.9974917700629151,2005,2005.csv
4982,Queens,3245067,140417,0.04327090935256499,3104650,0.956729090647435,2005,2005.csv
4983,Resurrecting the Champ,3243064,3172573,0.978264073727808,70491,0.021735926272191976,2007,2007.csv
4984,Your Sister's Sister,3242802,1636190,0.5045605621311446,1606612,0.4954394378688554,2012,2012.csv
4985,In Harmony,3242445,3144,0.0009696386523133006,3239301,0.9990303613476867,2015,2015.csv
4986,The Front Runner,3242235,2000105,0.616890817599588,1242130,0.3831091824004121,2018,2018.csv
4987,Pathology,3234706,109846,0.033958573051152095,3124860,0.9660414269488479,2008,2008.csv
4988,Sleeping with Other People,3224947,819431,0.25409130754706977,2405516,0.7459086924529302,2015,2015.csv
4989,The Final Cut,3222439,551281,0.1710756976315145,2671158,0.8289243023684855,2004,2004.csv
4990,Love is in the Air 2013 Re-release,3221554,8425,0.0026151975102698885,3213129,0.9973848024897302,2013,2013.csv
4991,Gun Shy,3221280,1638202,0.5085562260964586,1583078,0.49144377390354144,2000,2000.csv
4992,The Wild Parrots of Telegraph Hill,3218709,3058527,0.950234084535135,160182,0.04976591546486495,2005,2005.csv
4993,Embrace of the Serpent,3217176,1329249,0.41317260852374876,1887927,0.5868273914762512,2015,2015.csv
4994,The Mystery of Happiness,3216374,8528,0.0026514329490289375,3207846,0.9973485670509711,2014,2014.csv
4995,Riding Giants,3216111,2276368,0.7078014409328534,939743,0.29219855906714665,2004,2004.csv
4996,6 Souls,3205167,0,0.0,3205167,1.0,2010,2010.csv
4997,Saint Laurent,3202241,429477,0.13411763824146902,2772764,0.865882361758531,2014,2014.csv
4998,Lady Chatterley,3200383,687414,0.2147911671821779,2512969,0.7852088328178222,2006,2006.csv
4999,Tadpole,3200241,2891288,0.9034594582095536,308953,0.09654054179044641,2002,2002.csv
5000,I,3200113,1449232,0.4528690080631528,1750881,0.5471309919368472,2015,2015.csv
5001,Dear Zindagi,3199581,2376479,0.7427469409275778,823102,0.2572530590724223,2016,2016.csv
5002,Fill the Void,3197615,1775316,0.5552000475354287,1422299,0.44479995246457127,2012,2012.csv
5003,Victoria,3191971,0,0.0,3191971,1.0,2015,2015.csv
5004,Empire of Lust,3191168,10654,0.003338589507039429,3180514,0.9966614104929605,2015,2015.csv
5005,Machuca,3187700,26676,0.008368416099382,3161024,0.991631583900618,2004,2004.csv
5006,Thoroughbreds,3187255,3072605,0.9640286076890616,114650,0.03597139231093841,2018,2018.csv
5007,Showtime Championship Boxing: Floyd Mayweather vs. Conor McGregor,3184384,2620183,0.822822561600611,564201,0.17717743839938901,2017,2017.csv
5008,Strayed,3184020,482757,0.15161870842519834,2701263,0.8483812915748017,2003,2003.csv
5009,Madame 2017 Re-release,3182153,90979,0.028590391473948613,3091174,0.9714096085260514,2017,2017.csv
5010,Tea With the Dames,3181152,889343,0.2795663332025631,2291809,0.7204336667974369,2018,2018.csv
5011,Pastorela,3179022,161194,0.05070553144960935,3017828,0.9492944685503907,2011,2011.csv
5012,Chocolate,3179014,14845,0.004669686890337696,3164169,0.9953303131096624,2008,2008.csv
5013,Wordplay,3177636,3121270,0.9822616561494142,56366,0.017738343850585783,2006,2006.csv
5014,Waking Life,3176880,2901447,0.9133007856765128,275433,0.08669921432348719,2001,2001.csv
5015,The Wackness,3175469,2077116,0.6541131404526387,1098353,0.34588685954736137,2008,2008.csv
5016,Pilgrim's Progress,3173282,1294596,0.4079675238443983,1878686,0.5920324761556017,2019,2019.csv
5017,Rosewater,3171593,3128941,0.9865518684143899,42652,0.013448131585610134,2014,2014.csv
5018,Songcatcher,3171273,3059834,0.9648598528098968,111439,0.03514014719010315,2001,2001.csv
5019,Beautiful,3169930,3157348,0.996030827179149,12582,0.003969172820850933,2000,2000.csv
5020,Land of Mine,3169553,435266,0.1373272508773319,2734287,0.8626727491226681,2015,2015.csv
5021,My One and Only,3167681,2479538,0.7827612692060848,688143,0.21723873079391517,2009,2009.csv
5022,Race 2,3164441,1579940,0.4992793355919734,1584501,0.5007206644080265,2013,2013.csv
5023,The Bridesmaid,3162662,111728,0.03532720221130174,3050934,0.9646727977886983,2004,2004.csv
5024,The Lodge,3154127,2138907,0.6781296377729876,1015220,0.32187036222701243,2020,2020.csv
5025,Ingrid Goes West,3146831,3024308,0.9610646393149171,122523,0.03893536068508287,2017,2017.csv
5026,Them,3144202,50057,0.015920414782510793,3094145,0.9840795852174892,2006,2006.csv
5027,Genesis,3139313,16413,0.005228213943623971,3122900,0.9947717860563761,2004,2004.csv
5028,Munna Bhai M.B.B.S.,3137716,48772,0.015543790451398407,3088944,0.9844562095486016,2003,2003.csv
5029,Mother of Tears,3119957,58669,0.01880442583022779,3061288,0.9811955741697722,2007,2007.csv
5030,The Deep Blue Sea,3115609,1126525,0.3615745749867843,1989084,0.6384254250132158,2011,2011.csv
5031,In a World...,3114953,2963902,0.9515077755587323,151051,0.048492224441267655,2013,2013.csv
5032,The Boss of It All,3111395,51548,0.016567488216700225,3059847,0.9834325117832998,2006,2006.csv
5033,Illegal Tender,3106835,3106835,1.0,0,0.0,2007,2007.csv
5034,Close Encounters of the Third Kind 2017 Re-release,3101507,3100479,0.9996685482251048,1028,0.00033145177489523643,2017,2017.csv
5035,Come Undone,3101465,10035,0.003235567707518866,3091430,0.9967644322924811,2010,2010.csv
5036,Raw,3096815,514870,0.16625791337228735,2581945,0.8337420866277127,2017,2017.csv
5037,Paid in Full,3090862,3090862,1.0,0,0.0,2002,2002.csv
5038,Nomad: The Warrior,3088685,79123,0.02561705062186659,3009562,0.9743829493781334,2006,2006.csv
5039,Aquarius,3085977,285930,0.09265461148932737,2800047,0.9073453885106726,2016,2016.csv
5040,The People Vs. Fritz Bauer,3083973,288483,0.09354264774691608,2795490,0.9064573522530839,2015,2015.csv
5041,Mumbai Diaries,3082958,576639,0.1870408224828233,2506319,0.8129591775171767,2011,2011.csv
5042,Incantato,3082196,108954,0.03534947161050109,2973242,0.9646505283894989,2003,2003.csv
5043,Provoked: A True Story,3078709,761740,0.24742189014941002,2316969,0.7525781098505899,2007,2007.csv
5044,3 Hearts,3077754,161129,0.052352787129835585,2916625,0.9476472128701644,2014,2014.csv
5045,Ismael's Ghosts,3075562,102510,0.03333049374390762,2973052,0.9666695062560924,2017,2017.csv
5046,Living Is Easy with Eyes Closed,3075169,11600,0.003772150408644208,3063569,0.9962278495913558,2013,2013.csv
5047,The End of the Tour,3072991,3002884,0.9771860705091554,70107,0.022813929490844587,2015,2015.csv
5048,Jane Got a Gun,3067531,1513793,0.49348906335420895,1553738,0.506510936645791,2015,2015.csv
5049,English Vinglish,3064818,1862086,0.6075682144910399,1202732,0.3924317855089601,2012,2012.csv
5050,'71,3062178,1270847,0.4150140847462166,1791331,0.5849859152537834,2014,2014.csv
5051,Remember,3054936,547009,0.1790574336090838,2507927,0.8209425663909162,2015,2015.csv
5052,Mambo Italiano,3047296,3047296,1.0,0,0.0,2003,2003.csv
5053,La moustache,3044771,244771,0.08039061065676203,2800000,0.919609389343238,2005,2005.csv
5054,The Witnesses,3041093,78440,0.02579335784864192,2962653,0.9742066421513581,2007,2007.csv
5055,The Mother,3039587,1063163,0.349772189445474,1976424,0.6502278105545259,2003,2003.csv
5056,Adam,3035915,2277396,0.7501514370461624,758519,0.24984856295383764,2009,2009.csv
5057,Harrison's Flowers,3033646,1871025,0.6167578550694445,1162621,0.38324214493055553,2002,2002.csv
5058,Innocence,3026796,2202382,0.7276281586205348,824414,0.2723718413794653,2001,2001.csv
5059,Starred Up,3025189,54915,0.018152584846764946,2970274,0.981847415153235,2014,2014.csv
5060,G,3020784,3020784,1.0,0,0.0,2005,2005.csv
5061,The Greatest Miracle,3019382,555166,0.18386742717549484,2464216,0.8161325728245051,2011,2011.csv
5062,All Is True,3019143,1200481,0.3976231003301268,1818662,0.6023768996698732,2019,2019.csv
5063,Top Gun 2013 3D Release,3018873,3018873,1.0,0,0.0,2013,2013.csv
5064,Rigor Mortis,3016904,7865,0.0026069772190298397,3009039,0.9973930227809702,2013,2013.csv
5065,Cowboy Bebop: The Movie,3007903,1000045,0.3324724899705875,2007858,0.6675275100294125,2003,2003.csv
5066,The Second Mother,3003560,376986,0.1255130578380322,2626574,0.8744869421619678,2015,2015.csv
5067,Isn't She Great,3003296,2962465,0.9864046034756481,40831,0.013595396524351912,2000,2000.csv
5068,The Imposter,3001877,898317,0.2992517681437314,2103560,0.7007482318562686,2012,2012.csv
5069,Made for More,2999134,2999134,1.0,0,0.0,2018,2018.csv
5070,Incredible Love,2998940,1445739,0.4820833361120929,1553201,0.517916663887907,2009,2009.csv
5071,Pinocchio Italian Version,2995810,8586,0.002866002850648072,2987224,0.9971339971493519,2003,2003.csv
5072,Samoan Wedding,2993332,72244,0.024134977342974318,2921088,0.9758650226570257,2006,2006.csv
5073,The Corporation 2004 Re-release,2992149,1879983,0.6283052749044249,1112166,0.3716947250955751,2004,2004.csv
5074,Elsa & Fred,2985837,189024,0.06330687174149158,2796813,0.9366931282585084,2005,2005.csv
5075,The Last Word,2982004,1783421,0.5980612366717147,1198583,0.40193876332828526,2017,2017.csv
5076,Darwin's Nightmare,2981713,203746,0.06833186158426381,2777967,0.9316681384157361,2005,2005.csv
5077,Memoir of War,2980982,103636,0.034765724851743486,2877346,0.9652342751482565,2018,2018.csv
5078,Love Is Strange 2014 Re-release,2979739,2262223,0.759201728742014,717516,0.24079827125798603,2014,2014.csv
5079,Clean,2971219,138711,0.046684879169122166,2832508,0.9533151208308779,2004,2004.csv
5080,Love Songs,2966934,104567,0.035244127439302664,2862367,0.9647558725606974,2007,2007.csv
5081,Romeo and Juliet,2966268,1162635,0.39195210951943654,1803633,0.6080478904805634,2013,2013.csv
5082,Donnie Darko,2962988,517375,0.17461258702363966,2445613,0.8253874129763603,2001,2001.csv
5083,Killshot,2961647,18643,0.006294808260403755,2943004,0.9937051917395963,2008,2008.csv
5084,The Last: Naruto the Movie,2949185,524451,0.17782912906447035,2424734,0.8221708709355297,2015,2015.csv
5085,Turtle: The Incredible Journey,2945067,386073,0.13109141489820095,2558994,0.868908585101799,2009,2009.csv
5086,Shattered Glass,2944752,2220008,0.7538862355811288,724744,0.24611376441887126,2003,2003.csv
5087,Fearless,2942554,1288549,0.4379015644232867,1654005,0.5620984355767132,2010,2010.csv
5088,Filly Brown,2940411,2850357,0.9693736691911436,90054,0.030626330808856312,2013,2013.csv
5089,Shall We Kiss?,2936437,535499,0.18236352423021504,2400938,0.8176364757697849,2007,2007.csv
5090,Romance & Cigarettes,2935242,557471,0.1899233521460922,2377771,0.8100766478539078,2006,2006.csv
5091,Joan Rivers: A Piece of Work,2930687,2930687,1.0,0,0.0,2010,2010.csv
5092,The Lord of the Rings: The Fellowship of the Ring 2003 Extended Edition,2928554,1412056,0.48216833290422506,1516498,0.5178316670957749,2003,2003.csv
5093,Kites,2924751,1643486,0.5619233910852582,1281265,0.4380766089147418,2010,2010.csv
5094,My Architect,2920081,2750707,0.9419968144719273,169374,0.05800318552807268,2003,2003.csv
5095,Sylvia,2917393,1315498,0.45091559484786586,1601895,0.5490844051521341,2003,2003.csv
5096,Brighton Rock,2913599,229653,0.07882107318131287,2683946,0.9211789268186872,2011,2011.csv
5097,Letters to God,2908893,2848578,0.9792653081429946,60315,0.020734691857005397,2010,2010.csv
5098,Bright Young Things,2905499,933637,0.3213344764530981,1971862,0.6786655235469019,2003,2003.csv
5099,Margot at the Wedding,2900156,1959420,0.6756257249610021,940736,0.3243742750389979,2007,2007.csv
5100,Time to Leave,2893462,117686,0.040673076059060044,2775776,0.95932692394094,2005,2005.csv
5101,The East,2891812,2301839,0.7959850087073433,589973,0.20401499129265666,2013,2013.csv
5102,Married Life,2888315,1507990,0.5221002556854083,1380325,0.4778997443145917,2008,2008.csv
5103,The Oscar Nominated Short Films 2017: Live Action,2877797,2835355,0.9852519131822015,42442,0.014748086817798475,2017,2017.csv
5104,Tetro,2874474,518522,0.18038848151000844,2355952,0.8196115184899916,2009,2009.csv
5105,Starbuck,2865068,340058,0.11869107469700545,2525010,0.8813089253029945,2011,2011.csv
5106,Home Run,2861020,2861020,1.0,0,0.0,2013,2013.csv
5107,The Private Lives of Pippa Lee,2860973,337356,0.11791652699973051,2523617,0.8820834730002695,2009,2009.csv
5108,And Now Ladies & Gentlemen,2860785,736872,0.25757685390548396,2123913,0.742423146094516,2002,2002.csv
5109,The Flowers of War,2855644,311434,0.10905911241037047,2544210,0.8909408875896295,2012,2012.csv
5110,Inhumans,2852282,1521787,0.5335331499480065,1330495,0.46646685005199345,2017,2017.csv
5111,Rise: Blood Hunter,2850927,114306,0.04009432721356948,2736621,0.9599056727864305,2007,2007.csv
5112,The Salt of Life,2850852,317405,0.1113368915678541,2533447,0.8886631084321459,2011,2011.csv
5113,The Oscar Nominated Short Films 2016: Live Action,2850840,2816816,0.9880652719900099,34024,0.011934728009990039,2016,2016.csv
5114,God Bless the Broken Road,2848233,2846257,0.9993062365333173,1976,0.0006937634666826766,2018,2018.csv
5115,The Double Hour,2848165,1514942,0.5319010661250314,1333223,0.4680989338749686,2009,2009.csv
5116,Wah-Wah,2846148,234750,0.08247989914790095,2611398,0.917520100852099,2006,2006.csv
5117,All or Nothing,2845696,201546,0.07082485268981648,2644150,0.9291751473101835,2002,2002.csv
5118,Remember You,2845124,14814,0.005206802937235776,2830310,0.9947931970627643,2016,2016.csv
5119,"Moscow, Belgium",2842635,0,0.0,2842635,1.0,2008,2008.csv
5120,A Breath Away,2842040,77987,0.027440500485566705,2764053,0.9725594995144333,2018,2018.csv
5121,The Identical,2840991,2827666,0.9953097352297139,13325,0.0046902647702861434,2014,2014.csv
5122,Personal Shopper,2840408,1305195,0.4595096901571887,1535213,0.5404903098428113,2016,2016.csv
5123,Terribly Happy,2828984,170943,0.06042558034969445,2658041,0.9395744196503055,2008,2008.csv
5124,The Fluffy Movie: Unity Through Laughter,2827393,2827393,1.0,0,0.0,2014,2014.csv
5125,A Coffee in Berlin,2826333,150275,0.05316960174190373,2676058,0.9468303982580962,2012,2012.csv
5126,Everything Must Go,2820490,2711643,0.9614084786686001,108847,0.03859152133139986,2011,2011.csv
5127,Raising Victor Vargas,2816116,2078661,0.7381304605350064,737455,0.26186953946499364,2003,2003.csv
5128,SamSam,2809390,0,0.0,2809390,1.0,2020,2020.csv
5129,Captive,2801508,2583301,0.9221108774274427,218207,0.07788912257255735,2015,2015.csv
5130,To the Wonder,2801166,587615,0.20977514363661418,2213551,0.7902248563633858,2013,2013.csv
5131,"Cinco de Mayo, La Batalla",2794852,173472,0.06206840290648664,2621380,0.9379315970935134,2013,2013.csv
5132,After the Wedding,2790019,1574258,0.564246336673693,1215761,0.4357536633263071,2019,2019.csv
5133,Children of the Sea,2789668,0,0.0,2789668,1.0,2019,2019.csv
5134,Bon voyage 2004 Re-release,2788330,2354559,0.8444334063758594,433771,0.1555665936241406,2004,2004.csv
5135,Kirk Cameron's Saving Christmas,2783970,2783970,1.0,0,0.0,2014,2014.csv
5136,24 Hour Party People,2781211,1184096,0.4257483520667795,1597115,0.5742516479332205,2002,2002.csv
5137,"My Daughter, My Angel",2780005,2779545,0.9998345326717039,460,0.00016546732829617213,2007,2007.csv
5138,Gabrielle,2775311,332829,0.11992493814206769,2442482,0.8800750618579323,2005,2005.csv
5139,The Wonders,2772358,73378,0.026467721701165577,2698980,0.9735322782988344,2014,2014.csv
5140,Every Little Step,2769763,1725141,0.6228478754319413,1044622,0.3771521245680587,2008,2008.csv
5141,My Summer of Love,2766976,1000915,0.3617360613174816,1766061,0.6382639386825184,2004,2004.csv
5142,When Did You Last See Your Father?,2752471,1077273,0.3913839600853197,1675198,0.6086160399146803,2007,2007.csv
5143,Comedian,2751988,2751988,1.0,0,0.0,2002,2002.csv
5144,Ma vie en cinémascope,2750263,2750263,1.0,0,0.0,2004,2004.csv
5145,Battle for Incheon: Operation Chromite,2749918,1023348,0.37213764192241366,1726570,0.6278623580775863,2016,2016.csv
5146,Ben X,2744414,1601,0.0005833667952429918,2742813,0.999416633204757,2007,2007.csv
5147,Ararat,2743336,1555959,0.5671776989767203,1187377,0.4328223010232797,2002,2002.csv
5148,McQueen,2739246,1257275,0.4589857939009494,1481971,0.5410142060990506,2018,2018.csv
5149,Edie,2731170,71790,0.02628543810894232,2659380,0.9737145618910577,2018,2018.csv
5150,XXY,2728869,48334,0.017712099774668554,2680535,0.9822879002253314,2007,2007.csv
5151,Lucky,2728446,955925,0.35035511056476837,1772521,0.6496448894352316,2017,2017.csv
5152,Sukiyaki Western Django,2725258,50659,0.01858869875806254,2674599,0.9814113012419374,2007,2007.csv
5153,Control Room,2724826,2589616,0.9503784828829437,135210,0.049621517117056285,2004,2004.csv
5154,Cocktail,2724695,1227789,0.4506152064726511,1496906,0.5493847935273489,2012,2012.csv
5155,The Color of Paradise,2724595,1817216,0.6669673841433313,907379,0.3330326158566686,2000,2000.csv
5156,Hunger,2724474,154084,0.05655550392479429,2570390,0.9434444960752058,2008,2008.csv
5157,O Jerusalem,2724303,234480,0.08606972131954485,2489823,0.9139302786804552,2006,2006.csv
5158,Chi-Raq,2719699,2653032,0.9754873609175133,66667,0.0245126390824867,2015,2015.csv
5159,Billionaire Boys Club,2713955,1349,0.0004970605629054277,2712606,0.9995029394370946,2018,2018.csv
5160,What Maisie Knew,2711379,1066471,0.3933315851454186,1644908,0.6066684148545813,2013,2013.csv
5161,Factotum,2708087,808221,0.2984472064597629,1899866,0.701552793540237,2005,2005.csv
5162,Bobby Jones: Stroke of Genius,2707913,2694071,0.9948883143586962,13842,0.005111685641303838,2004,2004.csv
5163,Up and Down,2705163,245127,0.09061450271203621,2460036,0.9093854972879638,2004,2004.csv
5164,Auto Focus,2704951,2063196,0.7627480128105832,641755,0.23725198718941673,2002,2002.csv
5165,The Guest,2700051,332890,0.12329026377649904,2367161,0.876709736223501,2014,2014.csv
5166,Gangsterdam,2697522,954,0.0003536579127065507,2696568,0.9996463420872934,2017,2017.csv
5167,The Best of Youth,2693053,274024,0.10175217494791228,2419029,0.8982478250520878,2003,2003.csv
5168,Jiro Dreams of Sushi,2692864,2552478,0.9478674006559559,140386,0.05213259934404411,2012,2012.csv
5169,Thérèse: The Story of Saint Thérèse of Lisieux,2689828,2627016,0.976648321007886,62812,0.023351678992113992,2004,2004.csv
5170,Infamous,2689799,1151330,0.4280357008088708,1538469,0.5719642991911291,2006,2006.csv
5171,A Hijacking,2688444,414437,0.15415496845015184,2274007,0.8458450315498481,2012,2012.csv
5172,Redbelt,2674090,2345941,0.8772857308467553,328149,0.12271426915324465,2008,2008.csv
5173,Intimacy,2672527,405094,0.1515771402870766,2267433,0.8484228597129234,2001,2001.csv
5174,In Your Name,2663172,0,0.0,2663172,1.0,2003,2003.csv
5175,The Cup,2660645,0,0.0,2660645,1.0,2011,2011.csv
5176,Diego Maradona,2656890,0,0.0,2656890,1.0,2019,2019.csv
5177,Speechless,2655669,73819,0.027796762322412922,2581850,0.9722032376775871,2007,2007.csv
5178,Camp,2650356,1629862,0.6149596507035281,1020494,0.38504034929647185,2003,2003.csv
5179,Hillsong: Let Hope Rise,2649761,2394386,0.9036233833919362,255375,0.0963766166080639,2016,2016.csv
5180,Twelve,2648195,183920,0.06945107894244948,2464275,0.9305489210575505,2010,2010.csv
5181,Pioneer,2647820,6871,0.0025949649145334654,2640949,0.9974050350854665,2013,2013.csv
5182,Stories We Tell,2641053,1600145,0.6058738692483642,1040908,0.39412613075163583,2013,2013.csv
5183,God's Army,2637726,2637726,1.0,0,0.0,2000,2000.csv
5184,Find Me Guilty,2636637,1173643,0.44512877578521426,1462994,0.5548712242147857,2006,2006.csv
5185,Kinky Boots: The Musical,2635571,900451,0.34165309908175495,1735120,0.658346900918245,2019,2019.csv
5186,Imagine Me & You,2635305,672243,0.2550911564316085,1963062,0.7449088435683915,2006,2006.csv
5187,Everyone Else,2634462,102042,0.03873352509924227,2532420,0.9612664749007577,2009,2009.csv
5188,Beautiful Accident,2632092,51766,0.01966724567378344,2580326,0.9803327543262166,2017,2017.csv
5189,Maniac,2631275,31081,0.011812144302666958,2600194,0.988187855697333,2012,2012.csv
5190,Third Person,2624761,1021398,0.3891394302185989,1603363,0.610860569781401,2014,2014.csv
5191,Youth Without Youth,2624759,244397,0.09311216763139016,2380362,0.9068878323686098,2007,2007.csv
5192,Below,2622015,605562,0.23095291216869468,2016453,0.7690470878313053,2002,2002.csv
5193,The Happy Prince,2621992,466440,0.17789527961946489,2155552,0.8221047203805351,2018,2018.csv
5194,Happy End,2610794,301718,0.11556560954253764,2309076,0.8844343904574624,2017,2017.csv
5195,The Little Mermaid,2610742,147175,0.05637286258082951,2463567,0.9436271374191705,2018,2018.csv
5196,Russian Ark Canadian Release,2610711,684034,0.2620106170311459,1926677,0.7379893829688541,2003,2003.csv
5197,Poster Boys,2602256,97049,0.03729417858965452,2505207,0.9627058214103454,2017,2017.csv
5198,The Air I Breathe,2597648,25775,0.009922437528102344,2571873,0.9900775624718977,2007,2007.csv
5199,Zero,2595762,1035388,0.39887632225142367,1560374,0.6011236777485763,2018,2018.csv
5200,N-Secure,2595644,2595644,1.0,0,0.0,2010,2010.csv
5201,The Signal,2595622,600896,0.23150366270589476,1994726,0.7684963372941053,2014,2014.csv
5202,But I'm a Cheerleader,2595216,2205627,0.849881859544639,389589,0.15011814045536095,2000,2000.csv
5203,It's Easier for a Camel...,2590219,16150,0.006234994029462373,2574069,0.9937650059705376,2003,2003.csv
5204,City of Men,2589732,325131,0.12554619551366705,2264601,0.8744538044863329,2007,2007.csv
5205,Leo Da Vinci: Mission Mona Lisa,2588859,19978,0.007716913126593608,2568881,0.9922830868734064,2018,2018.csv
5206,A Question of Faith,2587072,2587072,1.0,0,0.0,2017,2017.csv
5207,Blancanieves,2585522,279735,0.10819285235244566,2305787,0.8918071476475543,2012,2012.csv
5208,Assassination Nation,2584988,2005142,0.7756871598630245,579846,0.2243128401369755,2018,2018.csv
5209,Metallica & San Francisco Symphony - S&M2,2582847,1252385,0.4848854771498273,1330462,0.5151145228501727,2019,2019.csv
5210,The Informer,2579970,0,0.0,2579970,1.0,2019,2019.csv
5211,The Nightmare Before Christmas 2009 3D Release,2578558,1109188,0.43015825123964635,1469370,0.5698417487603537,2008,2008.csv
5212,After Dark's Horror Fest: 8 Films to Die For,2575000,2575000,1.0,0,0.0,2006,2006.csv
5213,The Polar Express 2007 IMAX Release,2574903,2483757,0.9646021617124995,91146,0.03539783828750054,2007,2007.csv
5214,The Gatekeepers,2573616,2415727,0.9386509098482446,157889,0.06134909015175535,2013,2013.csv
5215,Is Genesis History?,2570392,2570392,1.0,0,0.0,2017,2017.csv
5216,Maquia: When the Promised Flower Blooms 2018 Re-release,2569927,18539,0.007213823583315791,2551388,0.9927861764166842,2018,2018.csv
5217,Blood Ties,2566435,42472,0.016549026178336874,2523963,0.9834509738216631,2013,2013.csv
5218,Young Adam,2561820,767373,0.2995421223973581,1794447,0.7004578776026419,2003,2003.csv
5219,God's Own Country,2559939,335609,0.1311003895014686,2224330,0.8688996104985314,2017,2017.csv
5220,Lucky Break,2559317,54606,0.021336161171124954,2504711,0.9786638388288751,2001,2001.csv
5221,Management,2555950,934658,0.36567929732584753,1621292,0.6343207026741524,2009,2009.csv
5222,The Only Living Boy in New York,2550321,624332,0.2448052617690087,1925989,0.7551947382309914,2017,2017.csv
5223,"1,000 Times Good Night",2549568,53895,0.021138875291814144,2495673,0.9788611247081859,2013,2013.csv
5224,Disney's Newsies: The Broadway Musical!,2545060,2545060,1.0,0,0.0,2017,2017.csv
5225,The Dinner,2544921,1323312,0.5199815632783886,1221609,0.4800184367216114,2017,2017.csv
5226,The Man of My Life,2542577,7704,0.003029996731662404,2534873,0.9969700032683376,2006,2006.csv
5227,El Jeremías,2540144,650465,0.25607406509237274,1889679,0.7439259349076273,2016,2016.csv
5228,In the Name of My Daughter,2537899,277528,0.10935344550748473,2260371,0.8906465544925153,2014,2014.csv
5229,Novocaine,2534372,2036682,0.8036239352391835,497690,0.19637606476081648,2001,2001.csv
5230,IN OUR HANDS: Battle for Jerusalem,2534370,2534370,1.0,0,0.0,2017,2017.csv
5231,Poetry,2533089,356149,0.14059869195278965,2176940,0.8594013080472104,2010,2010.csv
5232,Spirits in the Forest,2531785,704744,0.2783585494028916,1827041,0.7216414505971084,2019,2019.csv
5233,Bucky Larson: Born to Be a Star,2530394,2529395,0.9996051998226363,999,0.00039480017736368326,2011,2011.csv
5234,Quinceañera,2522787,1692693,0.6709615199380685,830094,0.3290384800619315,2006,2006.csv
5235,Lonely Hearts,2520835,188565,0.0748025951718379,2332270,0.9251974048281622,2006,2006.csv
5236,Coincidence,2520487,298032,0.11824381558008433,2222455,0.8817561844199157,2017,2017.csv
5237,Restless,2518012,163265,0.06483884906029042,2354747,0.9351611509397095,2011,2011.csv
5238,Birds of Passage,2517405,507259,0.2015007517662037,2010146,0.7984992482337963,2018,2018.csv
5239,Fateless,2512009,196857,0.07836635935619657,2315152,0.9216336406438034,2005,2005.csv
5240,LBJ,2510151,2470979,0.9843945643110713,39172,0.015605435688928674,2017,2017.csv
5241,The Rover,2510007,1114423,0.44399198886696334,1395584,0.5560080111330367,2014,2014.csv
5242,Grace Unplugged,2507201,2507201,1.0,0,0.0,2013,2013.csv
5243,Still Life,2504465,76983,0.030738301393710834,2427482,0.9692616986062892,2006,2006.csv
5244,I'm in Love with a Church Girl,2503392,2387730,0.953797887026882,115662,0.046202112973118076,2013,2013.csv
5245,The Queen of Versailles,2495706,2401999,0.9624527087725878,93707,0.037547291227412204,2012,2012.csv
5246,Still Life,2495025,9481,0.0037999619242292163,2485544,0.9962000380757707,2013,2013.csv
5247,Look Both Ways,2490011,105067,0.04219539592395375,2384944,0.9578046040760463,2005,2005.csv
5248,13B: Fear Has a New Address,2482072,36594,0.014743327349085764,2445478,0.9852566726509142,2009,2009.csv
5249,"One Nation, One King",2481681,6576,0.0026498167975658434,2475105,0.9973501832024342,2018,2018.csv
5250,Cairo Time,2477315,1603616,0.6473201833436604,873699,0.35267981665633963,2010,2010.csv
5251,The Christmas Candle,2476775,2258620,0.9119197343319437,218155,0.08808026566805624,2013,2013.csv
5252,Tuya's Marriage,2476766,88148,0.035589958841489265,2388618,0.9644100411585107,2007,2007.csv
5253,The Wretched,2476030,1768828,0.7143806819788129,707202,0.2856193180211871,2020,2020.csv
5254,Wonderland,2466444,1060512,0.42997611135707925,1405932,0.5700238886429208,2003,2003.csv
5255,Bamboozled,2463650,2274979,0.9234180991618127,188671,0.07658190083818724,2000,2000.csv
5256,Ask the Dust,2460057,743847,0.30236982313824434,1716210,0.6976301768617557,2006,2006.csv
5257,Queen to Play,2456722,478710,0.1948572121713405,1978012,0.8051427878286594,2009,2009.csv
5258,Last Days,2456454,463080,0.1885156408383792,1993374,0.8114843591616208,2005,2005.csv
5259,Painted Skin: The Resurrection,2455359,50425,0.020536711739505303,2404934,0.9794632882604947,2012,2012.csv
5260,Tees Maar Khan,2454414,1076443,0.43857433994427997,1377971,0.56142566005572,2010,2010.csv
5261,The Endurance,2453083,2453083,1.0,0,0.0,2001,2001.csv
5262,Piku,2452343,1801807,0.7347287879387182,650536,0.2652712120612818,2015,2015.csv
5263,Crime Spree,2451607,0,0.0,2451607,1.0,2003,2003.csv
5264,Footnote,2451259,2007758,0.819072158429607,443501,0.18092784157039302,2011,2011.csv
5265,The Tree,2450045,71158,0.029043548179727312,2378887,0.9709564518202727,2010,2010.csv
5266,Côte d'Azur,2447211,141039,0.057632545783751384,2306172,0.9423674542162486,2005,2005.csv
5267,Love at First Fight,2446362,25229,0.010312864571964411,2421133,0.9896871354280355,2014,2014.csv
5268,Lean on Pete,2443584,1163056,0.47596317540137767,1280528,0.5240368245986223,2018,2018.csv
5269,Highwaymen,2442378,371396,0.15206327603671504,2070982,0.847936723963285,2004,2004.csv
5270,Ricky,2440234,3457,0.0014166674179607365,2436777,0.9985833325820392,2009,2009.csv
5271,A Family Secret,2438422,2438422,1.0,0,0.0,2006,2006.csv
5272,Coriolanus,2435325,757195,0.31092154024616836,1678130,0.6890784597538316,2012,2012.csv
5273,The Unknown Girl,2432640,150549,0.061887085635359114,2282091,0.9381129143646408,2016,2016.csv
5274,Joe,2431443,373375,0.15356107463757118,2058068,0.8464389253624288,2014,2014.csv
5275,The Grace Card,2430735,2430735,1.0,0,0.0,2011,2011.csv
5276,The Breadwinner 2018 Re-release,2426907,834,0.0003436472843829615,2426073,0.999656352715617,2018,2018.csv
5277,Life of Riley,2423379,11616,0.004793307196274293,2411763,0.9952066928037258,2014,2014.csv
5278,The Matrix Reloaded 2003 IMAX Release,2423288,0,0.0,2423288,1.0,2003,2003.csv
5279,After.Life,2422634,108595,0.044825177884897184,2314039,0.9551748221151029,2010,2010.csv
5280,Adam's Apples,2421577,1305,0.0005389050193324433,2420272,0.9994610949806676,2005,2005.csv
5281,Hearts Beat Loud,2417165,2386251,0.9872106372548005,30914,0.012789362745199439,2018,2018.csv
5282,Riddle,2415975,1409499,0.5834079408934281,1006476,0.4165920591065719,2005,2005.csv
5283,The Art of Self-Defense,2414269,2410914,0.9986103454089001,3355,0.0013896545910998318,2019,2019.csv
5284,The Oscar Nominated Short Films 2015: Live Action,2412593,2412593,1.0,0,0.0,2015,2015.csv
5285,Waves,2409350,1658790,0.6884802955153879,750560,0.311519704484612,2019,2019.csv
5286,The Marsh,2408452,336,0.00013950869687251395,2408116,0.9998604913031275,2007,2007.csv
5287,Beloved Sisters,2407680,54030,0.022440689792663476,2353650,0.9775593102073366,2014,2014.csv
5288,Horsemen,2405815,0,0.0,2405815,1.0,2009,2009.csv
5289,Fish Tank,2404300,374675,0.15583537828058064,2029625,0.8441646217194194,2009,2009.csv
5290,Sound! Euphonium the Movie - Our Promise: A Brand New Day,2403030,90341,0.037594620125424985,2312689,0.962405379874575,2019,2019.csv
5291,The Stroller Strategy,2401291,3462,0.0014417244723775669,2397829,0.9985582755276224,2013,2013.csv
5292,The Race Against Time,2395616,815064,0.3402314895208581,1580552,0.6597685104791419,2005,2005.csv
5293,The Man Who Killed Don Quixote,2390383,391963,0.1639749780683681,1998420,0.8360250219316319,2018,2018.csv
5294,Finding Vivian Maier,2384584,1514782,0.6352395218620942,869802,0.3647604781379058,2014,2014.csv
5295,Dark Blue World,2381183,258771,0.10867329390475239,2122412,0.8913267060952477,2001,2001.csv
5296,Laggies,2379154,1066981,0.44847075893363775,1312173,0.5515292410663623,2014,2014.csv
5297,Journey,2377609,2377609,1.0,0,0.0,2003,2003.csv
5298,Red Lights,2373828,673828,0.2838571286546456,1700000,0.7161428713453544,2004,2004.csv
5299,I Wish,2371548,145808,0.06148220487209198,2225740,0.938517795127908,2011,2011.csv
5300,Lore,2362019,970325,0.4108032153848043,1391694,0.5891967846151958,2012,2012.csv
5301,Cake,2360281,1951776,0.8269252686438606,408505,0.17307473135613938,2015,2015.csv
5302,Desi Boyz,2355293,1078826,0.4580432243461854,1276467,0.5419567756538146,2011,2011.csv
5303,Chico & Rita,2347919,350524,0.14929135119226855,1997395,0.8507086488077314,2010,2010.csv
5304,Memories of the Sword,2345062,111071,0.047363779720962604,2233991,0.9526362202790374,2015,2015.csv
5305,Standing in the Shadows of Motown,2344256,1722119,0.7346121754620656,622137,0.2653878245379344,2002,2002.csv
5306,Terraferma,2343302,19996,0.008533257770445295,2323306,0.9914667422295547,2011,2011.csv
5307,1991,2342264,2342264,1.0,0,0.0,2018,2018.csv
5308,JCVD,2342211,470691,0.20096011845218045,1871520,0.7990398815478196,2008,2008.csv
5309,Housefull,2340550,1183658,0.5057178868214736,1156892,0.49428211317852644,2010,2010.csv
5310,Ong-bak 3,2340516,14890,0.00636184499486438,2325626,0.9936381550051356,2010,2010.csv
5311,High Heels and Low Lifes,2340411,228194,0.09750167812405598,2112217,0.902498321875944,2001,2001.csv
5312,Teeth,2340110,347578,0.14853062462875677,1992532,0.8514693753712432,2008,2008.csv
5313,Me and Orson Welles,2336172,1190003,0.5093815866297515,1146169,0.4906184133702484,2009,2009.csv
5314,Gabriela,2335352,2335352,1.0,0,0.0,2001,2001.csv
5315,Meru,2334228,2334228,1.0,0,0.0,2015,2015.csv
5316,Jem and the Holograms,2333684,2184640,0.9361335982078122,149044,0.0638664017921878,2015,2015.csv
5317,Ready,2332914,955148,0.40942272196917673,1377766,0.5905772780308233,2011,2011.csv
5318,The Experiment 2002 Re-release,2327755,144634,0.06213454594663098,2183121,0.937865454053369,2002,2002.csv
5319,Bhaag Milkha Bhaag,2325917,1636731,0.7036927800949045,689186,0.2963072199050955,2013,2013.csv
5320,The Oranges,2316971,366377,0.158127572593701,1950594,0.841872427406299,2012,2012.csv
5321,Austenland,2313509,2159041,0.9332321594599373,154468,0.06676784054006274,2013,2013.csv
5322,A Aa,2313043,2313043,1.0,0,0.0,2016,2016.csv
5323,Fur: An Imaginary Portrait of Diane Arbus,2312717,223202,0.09651072742579399,2089515,0.903489272574206,2006,2006.csv
5324,WARx2,2310625,2310625,1.0,0,0.0,2015,2015.csv
5325,The Resurrection of Gavin Stone,2308355,2303792,0.9980232676516394,4563,0.001976732348360629,2017,2017.csv
5326,Blackfish,2303417,2073582,0.900219977537719,229835,0.09978002246228104,2013,2013.csv
5327,Lost Embrace,2298732,190860,0.08302838260397472,2107872,0.9169716173960253,2004,2004.csv
5328,Piranhas,2298525,23494,0.010221337596937167,2275031,0.9897786624030628,2019,2019.csv
5329,The Remaining,2297261,1169603,0.509129350126085,1127658,0.49087064987391504,2014,2014.csv
5330,3 from Hell,2295825,2172949,0.9464784990145155,122876,0.05352150098548452,2019,2019.csv
5331,Buffalo Soldiers,2295274,354421,0.15441337286964432,1940853,0.8455866271303557,2002,2002.csv
5332,Cashback,2294291,25343,0.011046114028255352,2268948,0.9889538859717446,2007,2007.csv
5333,Ek Main Aur Ekk Tu,2293823,1155545,0.5037638039203548,1138278,0.4962361960796452,2012,2012.csv
5334,Going Away,2290889,19501,0.008512415922377732,2271388,0.9914875840776223,2014,2014.csv
5335,American Honey,2290649,663246,0.28954501540829697,1627403,0.7104549845917031,2016,2016.csv
5336,Noel,2280924,0,0.0,2280924,1.0,2004,2004.csv
5337,Escanaba in da Moonlight,2276602,2276602,1.0,0,0.0,2001,2001.csv
5338,RV: Resurrected Victims,2269892,20374,0.008975757436917704,2249518,0.9910242425630823,2017,2017.csv
5339,The House That Jack Built 2018 Re-release,2268962,87993,0.03878116953919898,2180969,0.961218830460801,2018,2018.csv
5340,Luce,2268204,2010613,0.8864339362773366,257591,0.1135660637226634,2019,2019.csv
5341,Sleepwalk with Me,2266067,2266067,1.0,0,0.0,2012,2012.csv
5342,Nobody Knows,2265264,684118,0.30200365167150495,1581146,0.697996348328495,2004,2004.csv
5343,Puzzle,2260946,2032018,0.8987468077521533,228928,0.1012531922478467,2018,2018.csv
5344,Bronson,2260712,104979,0.046436255480574264,2155733,0.9535637445194257,2009,2009.csv
5345,Dans une galaxie près de chez vous - Le film,2259688,2259688,1.0,0,0.0,2004,2004.csv
5346,DysFunktional Family,2255000,2255000,1.0,0,0.0,2003,2003.csv
5347,Strangers with Candy,2254124,2072645,0.9194902321256506,181479,0.08050976787434941,2006,2006.csv
5348,Shadow Dancer,2253819,100616,0.04464244910527421,2153203,0.9553575508947258,2012,2012.csv
5349,An Interview with God,2251795,1201434,0.5335450163092111,1050361,0.4664549836907889,2018,2018.csv
5350,Marius,2249781,9781,0.0043475342711135,2240000,0.9956524657288865,2013,2013.csv
5351,My All-American,2246000,2246000,1.0,0,0.0,2015,2015.csv
5352,No culpes al karma de lo que te pasa por gilipollas,2242471,5614,0.0025034883394255713,2236857,0.9974965116605744,2016,2016.csv
5353,At War,2235052,4605,0.002060354747898483,2230447,0.9979396452521015,2018,2018.csv
5354,"Romulus, My Father",2234889,4283,0.0019164262744145236,2230606,0.9980835737255854,2007,2007.csv
5355,Elena,2227905,233380,0.10475312008366605,1994525,0.895246879916334,2011,2011.csv
5356,The Beaches of Agnès,2225430,239711,0.1077144641709692,1985719,0.8922855358290308,2008,2008.csv
5357,Heal the Living,2223529,3176,0.0014283600528709093,2220353,0.998571639947129,2016,2016.csv
5358,Blade Runner The Final Cut (2007 re-release),2217175,1548502,0.6984121686380191,668673,0.3015878313619809,2007,2007.csv
5359,The Lovers,2216083,2194521,0.9902702200233475,21562,0.0097297799766525,2017,2017.csv
5360,Bill Cunningham: New York,2210382,1510026,0.6831516000401741,700356,0.31684839995982594,2011,2011.csv
5361,Fast Food Nation,2209322,1005539,0.45513465216930804,1203783,0.544865347830692,2006,2006.csv
5362,Valentino: The Last Emperor,2203403,1755134,0.7965560544303516,448269,0.2034439455696484,2009,2009.csv
5363,Neil Young: Heart of Gold,2201933,1904606,0.864970005899362,297327,0.13502999410063793,2006,2006.csv
5364,Rivers and Tides: Andy Goldsworthy Working with Time,2200276,2200276,1.0,0,0.0,2002,2002.csv
5365,Goodnight Mommy,2193474,1178196,0.5371369799687619,1015278,0.46286302003123814,2015,2015.csv
5366,3 Faces,2191516,72324,0.033001812443988546,2119192,0.9669981875560114,2018,2018.csv
5367,What Will People Say,2191131,44156,0.020152149734543486,2146975,0.9798478502654565,2017,2017.csv
5368,Home 2008 Re-release,2186716,15925,0.007282610087455344,2170791,0.9927173899125447,2008,2008.csv
5369,Maria By Callas 2018 Re-release,2185562,1267301,0.5798513151308451,918261,0.4201486848691549,2018,2018.csv
5370,Don't Say Anything,2185360,224831,0.10288053226928287,1960529,0.8971194677307172,2003,2003.csv
5371,Anchorman 2: The Legend Continues R-Rated Extended Cut,2185255,2184339,0.9995808269515457,916,0.0004191730484542994,2014,2014.csv
5372,Border,2177678,771930,0.35447389375288724,1405748,0.6455261062471127,2018,2018.csv
5373,Amreeka,2176304,627436,0.28830347230901565,1548868,0.7116965276909843,2009,2009.csv
5374,Gone with the Wind 2019 Re-release,2176120,2176120,1.0,0,0.0,2019,2019.csv
5375,Veere Di Wedding,2176099,0,0.0,2176099,1.0,2018,2018.csv
5376,Desire,2174005,301010,0.13845874319516285,1872995,0.8615412568048372,2003,2003.csv
5377,The Oscar Nominated Short Films 2014: Live Action,2171849,2171849,1.0,0,0.0,2014,2014.csv
5378,Henry's Crime,2169799,102541,0.04725829443188056,2067258,0.9527417055681194,2011,2011.csv
5379,The Reluctant Fundamentalist,2167020,552959,0.25517023377726095,1614061,0.7448297662227391,2013,2013.csv
5380,In the Shadow of the Moon,2161369,1134358,0.5248331034635918,1027011,0.4751668965364082,2007,2007.csv
5381,Dhoondte Reh Jaoge,2161095,5127,0.0023724084318366384,2155968,0.9976275915681634,2009,2009.csv
5382,Mad Detective,2160790,4629,0.002142272039393,2156161,0.997857727960607,2007,2007.csv
5383,The Benefactor,2159380,0,0.0,2159380,1.0,2015,2015.csv
5384,Stage Beauty,2153070,782383,0.36338019664943544,1370687,0.6366198033505646,2004,2004.csv
5385,Shower,2150929,1157764,0.5382623043345457,993165,0.4617376956654543,2000,2000.csv
5386,Hallam Foe,2149799,60641,0.028207753376013292,2089158,0.9717922466239867,2007,2007.csv
5387,Echelon Conspiracy 2009 Re-release,2148179,666009,0.31003421968094835,1482170,0.6899657803190516,2009,2009.csv
5388,The Saratov Approach,2146999,2146999,1.0,0,0.0,2013,2013.csv
5389,The Oscar Nominated Short Films 2013: Live Action,2142342,2142342,1.0,0,0.0,2013,2013.csv
5390,Let Yourself Go,2140190,12189,0.0056952887360468,2128001,0.9943047112639533,2017,2017.csv
5391,The Attack,2139516,1720325,0.80407204246194,419191,0.19592795753806,2013,2013.csv
5392,Thumbsucker,2138742,1328679,0.6212432355094724,810063,0.3787567644905276,2005,2005.csv
5393,The Other Man,2138350,149528,0.06992681272944093,1988822,0.9300731872705591,2009,2009.csv
5394,The Black Balloon,2136663,0,0.0,2136663,1.0,2008,2008.csv
5395,High Life,2133033,1225852,0.5746990318480774,907181,0.42530096815192264,2018,2018.csv
5396,Mutant Chronicles,2131057,6820,0.003200289809235511,2124237,0.9967997101907645,2008,2008.csv
5397,My Scientology Movie,2130866,22936,0.010763698890498042,2107930,0.989236301109502,2016,2016.csv
5398,Mountain,2129889,365412,0.17156387022985706,1764477,0.8284361297701429,2017,2017.csv
5399,Heleno,2126384,0,0.0,2126384,1.0,2012,2012.csv
5400,Sightseers,2122909,61782,0.029102519231865333,2061127,0.9708974807681346,2012,2012.csv
5401,Let There Be Victory,2122804,1264515,0.595681466588531,858289,0.404318533411469,2014,2014.csv
5402,Abracadabra,2114260,13975,0.006609877687701608,2100285,0.9933901223122984,2017,2017.csv
5403,Left Luggage,2111280,1069540,0.5065836838316092,1041740,0.4934163161683907,2000,2000.csv
5404,State Property,2106838,2106838,1.0,0,0.0,2002,2002.csv
5405,"20,000 Days on Earth",2105558,279558,0.13277145535767715,1826000,0.8672285446423228,2014,2014.csv
5406,Candy,2105096,45128,0.02143750213766973,2059968,0.9785624978623303,2006,2006.csv
5407,The Eye of the Storm,2104689,83566,0.03970467845843258,2021123,0.9602953215415674,2011,2011.csv
5408,Once Upon a Time in Anatolia,2099472,152408,0.07259349017276724,1947064,0.9274065098272327,2011,2011.csv
5409,The Wizard of Oz 2019 Re-release,2097514,2076020,0.9897526309717122,21494,0.010247369028287772,2009,2009.csv
5410,Indian Horse,2097362,2097362,1.0,0,0.0,2018,2018.csv
5411,Mary Shelley,2096600,108900,0.051941238195173135,1987700,0.9480587618048268,2018,2018.csv
5412,Bollywood/Hollywood,2092228,1454510,0.6951966994036979,637718,0.3048033005963021,2002,2002.csv
5413,Garam Masala,2091698,1007943,0.4818778810325391,1083755,0.5181221189674609,2005,2005.csv
5414,The Captive,2090612,1075178,0.5142886389248699,1015434,0.48571136107513013,2014,2014.csv
5415,"The Butcher, the Chef, and the Swordsman",2089266,47896,0.022924797512619263,2041370,0.9770752024873808,2011,2011.csv
5416,Apollo 13 The IMAX Experience,2089051,1766621,0.8456571907531218,322430,0.15434280924687813,2002,2002.csv
5417,Lost in Paris,2087225,691597,0.33134760267819713,1395628,0.6686523973218029,2017,2017.csv
5418,Girl Most Likely,2085617,1378591,0.6609991192054917,707026,0.3390008807945083,2013,2013.csv
5419,The Hard Word,2085562,426880,0.20468343784553036,1658682,0.7953165621544697,2002,2002.csv
5420,Summer Storm,2085166,95204,0.045657755785390705,1989962,0.9543422442146093,2004,2004.csv
5421,Equals,2084628,33258,0.01595392559247981,2051370,0.9840460744075202,2016,2016.csv
5422,High Strung,2084451,53447,0.02564080422135133,2031004,0.9743591957786487,2016,2016.csv
5423,I'm Not Ashamed,2082980,2082980,1.0,0,0.0,2016,2016.csv
5424,A Cat in Paris,2080634,309973,0.1489800704977425,1770661,0.8510199295022575,2010,2010.csv
5425,Wi-heom-han gyan-gye,2074864,54000,0.02602580217305809,2020864,0.973974197826942,2012,2012.csv
5426,Black '47,2073063,57520,0.027746383009102954,2015543,0.9722536169908971,2018,2018.csv
5427,Blood Simple 2000 Re-release,2068701,1701855,0.82266842815854,366846,0.17733157184145992,2000,2000.csv
5428,A Fool,2067820,8212,0.003971332127554622,2059608,0.9960286678724454,2015,2015.csv
5429,Hotchpotch 3,2067671,1132192,0.5475687379665334,935479,0.4524312620334666,2010,2010.csv
5430,American Pastoral,2063436,544098,0.263685425668642,1519338,0.7363145743313579,2016,2016.csv
5431,Creation,2058675,341323,0.16579741824231606,1717352,0.8342025817576839,2009,2009.csv
5432,Battle of the Brave,2057293,1599716,0.7775829694652148,457577,0.2224170305347853,2004,2004.csv
5433,Under the Silver Lake,2053469,46083,0.022441536736127986,2007386,0.977558463263872,2018,2018.csv
5434,Family Comes First,2048588,327615,0.1599223465137939,1720973,0.8400776534862061,2005,2005.csv
5435,Hamlet,2046433,1577287,0.7707493966330684,469146,0.22925060336693162,2000,2000.csv
5436,Being 17,2045219,52713,0.025773767992571944,1992506,0.9742262320074281,2016,2016.csv
5437,Right at Your Door,2043704,65018,0.03181380473884672,1978686,0.9681861952611532,2006,2006.csv
5438,Guzaarish,2043580,1017335,0.4978200021530843,1026245,0.5021799978469157,2010,2010.csv
5439,W.E.,2042203,583455,0.2856988262185493,1458748,0.7143011737814507,2012,2012.csv
5440,Hotchpotch Again,2041647,1013893,0.49660543668910445,1027754,0.5033945633108956,2017,2017.csv
5441,The Dangerous Lives of Altar Boys,2036599,1815864,0.8916158752901283,220735,0.1083841247098717,2002,2002.csv
5442,A Guide to Recognizing Your Saints,2035468,517809,0.25439309289067674,1517659,0.7456069071093233,2006,2006.csv
5443,Mammoth,2033946,9580,0.004710056215848405,2024366,0.9952899437841516,2009,2009.csv
5444,Raid,2031135,1010385,0.49744847092881567,1020750,0.5025515290711844,2018,2018.csv
5445,Climax,2027391,817339,0.40314818404540614,1210052,0.5968518159545939,2018,2018.csv
5446,The Work and the Glory II: American Zion,2025032,2025032,1.0,0,0.0,2005,2005.csv
5447,The Broken Hearts Club: A Romantic Comedy,2019121,1746585,0.8650224528396268,272536,0.13497754716037325,2000,2000.csv
5448,Armadillo,2018685,14566,0.007215588365693509,2004119,0.9927844116343065,2010,2010.csv
5449,Graduation,2015002,175975,0.0873324195211717,1839027,0.9126675804788283,2016,2016.csv
5450,What to Do in Case of Fire,2014162,33545,0.01665456899693272,1980617,0.9833454310030673,2002,2002.csv
5451,Sur le seuil,2014071,2014071,1.0,0,0.0,2003,2003.csv
5452,Little Men,2008649,702537,0.34975598026335114,1306112,0.6502440197366489,2016,2016.csv
5453,The Italian,2007774,555436,0.2766426898644967,1452338,0.7233573101355033,2006,2006.csv
5454,The Man from Elysian Fields,2006391,1435016,0.7152225064805414,571375,0.2847774935194586,2002,2002.csv
5455,Red Nose,2004814,2004814,1.0,0,0.0,2003,2003.csv
5456,Introducing the Dwights,2003304,379408,0.18939112586007914,1623896,0.8106088741399209,2007,2007.csv
5457,Greater,2000093,2000093,1.0,0,0.0,2016,2016.csv
5458,Peterloo,1998945,151971,0.07602560350584933,1846974,0.9239743964941507,2018,2018.csv
5459,Will You Marry Me?,1998096,915728,0.4583003018873968,1082368,0.5416996981126032,2004,2004.csv
5460,Baaghi 3,1997071,721439,0.3612485484992772,1275632,0.6387514515007228,2020,2020.csv
5461,1898: Our Last Men in the Philippines,1995045,2848,0.001427536722229323,1992197,0.9985724632777707,2016,2016.csv
5462,Antboy,1994566,0,0.0,1994566,1.0,2013,2013.csv
5463,Va Savoir (Who Knows?),1989779,907323,0.4559918463306729,1082456,0.5440081536693271,2001,2001.csv
5464,The Trip to Spain,1988841,1157604,0.5820495454387756,831237,0.41795045456122437,2017,2017.csv
5465,42nd Street: The Musical,1985457,187440,0.0944064766952898,1798017,0.9055935233047102,2019,2019.csv
5466,De Dana Dan,1985423,944979,0.47595852369998737,1040444,0.5240414763000126,2009,2009.csv
5467,The Wedding Weekend,1985004,1215045,0.6121121166506466,769959,0.3878878833493535,2006,2006.csv
5468,Dead Snow,1984662,46742,0.023551617353483868,1937920,0.9764483826465161,2009,2009.csv
5469,"Gandhi, My Father",1983906,242967,0.12246900810824707,1740939,0.877530991891753,2007,2007.csv
5470,Summer 1993,1983149,185903,0.0937413174703464,1797246,0.9062586825296536,2017,2017.csv
5471,Great Performances at the Met: Verdi: La Traviata,1982588,1882931,0.9497338831870262,99657,0.05026611681297375,2018,2018.csv
5472,The Limits of Control,1981134,426688,0.2153756383969989,1554446,0.7846243616030011,2009,2009.csv
5473,Metallica: Some Kind of Monster,1980444,1222708,0.6173908477088976,757736,0.3826091522911024,2004,2004.csv
5474,Roadside Romeo,1978021,55202,0.027907691576580834,1922819,0.9720923084234192,2008,2008.csv
5475,Ashes of Time,1977198,174273,0.08814140010256939,1802925,0.9118585998974306,2008,2008.csv
5476,Oye Lucky! Lucky Oye!,1976868,80037,0.04048676998160727,1896831,0.9595132300183927,2008,2008.csv
5477,Singham Returns,1974745,1232018,0.6238871347946191,742727,0.37611286520538095,2014,2014.csv
5478,Beloved,1971858,137515,0.06973879457851427,1834343,0.9302612054214857,2011,2011.csv
5479,Diary of a Chambermaid,1971247,54235,0.027513041237348743,1917012,0.9724869587626512,2015,2015.csv
5480,Maquia: When the Promised Flower Blooms,1963575,185699,0.09457189055676508,1777876,0.9054281094432349,2018,2018.csv
5481,Menashe,1962265,1703036,0.8678929706232339,259229,0.13210702937676613,2017,2017.csv
5482,Cecil B. Demented,1961544,1284646,0.6549157194536549,676898,0.3450842805463451,2000,2000.csv
5483,Greenfingers,1961054,1443067,0.7358629594085629,517987,0.26413704059143706,2001,2001.csv
5484,Holy Motors,1954125,641100,0.3280752254845519,1313025,0.6719247745154481,2012,2012.csv
5485,Swades,1953889,1223240,0.626053987713734,730649,0.373946012286266,2004,2004.csv
5486,God Is Great and I'm Not,1952817,73181,0.03747458159161867,1879636,0.9625254184083814,2001,2001.csv
5487,A Ghost Story,1951683,1596371,0.8179458446889172,355312,0.1820541553110828,2017,2017.csv
5488,Deadfall,1946254,66351,0.03409164476990156,1879903,0.9659083552300984,2012,2012.csv
5489,Liam,1945689,1016021,0.5221908537284222,929668,0.47780914627157783,2001,2001.csv
5490,V/H/S,1944287,100345,0.0516101789499184,1843942,0.9483898210500816,2012,2012.csv
5491,Housefull 3,1944262,1326999,0.6825206685107255,617263,0.3174793314892746,2016,2016.csv
5492,Broken English,1944150,956919,0.4922043052233624,987231,0.5077956947766376,2007,2007.csv
5493,Another Earth,1938783,1321194,0.6814553253252169,617589,0.3185446746747831,2011,2011.csv
5494,New York,1935820,997437,0.5152529677346034,938383,0.48474703226539656,2009,2009.csv
5495,Monty Python and the Holy Grail 2001 Re-release,1935066,1827696,0.9445135204690692,107370,0.05548647953093073,2001,2001.csv
5496,Roger Dodger,1934497,1266828,0.6548617030680327,667669,0.34513829693196735,2002,2002.csv
5497,The House That Jack Built,1933114,170113,0.08799946614633178,1763001,0.9120005338536682,2018,2018.csv
5498,Three Monkeys 2008 Re-release,1924847,41343,0.02147859024639361,1883504,0.9785214097536064,2008,2008.csv
5499,Henry Poole Is Here,1923800,1836515,0.9546288595488096,87285,0.04537114045119035,2008,2008.csv
5500,Luka Chuppi,1923586,1042905,0.5421670775312359,880681,0.45783292246876406,2019,2019.csv
5501,Jane,1921221,1723379,0.8970227787433096,197842,0.10297722125669041,2017,2017.csv
5502,A Dirty Shame,1914166,1339668,0.6998703351746922,574498,0.30012966482530773,2004,2004.csv
5503,Old Fashioned,1914090,1914090,1.0,0,0.0,2015,2015.csv
5504,Hattrick,1911270,24502,0.012819748125591885,1886768,0.9871802518744082,2007,2007.csv
5505,Am Limit,1909568,18254,0.009559230150484299,1891314,0.9904407698495157,2007,2007.csv
5506,Marie Curie: The Courage of Knowledge,1900916,127986,0.0673285931624543,1772930,0.9326714068375457,2017,2017.csv
5507,Professor Marston & the Wonder Women,1899615,1584759,0.8342527301584794,314856,0.16574726984152052,2017,2017.csv
5508,Secuestro express,1898606,307208,0.16180713639375416,1591398,0.8381928636062459,2005,2005.csv
5509,Frank,1897363,645186,0.3400435235640202,1252177,0.6599564764359799,2014,2014.csv
5510,It Might Get Loud,1896244,1610163,0.8491328120220816,286081,0.15086718797791845,2009,2009.csv
5511,Game of Thrones Season 4 Finale,1896092,1896092,1.0,0,0.0,2015,2015.csv
5512,The Art of Getting By,1892130,1430241,0.7558893944919218,461889,0.2441106055080782,2011,2011.csv
5513,The Mighty Macs,1891936,1891936,1.0,0,0.0,2011,2011.csv
5514,Awake: The Life of Yogananda,1891918,1539680,0.8138196264320123,352238,0.1861803735679876,2014,2014.csv
5515,Red Lips,1889869,136163,0.07204890921010927,1753706,0.9279510907898907,2011,2011.csv
5516,Tusk,1882074,1826705,0.9705808592010728,55369,0.02941914079892714,2014,2014.csv
5517,Me and You,1878702,796641,0.42403797941344606,1082061,0.5759620205865539,2004,2004.csv
5518,Kill Your Darlings,1877924,1030064,0.5485120803610796,847860,0.45148791963892043,2013,2013.csv
5519,Red State,1874460,1104682,0.5893334613702079,769778,0.410666538629792,2011,2011.csv
5520,Wilbur Wants to Kill Himself,1873482,235294,0.12559181246470477,1638188,0.8744081875352953,2003,2003.csv
5521,Last Flag Flying,1872950,965481,0.5154867989001308,907469,0.4845132010998692,2017,2017.csv
5522,The Whistleblower,1870392,1124966,0.6014600147990368,745426,0.39853998520096323,2011,2011.csv
5523,Scoundrel,1868980,1291827,0.6911935922267761,577153,0.3088064077732239,2009,2009.csv
5524,Undertaking Betty,1868949,0,0.0,1868949,1.0,2002,2002.csv
5525,Purple Rain 2016 Re-release,1868929,1868075,0.9995430538024719,854,0.000456946197528103,2016,2016.csv
5526,Late Marriage,1868298,1656445,0.8866064193185456,211853,0.11339358068145446,2001,2001.csv
5527,The Luzhin Defence,1864747,1053070,0.5647254024272461,811677,0.43527459757275383,2001,2001.csv
5528,Arctic Tale,1864636,833532,0.4470212953091113,1031104,0.5529787046908887,2007,2007.csv
5529,Inseparables,1864605,6258,0.003356206810557732,1858347,0.9966437931894423,2016,2016.csv
5530,Fantastic Fungi,1864309,1788322,0.9592411987497781,75987,0.04075880125022193,2019,2019.csv
5531,A Better Life,1863506,1759252,0.9440549158414301,104254,0.05594508415856992,2011,2011.csv
5532,Girlhood,1862990,60765,0.03261692225937874,1802225,0.9673830777406213,2014,2014.csv
5533,The Hallow,1862407,13906,0.007466681557790537,1848501,0.9925333184422095,2015,2015.csv
5534,The Dark Horse,1862114,67533,0.036266845101857355,1794581,0.9637331548981426,2014,2014.csv
5535,The Pact,1855647,2488,0.0013407722481700453,1853159,0.9986592277518299,2018,2018.csv
5536,The Five of Us,1852272,1852272,1.0,0,0.0,2004,2004.csv
5537,Smother,1851790,0,0.0,1851790,1.0,2008,2008.csv
5538,Sweet Country,1847693,104297,0.056447147875756415,1743396,0.9435528521242436,2018,2018.csv
5539,A Woman in Berlin,1847322,294014,0.15915687681952578,1553308,0.8408431231804743,2008,2008.csv
5540,A Love Song for Bobby Long,1841260,164308,0.0892367183341842,1676952,0.9107632816658158,2004,2004.csv
5541,"You, the Living",1840899,21438,0.01164539716736225,1819461,0.9883546028326378,2007,2007.csv
5542,Elvis Gratton 3: Le retour d'Elvis Wong,1838920,1838920,1.0,0,0.0,2004,2004.csv
5543,Election 2,1833853,55758,0.0304048361564422,1778095,0.9695951638435578,2006,2006.csv
5544,Crooked Arrows,1832541,1832541,1.0,0,0.0,2012,2012.csv
5545,The Last Mistress,1831577,785671,0.4289587606745444,1045906,0.5710412393254556,2007,2007.csv
5546,Renaissance,1831348,70644,0.03857486397997541,1760704,0.9614251360200246,2006,2006.csv
5547,Startup.com,1830008,1283356,0.7012843659699848,546652,0.29871563403001516,2001,2001.csv
5548,99 Homes,1828232,1411927,0.7722909346297406,416305,0.22770906537025937,2015,2015.csv
5549,Enduring Love,1828184,358362,0.19602075064654323,1469822,0.8039792493534568,2004,2004.csv
5550,Grease 2018 Re-release,1827688,1213413,0.6639059839534975,614275,0.33609401604650246,2018,2018.csv
5551,Rams,1826583,149250,0.08170994693370079,1677333,0.9182900530662992,2015,2015.csv
5552,A Somewhat Gentle Man,1826459,37743,0.02066457555302364,1788716,0.9793354244469764,2010,2010.csv
5553,Delhi Safari,1826376,0,0.0,1826376,1.0,2012,2012.csv
5554,The Little Stranger,1824902,713143,0.39078427225133183,1111759,0.6092157277486682,2018,2018.csv
5555,Mozart's Sister,1824891,707885,0.3879053598269705,1117006,0.6120946401730295,2010,2010.csv
5556,Infinitely Polar Bear,1824678,1430655,0.7840588860061884,394023,0.21594111399381152,2015,2015.csv
5557,Human Flow,1824537,527845,0.28930353289629096,1296692,0.710696467103709,2017,2017.csv
5558,The Seagull,1820461,1252960,0.688265225127042,567501,0.311734774872958,2018,2018.csv
5559,Brodeuses - A Common Thread,1812833,26042,0.014365360736482622,1786791,0.9856346392635174,2004,2004.csv
5560,Dans Paris,1810452,63667,0.03516635624694828,1746785,0.9648336437530517,2006,2006.csv
5561,The Monk,1809527,13472,0.0074450395047987675,1796055,0.9925549604952012,2011,2011.csv
5562,NSync: Bigger Than Live,1808679,1808679,1.0,0,0.0,2001,2001.csv
5563,The Navigators,1807686,3052,0.0016883463167828925,1804634,0.9983116536832171,2002,2002.csv
5564,The Other Side of Heaven 2: Fire of Faith,1807216,1807216,1.0,0,0.0,2019,2019.csv
5565,Moses,1807117,1807117,1.0,0,0.0,2018,2018.csv
5566,The Face of Love,1806548,350006,0.19374298385650424,1456542,0.8062570161434958,2013,2013.csv
5567,The Aura,1805261,58804,0.032573683251341495,1746457,0.9674263167486585,2005,2005.csv
5568,The Secret of Kells,1803412,676775,0.3752747569606945,1126637,0.6247252430393055,2009,2009.csv
5569,How I Killed My Father,1802142,145396,0.0806795468947508,1656746,0.9193204531052492,2001,2001.csv
5570,Oyster Farmer,1801199,15456,0.008580950799994892,1785743,0.9914190492000051,2005,2005.csv
5571,The Bridge of San Luis Rey,1800141,49981,0.027765047293517562,1750160,0.9722349527064824,2004,2004.csv
5572,Elvis & Nixon,1798432,1055287,0.5867817076208608,743145,0.41321829237913915,2016,2016.csv
5573,The Polar Express 2010 IMAX Release,1798274,672796,0.3741343087872037,1125478,0.6258656912127962,2010,2010.csv
5574,Slow Burn,1797256,1237615,0.6886136421300026,559641,0.31138635786999735,2007,2007.csv
5575,Mine,1788934,0,0.0,1788934,1.0,2016,2016.csv
5576,Mondovino,1788325,209618,0.11721471209092307,1578707,0.882785287909077,2004,2004.csv
5577,Harry Potter IMAX Marathon,1784557,1729226,0.9689945459853622,55331,0.031005454014637807,2010,2010.csv
5578,Soldiers of Fortune,1784286,38898,0.021800316765361608,1745388,0.9781996832346384,2012,2012.csv
5579,Reservation Road,1783226,121994,0.06841196797265181,1661232,0.9315880320273482,2007,2007.csv
5580,O'Horten,1778791,302232,0.16990866268156293,1476559,0.8300913373184371,2007,2007.csv
5581,Che: Part One/Che: Part Two,1778287,1497109,0.8418826657339339,281178,0.15811733426606617,2008,2008.csv
5582,Song to Song,1778021,443684,0.2495381100673164,1334337,0.7504618899326836,2017,2017.csv
5583,The Notorious Bettie Page,1778006,1415082,0.7958814537183789,362924,0.2041185462816211,2006,2006.csv
5584,Ondine,1777019,550472,0.30977271486686414,1226547,0.6902272851331359,2010,2010.csv
5585,Tom of Finland,1776931,378296,0.2128929035511227,1398635,0.7871070964488773,2017,2017.csv
5586,The Diary of a Teenage Girl,1775133,1477002,0.832051457552758,298131,0.16794854244724197,2015,2015.csv
5587,Sweet Land,1774931,1706325,0.9613472298359768,68606,0.03865277016402328,2006,2006.csv
5588,Polaroid,1772204,0,0.0,1772204,1.0,2019,2019.csv
5589,Dior and I,1769832,1028953,0.5813845607944709,740879,0.4186154392055291,2015,2015.csv
5590,I Saw the Light,1767963,1646788,0.9314606697085855,121175,0.06853933029141447,2016,2016.csv
5591,Invisible Life,1766249,146535,0.08296395355354766,1619714,0.9170360464464523,2019,2019.csv
5592,Carman: The Champion,1765751,1765751,1.0,0,0.0,2001,2001.csv
5593,Who Killed the Electric Car?,1764304,1678874,0.9515786395088375,85430,0.048421360491162524,2006,2006.csv
5594,Great Performances at the Met: Puccini: La Bohème,1764201,1764201,1.0,0,0.0,2018,2018.csv
5595,Tales of the Night,1762194,10975,0.006228031646912883,1751219,0.9937719683530871,2011,2011.csv
5596,Bloody Sunday,1758689,773228,0.43966158883122597,985461,0.560338411168774,2002,2002.csv
5597,The Blue Butterfly,1755355,1755355,1.0,0,0.0,2004,2004.csv
5598,Flipped,1755212,1755212,1.0,0,0.0,2010,2010.csv
5599,Going the Distance,1752950,1230897,0.7021860292649533,522053,0.2978139707350466,2004,2004.csv
5600,Pledge This!,1751490,0,0.0,1751490,1.0,2007,2007.csv
5601,Murderball,1750211,1531154,0.8748396621893018,219057,0.12516033781069824,2005,2005.csv
5602,Great Performances at the Met: Massenet: Cendrillon,1747259,1243306,0.7115751013444487,503953,0.2884248986555514,2018,2018.csv
5603,The Debut,1745778,1745778,1.0,0,0.0,2001,2001.csv
5604,Beast,1744071,800365,0.45890620278646915,943706,0.5410937972135309,2018,2018.csv
5605,"Turn Me On, Dammit!",1743743,126085,0.07230710030090444,1617658,0.9276928996990955,2011,2011.csv
5606,Wuthering Heights,1742215,100915,0.057923390626300426,1641300,0.9420766093736995,2011,2011.csv
5607,Starter for 10,1736394,216839,0.1248789157299553,1519555,0.8751210842700446,2006,2006.csv
5608,L'odyssée d'Alice Tremblay,1734925,1734925,1.0,0,0.0,2002,2002.csv
5609,First Position,1730824,1014071,0.5858891487522706,716753,0.4141108512477294,2012,2012.csv
5610,Matthias & Maxime,1730255,374739,0.21658021505500635,1355516,0.7834197849449936,2019,2019.csv
5611,After Love,1728251,13693,0.007923038956725614,1714558,0.9920769610432744,2016,2016.csv
5612,Elling,1727470,314729,0.18219071821797195,1412741,0.817809281782028,2001,2001.csv
5613,Girl Rising,1727259,1727259,1.0,0,0.0,2013,2013.csv
5614,Diana Vreeland: The Eye Has to Travel,1721472,1017579,0.5911098176444345,703893,0.40889018235556546,2012,2012.csv
5615,A Faithful Man,1720605,77491,0.04503706545081527,1643114,0.9549629345491847,2018,2018.csv
5616,The Souvenir,1719157,1036737,0.6030496342102554,682420,0.39695036578974463,2019,2019.csv
5617,Weiner,1715955,1676108,0.9767785285744672,39847,0.02322147142553272,2016,2016.csv
5618,Safe Conduct,1713421,25440,0.014847489321071704,1687981,0.9851525106789283,2002,2002.csv
5619,The Life and Times of Hank Greenberg,1712385,1712385,1.0,0,0.0,2000,2000.csv
5620,"To Joey, with Love",1709073,1709073,1.0,0,0.0,2016,2016.csv
5621,Paradise: Love,1709036,24267,0.01419923278386178,1684769,0.9858007672161382,2012,2012.csv
5622,The Girl on the Bridge,1708839,1708839,1.0,0,0.0,2000,2000.csv
5623,"Men, Women & Children",1705908,705908,0.4138019166332534,1000000,0.5861980833667466,2014,2014.csv
5624,The Polar Express 2008 IMAX Release,1705694,1705694,1.0,0,0.0,2008,2008.csv
5625,The Oscar Nominated Short Films 2012: Live Action,1702415,1702415,1.0,0,0.0,2012,2012.csv
5626,Meet the Patels,1700681,1700681,1.0,0,0.0,2015,2015.csv
5627,Rear Window 2000 Re-release,1699210,1574607,0.9266700407836583,124603,0.07332995921634171,2000,2000.csv
5628,Tekken,1697207,0,0.0,1697207,1.0,2010,2010.csv
5629,The Wild Pear Tree,1696258,34014,0.020052374108184015,1662244,0.9799476258918159,2018,2018.csv
5630,Dunkirk 2017 Re-release,1695119,1695119,1.0,0,0.0,2017,2017.csv
5631,Open Hearts,1692272,136170,0.08046578800571066,1556102,0.9195342119942893,2002,2002.csv
5632,State Property: Blood on the Streets,1691706,1691706,1.0,0,0.0,2005,2005.csv
5633,El vacilón: The Movie,1690929,1291951,0.7640480469611675,398978,0.2359519530388325,2005,2005.csv
5634,The Legend of Johnny Lingo,1690767,1690767,1.0,0,0.0,2003,2003.csv
5635,The Breed,1689984,14500,0.008579962887222601,1675484,0.9914200371127774,2006,2006.csv
5636,All Good Things 2010 Re-release,1689646,582024,0.34446505362661767,1107622,0.6555349463733824,2010,2010.csv
5637,Slamma Jamma,1687000,1687000,1.0,0,0.0,2017,2017.csv
5638,Tim's Vermeer,1686917,1671377,0.9907879285110056,15540,0.00921207148899442,2014,2014.csv
5639,Janis: Little Girl Blue,1683166,410465,0.2438648356727738,1272701,0.7561351643272262,2015,2015.csv
5640,The Bride,1682689,0,0.0,1682689,1.0,2015,2015.csv
5641,Detachment,1681521,72689,0.04322812501300906,1608832,0.9567718749869909,2012,2012.csv
5642,The Hunter,1680778,176669,0.10511144243915616,1504109,0.8948885575608438,2011,2011.csv
5643,"The Book of Mormon Movie, Volume 1: The Journey",1680020,1680020,1.0,0,0.0,2003,2003.csv
5644,In Between,1679952,107977,0.06427386020552968,1571975,0.9357261397944703,2016,2016.csv
5645,Final Portrait,1677835,461972,0.275338158996564,1215863,0.724661841003436,2017,2017.csv
5646,Marci X,1675706,1648818,0.9839542258606223,26888,0.01604577413937767,2003,2003.csv
5647,Nothing Left to Fear,1675381,7886,0.0047069890371205115,1667495,0.9952930109628795,2013,2013.csv
5648,Ginger & Rosa,1674776,1012973,0.6048408861841822,661803,0.39515911381581775,2012,2012.csv
5649,Happy Endings,1673288,1315701,0.7862968000726713,357587,0.2137031999273287,2005,2005.csv
5650,Equity,1672306,1605463,0.9600294443720229,66843,0.039970555627977175,2016,2016.csv
5651,Divine Intervention,1672044,421343,0.25199277052517755,1250701,0.7480072294748225,2002,2002.csv
5652,La femme de mon frère,1671969,539524,0.32268780102980377,1132445,0.6773121989701962,2019,2019.csv
5653,Vanishing on 7th Street,1671196,22729,0.013600439445762197,1648467,0.9863995605542378,2011,2011.csv
5654,L.I.E.,1667192,1138836,0.6830862912010135,528356,0.31691370879898656,2001,2001.csv
5655,Girlfight,1666028,1565852,0.9398713587046557,100176,0.06012864129534438,2000,2000.csv
5656,A Thousand Years of Good Prayers,1665585,76806,0.04611352767946397,1588779,0.953886472320536,2008,2008.csv
5657,A Hard Day's Night,1664617,965351,0.579923790277283,699266,0.420076209722717,2000,2000.csv
5658,The Double,1662515,200406,0.12054387479210714,1462109,0.8794561252078928,2014,2014.csv
5659,Storm 2009 Re-release,1661518,16013,0.009637572388622935,1645505,0.990362427611377,2009,2009.csv
5660,The Comedian,1659002,1659002,1.0,0,0.0,2016,2016.csv
5661,Rustom,1658594,1087419,0.6556269949125585,571175,0.3443730050874415,2016,2016.csv
5662,Sharkwater,1658393,850920,0.5130991266846882,807473,0.48690087331531184,2007,2007.csv
5663,Dear Frankie,1656829,18025,0.010879215658344947,1638804,0.9891207843416551,2005,2005.csv
5664,Sweetheart,1656433,650000,0.3924094726439282,1006433,0.6075905273560718,2006,2006.csv
5665,Rockstar,1651601,986697,0.5974185048325836,664904,0.40258149516741637,2011,2011.csv
5666,Talento de barrio,1650198,68542,0.04153562178599174,1581656,0.9584643782140082,2008,2008.csv
5667,What's Cooking?,1649655,1045899,0.6340107477017922,603756,0.36598925229820783,2000,2000.csv
5668,Two Lives,1649260,22620,0.013715241987315524,1626640,0.9862847580126844,2012,2012.csv
5669,Appleseed,1647770,129135,0.0783695540032893,1518635,0.9216304459967107,2004,2004.csv
5670,The Maid,1647555,576608,0.34997799769962157,1070947,0.6500220023003784,2009,2009.csv
5671,Dough,1647429,1148304,0.6970279144048089,499125,0.30297208559519107,2016,2016.csv
5672,The Letters,1647416,1647416,1.0,0,0.0,2015,2015.csv
5673,The Little Hours,1647175,1647175,1.0,0,0.0,2017,2017.csv
5674,Short Term 12,1645164,1013100,0.6158048680860996,632064,0.38419513191390037,2013,2013.csv
5675,Asylum,1644363,375403,0.2282969149755863,1268960,0.7717030850244138,2005,2005.csv
5676,A Family Man,1641235,0,0.0,1641235,1.0,2017,2017.csv
5677,The Girl on the Train 2009 Re-release,1636579,208023,0.12710843778393832,1428556,0.8728915622160617,2009,2009.csv
5678,Sorry Angel,1636273,30628,0.018718147888524713,1605645,0.9812818521114753,2018,2018.csv
5679,Student of the Year 2,1635907,778566,0.47592314233021804,857341,0.524076857669782,2019,2019.csv
5680,Since Otar Left,1634307,350391,0.21439729500026616,1283916,0.7856027049997338,2003,2003.csv
5681,Mohenjo Daro,1630231,1264339,0.7755581877660283,365892,0.22444181223397175,2016,2016.csv
5682,Withnail & I,1627318,1544889,0.9493467164991722,82429,0.05065328350082774,2007,2007.csv
5683,Iris,1620708,1310678,0.8087070588903121,310030,0.19129294110968786,2015,2015.csv
5684,All You Need Is Love,1620654,0,0.0,1620654,1.0,2014,2014.csv
5685,I Still See You,1620637,1359,0.0008385591591454472,1619278,0.9991614408408546,2018,2018.csv
5686,Son of Sardaar,1618361,771789,0.4768954516328557,846572,0.5231045483671443,2012,2012.csv
5687,Grand Piano,1618085,22555,0.013939317155773645,1595530,0.9860606828442263,2013,2013.csv
5688,Anjaana Anjaani,1615888,854757,0.5289704484469221,761131,0.47102955155307796,2010,2010.csv
5689,Deerskin,1615875,0,0.0,1615875,1.0,2019,2019.csv
5690,Lights in the Dusk,1615018,14056,0.008703308569935444,1600962,0.9912966914300646,2006,2006.csv
5691,In My Father's Den,1614675,0,0.0,1614675,1.0,2004,2004.csv
5692,The Corporation,1613533,1613533,1.0,0,0.0,2004,2004.csv
5693,Session 9,1612259,378176,0.23456280907720162,1234083,0.7654371909227984,2001,2001.csv
5694,Black Friday,1610897,35000,0.021727025377786414,1575897,0.9782729746222136,2007,2007.csv
5695,Singin' in the Rain 2012 Re-release,1609789,1608925,0.9994632836974287,864,0.0005367163025713307,2012,2012.csv
5696,Walk With Me,1606705,726726,0.4523082955489651,879979,0.5476917044510349,2017,2017.csv
5697,Year of the Dog,1606237,1540141,0.9588504062600973,66096,0.041149593739902644,2007,2007.csv
5698,The Year My Parents Went on Vacation 2007 Re-release,1605366,807117,0.5027619869861453,798249,0.4972380130138548,2007,2007.csv
5699,More Than Honey,1604609,79772,0.049714291768275014,1524837,0.950285708231725,2012,2012.csv
5700,We are the Best!,1604273,180590,0.11256812275716166,1423683,0.8874318772428383,2013,2013.csv
5701,Northfork,1599804,1420578,0.8879700263282252,179226,0.1120299736717748,2003,2003.csv
5702,The Code,1598493,13152,0.008227749511571212,1585341,0.9917722504884288,2002,2002.csv
5703,Crazy Mad Lover,1597269,993031,0.6217055486583662,604238,0.37829445134163375,2011,2011.csv
5704,The Hottie & the Nottie,1596232,27696,0.017350861278310422,1568536,0.9826491387216896,2008,2008.csv
5705,Great Performances at the Met: Verdi: Aida,1595902,1595902,1.0,0,0.0,2018,2018.csv
5706,The Messenger,1595417,1109660,0.6955297580507165,485757,0.30447024194928346,2009,2009.csv
5707,Monos,1594628,406473,0.25490145664067104,1188155,0.7450985433593289,2019,2019.csv
5708,Made in India,1594164,790628,0.49595148303436787,803536,0.5040485169656321,2018,2018.csv
5709,Queen of the Desert,1592853,0,0.0,1592853,1.0,2015,2015.csv
5710,It's All Gone Pete Tong,1591879,120620,0.0757720907179503,1471259,0.9242279092820497,2005,2005.csv
5711,Nine Lives,1591523,478830,0.30086275850239047,1112693,0.6991372414976095,2005,2005.csv
5712,"Mèche Blanche, les aventures du petit castor",1591520,360886,0.2267555544385242,1230634,0.7732444455614759,2008,2008.csv
5713,I Am,1591034,1591034,1.0,0,0.0,2011,2011.csv
5714,The Crossing,1589212,90896,0.05719564161357956,1498316,0.9428043583864204,2019,2019.csv
5715,Beanpole,1587651,196258,0.12361532855772459,1391393,0.8763846714422754,2019,2019.csv
5716,Dance Academy: The Movie,1586858,0,0.0,1586858,1.0,2017,2017.csv
5717,Lovelace,1585583,356582,0.22489015081518912,1229001,0.7751098491848109,2013,2013.csv
5718,Two 2004 Re-release,1585139,47806,0.030158869348366295,1537333,0.9698411306516337,2004,2004.csv
5719,Make Your Move,1583687,125106,0.07899667042793178,1458581,0.9210033295720682,2012,2012.csv
5720,Bra Boys,1582036,155056,0.09801041189960279,1426980,0.9019895881003972,2007,2007.csv
5721,The Bay,1581252,30668,0.019394758077776346,1550584,0.9806052419222236,2012,2012.csv
5722,Lou!,1581125,287,0.00018151632540121747,1580838,0.9998184836745988,2014,2014.csv
5723,The Stray,1579440,1579440,1.0,0,0.0,2017,2017.csv
5724,Lay the Favorite,1576687,20998,0.013317798649953985,1555689,0.986682201350046,2012,2012.csv
5725,After Midnight,1576003,50469,0.03202341619908084,1525534,0.9679765838009191,2004,2004.csv
5726,Adore,1575749,318982,0.2024319863125409,1256767,0.7975680136874591,2013,2013.csv
5727,Genesis: Paradise Lost,1575000,1575000,1.0,0,0.0,2017,2017.csv
5728,Teri Meri Kahaani,1574703,781196,0.49609100890771146,793507,0.5039089910922885,2012,2012.csv
5729,Human Nature,1574660,705308,0.44791129513672795,869352,0.5520887048632721,2002,2002.csv
5730,9 Songs,1574623,66853,0.04245651181266881,1507770,0.9575434881873311,2004,2004.csv
5731,Teen Spirit,1573601,441366,0.2804815197753433,1132235,0.7195184802246567,2019,2019.csv
5732,Caesar Must Die,1567339,76908,0.04906915479038038,1490431,0.9509308452096196,2012,2012.csv
5733,Hope Springs,1567189,0,0.0,1567189,1.0,2003,2003.csv
5734,Nanking,1566248,161182,0.10290962861564708,1405066,0.8970903713843529,2007,2007.csv
5735,Ushpizin,1565016,1400666,0.894985099193874,164350,0.10501490080612594,2005,2005.csv
5736,"Bless Me, Ultima",1561962,1561962,1.0,0,0.0,2013,2013.csv
5737,Persecuted,1558836,1558836,1.0,0,0.0,2014,2014.csv
5738,The Married Woman,1558018,802758,0.5152430844829777,755260,0.48475691551702227,2005,2005.csv
5739,The Milk of Sorrow,1553977,10462,0.006732403375339532,1543515,0.9932675966246605,2009,2009.csv
5740,Night of the Living Dead 3D,1553837,271000,0.17440696804104935,1282837,0.8255930319589506,2006,2006.csv
5741,The Kid,1553483,1508593,0.9711036425889437,44890,0.028896357411056315,2019,2019.csv
5742,Out of Control,1553195,36486,0.023490933205424946,1516709,0.976509066794575,2003,2003.csv
5743,Eros,1553020,188392,0.12130687306023104,1364628,0.878693126939769,2004,2004.csv
5744,Still Mine,1552730,1159336,0.7466436534362059,393394,0.2533563465637941,2013,2013.csv
5745,Good,1552024,27276,0.0175744704978789,1524748,0.9824255295021211,2008,2008.csv
5746,Yardie,1551163,36012,0.0232161288014219,1515151,0.9767838711985781,2018,2018.csv
5747,A Home at the End of the World,1548955,1029872,0.6648818074120939,519083,0.33511819258790604,2004,2004.csv
5748,Tel Aviv on Fire,1548893,506145,0.3267785444184976,1042748,0.6732214555815024,2019,2019.csv
5749,Cold in July,1547630,427418,0.276175830140279,1120212,0.723824169859721,2014,2014.csv
5750,Lagaan: Once Upon a Time in India,1546734,835767,0.5403430712714662,710967,0.4596569287285338,2001,2001.csv
5751,Fed Up,1546229,1538899,0.9952594344046063,7330,0.0047405655953936966,2014,2014.csv
5752,"New York, New York",1545352,92377,0.059777319342130465,1452975,0.9402226806578695,2016,2016.csv
5753,The Lords of Salem,1544989,1165882,0.7546215539398662,379107,0.24537844606013376,2013,2013.csv
5754,Mystery Train,1544973,1541218,0.9975695368139119,3755,0.0024304631860880416,2018,2018.csv
5755,Divided We Fall 2001 Re-release,1544317,1332586,0.8628966721210736,211731,0.1371033278789264,2001,2001.csv
5756,Rampart,1543613,972512,0.6300231988199114,571101,0.3699768011800885,2012,2012.csv
5757,The Wedding Plan,1542345,1412404,0.9157510154991263,129941,0.08424898450087367,2016,2016.csv
5758,The Chaperone,1541223,600654,0.38972556210230447,940569,0.6102744378976955,2019,2019.csv
5759,Kedarnath,1538417,901131,0.5857521075235128,637286,0.4142478924764872,2018,2018.csv
5760,Reaching for the Moon,1534391,45502,0.029654762052175748,1488889,0.9703452379478242,2013,2013.csv
5761,Love,1533874,309200,0.2015810946661851,1224674,0.7984189053338149,2012,2012.csv
5762,The Blind Swordsman: Zatoichi 2004 Re-release,1532969,862894,0.5628907042477702,670075,0.43710929575222984,2004,2004.csv
5763,Blonde Ambition,1530479,6422,0.004196071948716709,1524057,0.9958039280512833,2007,2007.csv
5764,The Bullet Vanishes,1528580,117629,0.07695311988904735,1410951,0.9230468801109526,2012,2012.csv
5765,Gold,1528185,5539,0.0036245611624247066,1522646,0.9963754388375753,2017,2017.csv
5766,Certain Women,1526698,1087585,0.7123773005532201,439113,0.28762269944677993,2016,2016.csv
5767,Mysterious Skin,1524966,713240,0.4677087882615088,811726,0.5322912117384913,2005,2005.csv
5768,The Sea Is Watching,1523691,30577,0.02006771714212396,1493114,0.979932282857876,2002,2002.csv
5769,Dogtown and Z-Boys,1523090,1300682,0.8539757991976836,222408,0.14602420080231635,2002,2002.csv
5770,The Syrian Bride,1522967,380505,0.24984454686148813,1142462,0.7501554531385118,2005,2005.csv
5771,She Hate Me,1522377,366037,0.2404378153374624,1156340,0.7595621846625376,2004,2004.csv
5772,Shaadi Ke Side Effects,1521778,921277,0.605395136478514,600501,0.39460486352148605,2014,2014.csv
5773,The Kid Stays in the Picture,1521593,1439232,0.9458718592948311,82361,0.05412814070516886,2002,2002.csv
5774,Princess Mononoke 2018 Re-release,1519321,1423877,0.9371798323066686,95444,0.06282016769333143,2018,2018.csv
5775,My Golden Days,1509773,269144,0.17826785881056292,1240629,0.821732141189437,2015,2015.csv
5776,The Road to Guantanamo,1508988,326876,0.21661935018701275,1182112,0.7833806498129873,2006,2006.csv
5777,Take a Shot,1508912,564489,0.3741033274306255,944423,0.6258966725693745,2011,2011.csv
5778,The Daughter,1505434,26376,0.01752052896374069,1479058,0.9824794710362593,2016,2016.csv
5779,The Kings of Summer,1501595,1315590,0.8761283834855603,186005,0.12387161651443965,2013,2013.csv
5780,Priceless,1499605,1499605,1.0,0,0.0,2016,2016.csv
5781,Guadalupe,1498950,848139,0.5658220754528169,650811,0.434177924547183,2006,2006.csv
5782,The Blind Swordsman: Zatoichi Canadian Release,1496523,255269,0.17057472554715164,1241254,0.8294252744528484,2004,2004.csv
5783,Moka,1493067,129547,0.0867656977215356,1363520,0.9132343022784644,2016,2016.csv
5784,The Artist and the Model,1492780,127958,0.08571792226583957,1364822,0.9142820777341605,2012,2012.csv
5785,Gonzo,1491958,1252100,0.8392327397956243,239858,0.16076726020437573,2008,2008.csv
5786,In My Country,1491434,163893,0.10988954254764206,1327541,0.890110457452358,2004,2004.csv
5787,Mully,1489771,1489771,1.0,0,0.0,2017,2017.csv
5788,John Rabe,1484665,67519,0.04547759932375317,1417146,0.9545224006762468,2009,2009.csv
5789,Patti Cake$,1482356,800148,0.5397812671180202,682208,0.4602187328819798,2017,2017.csv
5790,Oasis: Supersonic,1478119,242867,0.16430815110285438,1235252,0.8356918488971457,2016,2016.csv
5791,The Miseducation of Cameron Post,1474577,904703,0.613533915149904,569874,0.386466084850096,2018,2018.csv
5792,Freeheld,1474471,573335,0.3888411504871917,901136,0.6111588495128083,2015,2015.csv
5793,Good Kill,1474471,316472,0.21463426544163974,1157999,0.7853657345583602,2015,2015.csv
5794,Mausam,1473341,728316,0.4943295543937215,745025,0.5056704456062785,2011,2011.csv
5795,De De Pyaar De,1473116,425934,0.28913812625753843,1047182,0.7108618737424616,2019,2019.csv
5796,X Games 3D: The Movie,1472747,1391434,0.9447882087011551,81313,0.055211791298844945,2009,2009.csv
5797,A Pigeon Sat on a Branch Reflecting on Existence,1472431,222989,0.15144275011868127,1249442,0.8485572498813188,2014,2014.csv
5798,Jimmy P: Psychotherapy Of A Plains Indian,1470582,30283,0.020592527312315805,1440299,0.9794074726876842,2013,2013.csv
5799,Violeta Went to Heaven,1466032,21496,0.014662708590262696,1444536,0.9853372914097374,2011,2011.csv
5800,Modigliani,1466013,205165,0.13994759937326612,1260848,0.8600524006267338,2004,2004.csv
5801,Thelma,1463727,147391,0.10069568983833733,1316336,0.8993043101616627,2017,2017.csv
5802,Joshua,1461635,1461635,1.0,0,0.0,2002,2002.csv
5803,Kurbaan,1461611,754268,0.5160524927631224,707343,0.4839475072368777,2009,2009.csv
5804,The Center of the World,1460687,1101344,0.7539904168381043,359343,0.24600958316189575,2001,2001.csv
5805,Ek Vivaah... Aisa Bhi,1456886,6437,0.004418327858185198,1450449,0.9955816721418148,2008,2008.csv
5806,Life of Crime,1456675,265452,0.1822314517651501,1191223,0.8177685482348499,2014,2014.csv
5807,Trade,1455890,214307,0.14719999450507937,1241583,0.8528000054949206,2007,2007.csv
5808,Interview,1455393,416951,0.28648688017600743,1038442,0.7135131198239926,2007,2007.csv
5809,Greed,1454763,355308,0.24423772119582365,1099455,0.7557622788041763,2020,2020.csv
5810,The Other Woman,1451343,25423,0.017516879193960354,1425920,0.9824831208060396,2010,2010.csv
5811,The Disappearance of Eleanor Rigby: Them,1448076,587774,0.4058999665763399,860302,0.5941000334236601,2014,2014.csv
5812,The City of Your Final Destination,1444401,493296,0.34152288734222697,951105,0.658477112657773,2010,2010.csv
5813,Shameless,1443479,679866,0.4709912648538704,763613,0.5290087351461296,2013,2013.csv
5814,The Dawn Wall 2018 Re-release,1442013,970032,0.6726929646265325,471981,0.3273070353734675,2018,2018.csv
5815,No Good Deed,1440653,181600,0.12605394914667167,1259053,0.8739460508533283,2002,2002.csv
5816,Why We Fight,1439972,1439972,1.0,0,0.0,2006,2006.csv
5817,Vox Lux,1439539,727119,0.5051054538987829,712420,0.49489454610121714,2018,2018.csv
5818,Tomboy,1437501,129834,0.09031924151704938,1307667,0.9096807584829506,2011,2011.csv
5819,My Friend Dahmer,1436751,1361611,0.947701445831602,75140,0.052298554168398,2017,2017.csv
5820,Restrepo,1436391,1330894,0.9265541207094725,105497,0.07344587929052744,2010,2010.csv
5821,Kai Po Che,1435272,1122527,0.7821005356475985,312745,0.21789946435240148,2013,2013.csv
5822,Monica la mitraille,1435015,1435015,1.0,0,0.0,2004,2004.csv
5823,No End in Sight,1433319,1433319,1.0,0,0.0,2007,2007.csv
5824,Peaceful Warrior,1433261,1066748,0.7442803508921264,366513,0.2557196491078736,2006,2006.csv
5825,Savage Grace,1432799,435746,0.3041222111405717,997053,0.6958777888594283,2007,2007.csv
5826,Timecode,1431406,1057750,0.7389587580323123,373656,0.2610412419676877,2000,2000.csv
5827,Food Beware: The French Organic Revolution,1429635,1181,0.000826084979732589,1428454,0.9991739150202674,2008,2008.csv
5828,I Hope They Serve Beer in Hell,1429299,1429299,1.0,0,0.0,2009,2009.csv
5829,The Devil's Hand,1428494,5746,0.004022418015056416,1422748,0.9959775819849436,2014,2014.csv
5830,The Zero Theorem,1428362,257706,0.18042064966724122,1170656,0.8195793503327587,2014,2014.csv
5831,Mere Brother Ki Dulhan,1427275,496172,0.34763587956070136,931103,0.6523641204392987,2011,2011.csv
5832,Thr3e,1420418,1008849,0.7102479692597531,411569,0.28975203074024686,2007,2007.csv
5833,Fairy Tail: Dragon Cry,1420035,519461,0.3658085892249135,900574,0.6341914107750866,2017,2017.csv
5834,Black Butterflies,1416573,0,0.0,1416573,1.0,2011,2011.csv
5835,It 2019 Re-release,1414696,1347126,0.9522370883921352,67570,0.04776291160786487,2019,2019.csv
5836,The Wolfpack,1414140,1301696,0.9204859490573777,112444,0.07951405094262237,2015,2015.csv
5837,Bombón: El Perro,1412753,19791,0.01400881824352877,1392962,0.9859911817564713,2005,2005.csv
5838,Parkland,1412181,653651,0.4628663039652849,758530,0.5371336960347151,2013,2013.csv
5839,Saint Ralph,1410952,489389,0.34685021177191006,921563,0.65314978822809,2005,2005.csv
5840,The U.S. vs. John Lennon,1408065,1109146,0.7877093742121279,298919,0.212290625787872,2006,2006.csv
5841,Lost in La Mancha,1407019,732393,0.5205281520718625,674626,0.4794718479281374,2002,2002.csv
5842,Lazer Team,1406538,1186426,0.8435079606807637,220112,0.1564920393192363,2016,2016.csv
5843,Just a Sigh,1406331,75531,0.053707839761763056,1330800,0.9462921602382369,2013,2013.csv
5844,El Chicano,1404646,1400603,0.9971216947188117,4043,0.002878305281188285,2019,2019.csv
5845,Haider,1404307,1048143,0.7463773946864894,356164,0.2536226053135105,2014,2014.csv
5846,Universal Soldier: Day of Reckoning,1402307,5460,0.0038935839299097845,1396847,0.9961064160700902,2012,2012.csv
5847,Born to Be Blue 2016 Re-release,1401411,678203,0.4839429689077651,723208,0.5160570310922349,2016,2016.csv
5848,10 Items or Less,1399222,83291,0.0595266512390457,1315931,0.9404733487609543,2006,2006.csv
5849,Leonard Cohen: I'm Your Man,1398424,1044254,0.7467363260355944,354170,0.25326367396440563,2006,2006.csv
5850,Criminal,1398053,929233,0.664662212376784,468820,0.335337787623216,2004,2004.csv
5851,For Sama,1396596,43796,0.031359104565672535,1352800,0.9686408954343275,2019,2019.csv
5852,Maggie,1394052,187112,0.1342216789617604,1206940,0.8657783210382396,2015,2015.csv
5853,White Material,1392434,304020,0.21833709892174422,1088414,0.7816629010782558,2010,2010.csv
5854,Holiday: A Soldier is Never Off Duty,1390054,706893,0.5085363590191461,683161,0.491463640980854,2014,2014.csv
5855,Roméo et Juliette,1386582,1386582,1.0,0,0.0,2006,2006.csv
5856,"Oslo, August 31st",1386378,101475,0.07319432362602407,1284903,0.9268056763739759,2011,2011.csv
5857,"For a Good Time, Call...",1386088,1251749,0.9030804681953816,134339,0.09691953180461847,2012,2012.csv
5858,National Lampoon's Christmas Vacation 2019 Re-release,1385620,1385620,1.0,0,0.0,2019,2019.csv
5859,Climates,1385085,119958,0.08660695913969178,1265127,0.9133930408603083,2006,2006.csv
5860,House of Tolerance,1384443,19327,0.013960126924691013,1365116,0.9860398730753089,2011,2011.csv
5861,Silver City,1384395,1020656,0.7372577913095613,363739,0.2627422086904388,2004,2004.csv
5862,Snow Cake,1381665,26651,0.01928904618702797,1355014,0.980710953812972,2006,2006.csv
5863,Sometimes Always Never,1377856,0,0.0,1377856,1.0,2018,2018.csv
5864,Swimming with Men,1377748,24708,0.0179336134039026,1353040,0.9820663865960974,2018,2018.csv
5865,Ma ma,1375709,47258,0.03435174153836313,1328451,0.9656482584616368,2015,2015.csv
5866,Khoobsurat,1375623,710508,0.5164990698759762,665115,0.4835009301240238,2014,2014.csv
5867,Umrao Jaan,1371723,485000,0.353569926289783,886723,0.646430073710217,2006,2006.csv
5868,A Good Old Fashioned Orgy,1369485,200227,0.14620605556103206,1169258,0.8537939444389679,2011,2011.csv
5869,Sarileru Neekevvaru,1366335,821000,0.600877530034728,545335,0.39912246996527206,2020,2020.csv
5870,The Salvation,1363964,44903,0.03292095685809889,1319061,0.9670790431419011,2014,2014.csv
5871,Little Italy,1362536,990230,0.726755109589765,372306,0.27324489041023503,2018,2018.csv
5872,Gimme Shelter,1362018,1359910,0.9984522965188419,2108,0.0015477034811581052,2014,2014.csv
5873,Agent Vinod,1361471,698210,0.512835014480661,663261,0.487164985519339,2012,2012.csv
5874,Blame it on Fidel,1360243,168065,0.12355512948789298,1192178,0.8764448705121071,2006,2006.csv
5875,The Bank,1360012,88414,0.06500972050246616,1271598,0.9349902794975339,2001,2001.csv
5876,Chasing Ice,1358668,1328467,0.9777716116078394,30201,0.022228388392160556,2012,2012.csv
5877,Raavan,1356461,708726,0.5224816636821847,647735,0.47751833631781526,2010,2010.csv
5878,Foxtrot,1356159,618883,0.45634988227781553,737276,0.5436501177221845,2018,2018.csv
5879,Papa,1356033,26677,0.019672825071366258,1329356,0.9803271749286337,2016,2016.csv
5880,Griffin & Phoenix,1355967,0,0.0,1355967,1.0,2007,2007.csv
5881,The Secrets of Jonathan Sperry,1355079,1355079,1.0,0,0.0,2009,2009.csv
5882,Le dernier tunnel,1352489,1352489,1.0,0,0.0,2004,2004.csv
5883,The Oscar Nominated Short Films 2011: Live Action,1352152,1352152,1.0,0,0.0,2011,2011.csv
5884,Unforgivable,1351146,154189,0.11411720124990193,1196957,0.885882798750098,2011,2011.csv
5885,Lost in Beijing,1350967,11163,0.008262970153971193,1339804,0.9917370298460289,2007,2007.csv
5886,The Teacher,1350426,64437,0.04771605404516797,1285989,0.952283945954832,2016,2016.csv
5887,The Snowtown Murders,1349387,8452,0.006263584872241989,1340935,0.993736415127758,2011,2011.csv
5888,The Cokeville Miracle,1348456,1348456,1.0,0,0.0,2015,2015.csv
5889,Bolshoi Ballet: The Nutcracker,1348248,252935,0.18760272590799318,1095313,0.8123972740920068,2019,2019.csv
5890,The Gathering,1346475,0,0.0,1346475,1.0,2003,2003.csv
5891,Ashoka the Great,1340718,731277,0.5454368480172564,609441,0.45456315198274355,2001,2001.csv
5892,Bonneville,1338570,488393,0.36486175545544874,850177,0.6351382445445513,2008,2008.csv
5893,The Rider Named Death,1338136,3375,0.0025221651610897546,1334761,0.9974778348389103,2004,2004.csv
5894,Student of the Year,1337281,670086,0.5010809246523356,667195,0.4989190753476644,2012,2012.csv
5895,Barney Thomson,1336254,0,0.0,1336254,1.0,2015,2015.csv
5896,Godard Mon Amour,1335846,82264,0.06158194881745351,1253582,0.9384180511825465,2017,2017.csv
5897,Darna Mana Hai,1335493,132348,0.09910048199428975,1203145,0.9008995180057102,2003,2003.csv
5898,Mandy,1335484,1214525,0.9094268444998218,120959,0.0905731555001782,2018,2018.csv
5899,Sarah Silverman: Jesus Is Magic,1333799,1324339,0.9929074770636356,9460,0.007092522936364475,2005,2005.csv
5900,Julia,1333241,65108,0.04883438178093833,1268133,0.9511656182190616,2008,2008.csv
5901,Great Performances at the Met: Rossini: Semiramide,1332900,1033651,0.7754902843424113,299249,0.2245097156575887,2018,2018.csv
5902,Ghost in the Shell: The New Movie,1332311,101203,0.0759604927077837,1231108,0.9240395072922163,2015,2015.csv
5903,Kapow,1331922,812737,0.6101986452660141,519185,0.3898013547339859,2016,2016.csv
5904,Ajami,1331651,622403,0.4673919818330779,709248,0.5326080181669222,2010,2010.csv
5905,Ballets Russes,1331363,815848,0.6127915527170276,515515,0.38720844728297243,2005,2005.csv
5906,Baar Baar Dekho,1329777,981947,0.7384298269559483,347830,0.2615701730440517,2016,2016.csv
5907,The Ultimate Life,1327841,1327841,1.0,0,0.0,2013,2013.csv
5908,The Work and the Glory III: A House Divided,1325092,1325092,1.0,0,0.0,2006,2006.csv
5909,Spirited Away 2019 Re-release,1322927,1322927,1.0,0,0.0,2019,2019.csv
5910,It's a Wonderful Afterlife,1321438,0,0.0,1321438,1.0,2010,2010.csv
5911,Catfish in Black Bean Sauce,1319592,1319592,1.0,0,0.0,2000,2000.csv
5912,Off the Map,1319492,1317167,0.9982379582445365,2325,0.0017620417554634663,2005,2005.csv
5913,Storytelling,1318945,921445,0.6986227628900371,397500,0.3013772371099629,2001,2001.csv
5914,The Look of Love,1318468,21252,0.016118707469578327,1297216,0.9838812925304217,2013,2013.csv
5915,Noi the Albino,1317132,60555,0.04597489089931761,1256577,0.9540251091006824,2003,2003.csv
5916,Before the Rains,1316722,1029655,0.7819835925882609,287067,0.21801640741173917,2008,2008.csv
5917,Erased,1314735,0,0.0,1314735,1.0,2012,2012.csv
5918,Damsels in Distress,1314358,1008455,0.7672605180628109,305903,0.2327394819371891,2012,2012.csv
5919,Saints and Soldiers,1310470,1310470,1.0,0,0.0,2004,2004.csv
5920,Air Racers,1309987,1309987,1.0,0,0.0,2012,2012.csv
5921,Come What May,1309818,37766,0.02883301344156211,1272052,0.9711669865584379,2015,2015.csv
5922,Dom Hemingway,1307599,523511,0.40036050807625273,784088,0.5996394919237472,2013,2013.csv
5923,An American Crime,1306875,0,0.0,1306875,1.0,2007,2007.csv
5924,Heights,1306281,1160817,0.8886426427391962,145464,0.11135735726080376,2005,2005.csv
5925,Something in the Air,1305473,85154,0.06522846508506878,1220319,0.9347715349149313,2012,2012.csv
5926,The High Note,1305143,0,0.0,1305143,1.0,2020,2020.csv
5927,Great Performances at the Met: Mozart: Così fan tutte,1302949,1302949,1.0,0,0.0,2018,2018.csv
5928,Les Cowboys,1302493,73725,0.056602991340452505,1228768,0.9433970086595475,2015,2015.csv
5929,Sunset Song,1302482,159714,0.12262280783918703,1142768,0.877377192160813,2015,2015.csv
5930,Jesus' Son,1302067,1302067,1.0,0,0.0,2000,2000.csv
5931,Hard to Be a God,1299035,28608,0.022022501318286265,1270427,0.9779774986817137,2014,2014.csv
5932,Eagle vs Shark,1298037,221846,0.1709088415815574,1076191,0.8290911584184426,2007,2007.csv
5933,Yamakasi,1297401,184441,0.14216190676591123,1112960,0.8578380932340888,2001,2001.csv
5934,Reprise,1297260,554826,0.4276906711067943,742434,0.5723093288932056,2006,2006.csv
5935,Paper Heart,1296971,1274062,0.9823365364375919,22909,0.017663463562408104,2009,2009.csv
5936,"War, Inc.",1296184,580862,0.4481323639236405,715322,0.5518676360763596,2008,2008.csv
5937,Slow West,1295574,229094,0.17682818580798934,1066480,0.8231718141920107,2015,2015.csv
5938,Roger Waters - Us + Them,1294480,611644,0.47250169952413323,682836,0.5274983004758668,2019,2019.csv
5939,In Search of a Midnight Kiss,1294176,172605,0.1333705771085231,1121571,0.8666294228914769,2008,2008.csv
5940,The Assistant,1293044,1100313,0.8509478409087394,192731,0.14905215909126063,2020,2020.csv
5941,No Safe Spaces,1291514,1291514,1.0,0,0.0,2019,2019.csv
5942,Under Suspicion,1291020,260562,0.20182646279685829,1030458,0.7981735372031417,2000,2000.csv
5943,The Business of Strangers,1287598,1030920,0.8006536201516312,256678,0.1993463798483688,2001,2001.csv
5944,The Cakemaker,1287568,875751,0.6801590284940291,411817,0.31984097150597096,2018,2018.csv
5945,Time Changer,1285167,1285167,1.0,0,0.0,2002,2002.csv
5946,Buddha Mar Gaya,1284490,18528,0.014424401902700683,1265962,0.9855755980972993,2007,2007.csv
5947,Festival Express,1281754,1174079,0.9159940206935184,107675,0.08400597930648158,2004,2004.csv
5948,I Spit on Your Grave,1278650,93051,0.07277284636139679,1185599,0.9272271536386032,2010,2010.csv
5949,Howl,1278390,617334,0.4828995846337972,661056,0.5171004153662028,2010,2010.csv
5950,Black Souls,1278360,101088,0.07907631653055477,1177272,0.9209236834694452,2014,2014.csv
5951,The Villain,1278108,730530,0.5715714165000141,547578,0.4284285834999859,2014,2014.csv
5952,Shed Skin Papa,1278065,13331,0.0104306119015856,1264734,0.9895693880984144,2018,2018.csv
5953,Kontroll,1277800,237183,0.18561825011738925,1040617,0.8143817498826107,2003,2003.csv
5954,Driving Lessons,1277351,239962,0.18785909276306983,1037389,0.8121409072369302,2006,2006.csv
5955,City of Ghosts,1277187,357197,0.2796747852898597,919990,0.7203252147101403,2003,2003.csv
5956,The Believer,1274112,416925,0.3272279046112116,857187,0.6727720953887885,2001,2001.csv
5957,Yellow Submarine,1273261,992305,0.7793413919062941,280956,0.22065860809370585,2018,2018.csv
5958,The Women's Balcony,1272517,1200885,0.94370841411156,71632,0.05629158588844,2017,2017.csv
5959,Beautifully Broken,1271572,1209645,0.9512988647123403,61927,0.04870113528765969,2018,2018.csv
5960,Tai ji 1: Cong ling kai shi,1271521,212094,0.16680337957454106,1059427,0.833196620425459,2012,2012.csv
5961,Texas Killing Fields,1271319,45469,0.03576521706983062,1225850,0.9642347829301694,2011,2011.csv
5962,September 11,1266063,127035,0.10033860874221899,1139028,0.899661391257781,2002,2002.csv
5963,Fagara,1265949,43417,0.03429601034480852,1222532,0.9657039896551914,2019,2019.csv
5964,Why Don't You Play in Hell?,1265872,28534,0.022540983606557378,1237338,0.9774590163934426,2013,2013.csv
5965,Batla House,1264337,493180,0.39007005252555293,771157,0.6099299474744471,2019,2019.csv
5966,Valley of Love,1264277,28648,0.02265959121300158,1235629,0.9773404087869985,2015,2015.csv
5967,Black 2005 Re-release,1263200,754819,0.5975451234958835,508381,0.40245487650411654,2005,2005.csv
5968,The Holy Girl,1261792,304124,0.24102546219979204,957668,0.758974537800208,2004,2004.csv
5969,The Flying Scotsman,1260553,171817,0.13630287659463744,1088736,0.8636971234053625,2007,2007.csv
5970,Chonda Pierce: Enough,1260116,1260116,1.0,0,0.0,2017,2017.csv
5971,Meerkats,1259616,777595,0.6173270266493915,482021,0.38267297335060846,2012,2012.csv
5972,The Music of Strangers: Yo-Yo Ma and the Silk Road Ensemble,1259588,1176781,0.9342586623562625,82807,0.06574133764373748,2016,2016.csv
5973,Gett,1259160,988150,0.7847692112201785,271010,0.21523078877982146,2014,2014.csv
5974,Bewafaa,1258036,670076,0.5326365859164602,587960,0.46736341408353976,2005,2005.csv
5975,Guy,1257937,1319,0.0010485421765954893,1256618,0.9989514578234046,2018,2018.csv
5976,Chhapaak,1257420,604334,0.48061427367148607,653086,0.519385726328514,2020,2020.csv
5977,Anna,1257142,4288,0.0034109114165305114,1252854,0.9965890885834695,2014,2014.csv
5978,For a Woman,1252416,32286,0.025778974398283,1220130,0.974221025601717,2013,2013.csv
5979,Demi-soeur,1251642,943,0.0007534103202033809,1250699,0.9992465896797966,2013,2013.csv
5980,The Singles Ward,1250798,1250798,1.0,0,0.0,2002,2002.csv
5981,MVP: Most Valuable Primate,1248746,1248746,1.0,0,0.0,2000,2000.csv
5982,Turn It Up,1247949,1247949,1.0,0,0.0,2000,2000.csv
5983,The Ledge,1247188,9216,0.007389423246535406,1237972,0.9926105767534646,2011,2011.csv
5984,Midnight's Children,1243980,190022,0.15275325969870898,1053958,0.847246740301291,2012,2012.csv
5985,Slumber,1243832,0,0.0,1243832,1.0,2017,2017.csv
5986,1945,1240663,1006193,0.811012337758118,234470,0.18898766224188196,2017,2017.csv
5987,Dark Blue Almost Black 2007 Re-release,1239969,6646,0.005359811414640205,1233323,0.9946401885853597,2007,2007.csv
5988,Seducing Doctor Lewis 2004 Re-release,1239278,489838,0.3952607889432395,749440,0.6047392110567604,2004,2004.csv
5989,Bubba Ho-Tep,1239183,1239183,1.0,0,0.0,2003,2003.csv
5990,Nuit de noces,1238180,1238180,1.0,0,0.0,2001,2001.csv
5991,Saving Face,1236518,1187266,0.9601687965723104,49252,0.03983120342768969,2005,2005.csv
5992,Beyond the Mask,1236094,1236094,1.0,0,0.0,2015,2015.csv
5993,The Blue Room,1232900,254666,0.2065585205612783,978234,0.7934414794387217,2014,2014.csv
5994,The Cut,1232140,28066,0.02277825571769442,1204074,0.9772217442823056,2014,2014.csv
5995,Life,1231606,0,0.0,1231606,1.0,2015,2015.csv
5996,True to the Game,1231040,1231040,1.0,0,0.0,2017,2017.csv
5997,Exiled,1230135,51957,0.04223682766525625,1178178,0.9577631723347437,2006,2006.csv
5998,Steve McQueen: American Icon,1229782,1229782,1.0,0,0.0,2017,2017.csv
5999,Sex and Death 101,1229330,23624,0.019216971846452945,1205706,0.980783028153547,2007,2007.csv
6000,Casablanca 2011 Re-release,1226808,1155330,0.9417366042608134,71478,0.05826339573918657,2011,2011.csv
6001,Rory O'Shea Was Here,1226577,23844,0.01943946446085325,1202733,0.9805605355391468,2004,2004.csv
6002,BTS World Tour 'Love Yourself: Speak Yourself' (The Final) Seoul Live Viewing,1226552,1226552,1.0,0,0.0,2019,2019.csv
6003,That Sugar Film,1226399,3500,0.0028538836055802394,1222899,0.9971461163944197,2015,2015.csv
6004,The Revolution Has Begun,1223419,738525,0.6036566376686973,484894,0.3963433623313027,2013,2013.csv
6005,Santa vs. the Snowman 3D 2005 Re-release,1222538,1222538,1.0,0,0.0,2005,2005.csv
6006,Lebanon,1220376,368088,0.30161851757163366,852288,0.6983814824283663,2009,2009.csv
6007,Seraphim Falls,1220058,418296,0.34284927437875906,801762,0.657150725621241,2007,2007.csv
6008,Sister,1218174,154659,0.12695969541297056,1063515,0.8730403045870294,2012,2012.csv
6009,Alexandra's Project,1217812,752148,0.617622424479312,465664,0.3823775755206879,2003,2003.csv
6010,Ilo Ilo,1216181,56773,0.04668137390733781,1159408,0.9533186260926622,2013,2013.csv
6011,When We Leave,1214076,19631,0.016169498449849926,1194445,0.9838305015501501,2010,2010.csv
6012,Woman Thou Art Loosed: On the 7th Day,1213128,1213128,1.0,0,0.0,2012,2012.csv
6013,Clandestine Childhood,1212354,9017,0.007437596609571132,1203337,0.9925624033904289,2012,2012.csv
6014,Uncle Boonmee Who Can Recall His Past Lives,1212206,184292,0.15203026548292947,1027914,0.8479697345170706,2010,2010.csv
6015,Margaret Cho: I'm the One That I Want,1210967,1210967,1.0,0,0.0,2000,2000.csv
6016,Kochadaiiyaan,1210580,817192,0.6750417155413108,393388,0.32495828445868924,2014,2014.csv
6017,Casino Jack,1209709,1042959,0.862156931956363,166750,0.13784306804363694,2010,2010.csv
6018,The Way He Looks,1207841,101451,0.08399367135243795,1106390,0.916006328647562,2014,2014.csv
6019,Noble 2014 Re-release,1207386,347321,0.2876635972257422,860065,0.7123364027742578,2014,2014.csv
6020,Alone in Berlin,1205598,33125,0.02747599116786856,1172473,0.9725240088321314,2016,2016.csv
6021,Encounters at the End of the World,1205464,944933,0.7838749228512838,260531,0.21612507714871618,2008,2008.csv
6022,National Theater Live: Cyrano de Bergerac,1205310,86300,0.07159983738623259,1119010,0.9284001626137675,2019,2019.csv
6023,Inequality for All,1205273,1205273,1.0,0,0.0,2013,2013.csv
6024,Meek's Cutoff,1205257,977772,0.8112560225744385,227485,0.1887439774255615,2011,2011.csv
6025,In the Land of Blood and Honey,1203699,303877,0.25245264804573236,899822,0.7475473519542677,2011,2011.csv
6026,Mumbai Meri Jaan,1203043,16407,0.013637916516699735,1186636,0.9863620834833002,2008,2008.csv
6027,Boy A,1202375,113662,0.09453124025366462,1088713,0.9054687597463353,2008,2008.csv
6028,"Beats, Rhymes & Life: The Travels of A Tribe Called Quest",1200326,1200326,1.0,0,0.0,2011,2011.csv
6029,Army of Crime,1199877,37031,0.030862330055497354,1162846,0.9691376699445027,2009,2009.csv
6030,The Affair of the Necklace,1198113,471210,0.39329345395634635,726903,0.6067065460436536,2001,2001.csv
6031,Phantom,1197759,1034589,0.8637705915797752,163170,0.13622940842022477,2013,2013.csv
6032,No Entry,1197530,678000,0.5661653570265464,519530,0.4338346429734537,2005,2005.csv
6033,Spirited Away 2017 Re-release,1196791,1196791,1.0,0,0.0,2017,2017.csv
6034,The Captain,1196669,109226,0.09127503094005109,1087443,0.9087249690599489,2018,2018.csv
6035,Yi Yi,1196218,1136776,0.9503083886047526,59442,0.04969161139524735,2000,2000.csv
6036,Great Performances at the Met: Saint-Saëns: Samson et Dalila,1195758,1195758,1.0,0,0.0,2018,2018.csv
6037,Repentance,1194961,1189612,0.9955237032840403,5349,0.0044762967159597674,2014,2014.csv
6038,The First Grader,1194710,332000,0.27789170593700563,862710,0.7221082940629944,2011,2011.csv
6039,When You're Strange,1194182,246078,0.20606406728622606,948104,0.7939359327137739,2010,2010.csv
6040,Joe Strummer: The Future Is Unwritten,1193491,248362,0.2080970866139753,945129,0.7919029133860247,2007,2007.csv
6041,Wendy and Lucy,1192655,865695,0.7258553395575418,326960,0.2741446604424582,2008,2008.csv
6042,Free Men,1192651,53810,0.04511797667549015,1138841,0.9548820233245099,2011,2011.csv
6043,Backstage,1191835,1191835,1.0,0,0.0,2000,2000.csv
6044,Indigo,1190000,1190000,1.0,0,0.0,2005,2005.csv
6045,Tokyo!,1189862,351059,0.2950417779540821,838803,0.704958222045918,2008,2008.csv
6046,Time Out,1189692,448542,0.3770236330075347,741150,0.6229763669924653,2001,2001.csv
6047,Kingdom Men Rising,1188936,1188936,1.0,0,0.0,2019,2019.csv
6048,Shubh Mangal Savdhan,1188541,689874,0.5804376963016,498667,0.4195623036984,2017,2017.csv
6049,Kill the Irishman,1188194,1188194,1.0,0,0.0,2011,2011.csv
6050,Dead Snow 2: Red vs. Dead,1187477,37473,0.03155682173212618,1150004,0.9684431782678738,2014,2014.csv
6051,The Cove,1187434,857005,0.721728533964835,330429,0.2782714660351649,2009,2009.csv
6052,Los Domirriqueños 2,1187280,1187280,1.0,0,0.0,2019,2019.csv
6053,The Violin,1186247,65298,0.05504587155963303,1120949,0.944954128440367,2007,2007.csv
6054,Chuck & Buck,1182065,1055671,0.8930735619445631,126394,0.10692643805543689,2000,2000.csv
6055,Remember 2016 Re-release,1181023,637555,0.5398328398346179,543468,0.46016716016538206,2016,2016.csv
6056,Videocracy,1179676,23720,0.020107215879614403,1155956,0.9798927841203856,2009,2009.csv
6057,Alien 2019 Re-release,1178844,833658,0.7071826297627167,345186,0.2928173702372833,2014,2014.csv
6058,Fire at Sea,1178377,120933,0.10262674848541681,1057444,0.8973732515145832,2016,2016.csv
6059,House of Sand,1178175,539285,0.45772911494472385,638890,0.5422708850552762,2006,2006.csv
6060,Any Body Can Dance 2,1176958,892133,0.7579990110097387,284825,0.24200098899026135,2015,2015.csv
6061,Owning Mahowny,1176302,1011871,0.860213618611547,164431,0.13978638138845295,2003,2003.csv
6062,December Boys,1175579,50715,0.04314044398547439,1124864,0.9568595560145257,2007,2007.csv
6063,Little Manhattan,1172444,385373,0.3286920313464865,787071,0.6713079686535135,2005,2005.csv
6064,Double Dhamaal,1172240,543646,0.46376680543233467,628594,0.5362331945676653,2011,2011.csv
6065,Honeyland,1172068,815082,0.6954221086148585,356986,0.30457789138514146,2019,2019.csv
6066,Raanjhanaa,1171761,903232,0.7708329599636786,268529,0.2291670400363214,2013,2013.csv
6067,Vexille,1170351,3259,0.002784634695061567,1167092,0.9972153653049385,2007,2007.csv
6068,The Innkeepers,1169750,78396,0.06701944860012823,1091354,0.9329805513998718,2012,2012.csv
6069,Dark Tide,1167612,0,0.0,1167612,1.0,2012,2012.csv
6070,Great Performances at the Met: Verdi: Luisa Miller,1166858,1166858,1.0,0,0.0,2018,2018.csv
6071,Her & Him,1166781,857986,0.7353445076668201,308795,0.2646554923331799,2016,2016.csv
6072,You Ain't Seen Nothin' Yet,1166740,18929,0.01622383735879459,1147811,0.9837761626412054,2012,2012.csv
6073,Tulpan,1166344,158741,0.13610135603218262,1007603,0.8638986439678173,2009,2009.csv
6074,The Emperor's New Clothes,1165545,661903,0.5678914156038591,503642,0.43210858439614086,2001,2001.csv
6075,Man About Town,1165186,0,0.0,1165186,1.0,2006,2006.csv
6076,The Best Two Years,1163450,1163450,1.0,0,0.0,2004,2004.csv
6077,Vaxxed: From Cover-Up to Catastrophe,1163265,1163265,1.0,0,0.0,2016,2016.csv
6078,Groove,1162001,1115313,0.959821032856254,46688,0.040178967143746004,2000,2000.csv
6079,Trois,1161843,1161843,1.0,0,0.0,2000,2000.csv
6080,Louder Than Bombs,1160724,163807,0.14112484966279668,996917,0.8588751503372033,2015,2015.csv
6081,The Final Season,1159691,1159691,1.0,0,0.0,2007,2007.csv
6082,Where Hope Grows,1159072,1156000,0.9973496038209878,3072,0.002650396179012175,2015,2015.csv
6083,The Wizard of Oz 2009 NCM Fathom Event,1158710,1140000,0.9838527327804196,18710,0.016147267219580395,2009,2009.csv
6084,Breathe,1158695,42297,0.03650399803226906,1116398,0.9634960019677309,2014,2014.csv
6085,Darling Companion,1157257,793815,0.6859452999636209,363442,0.31405470003637914,2012,2012.csv
6086,Napping Princess,1156847,48198,0.041663245009927845,1108649,0.9583367549900722,2017,2017.csv
6087,Embrace: The Documentary,1155263,629126,0.5445738329713667,526137,0.4554261670286333,2016,2016.csv
6088,Detective Jagga,1154862,861740,0.7461843925940935,293122,0.25381560740590653,2017,2017.csv
6089,Step,1152839,1146292,0.9943209763028489,6547,0.00567902369715112,2017,2017.csv
6090,The Reckoning,1152528,257252,0.2232067246956256,895276,0.7767932753043744,2004,2004.csv
6091,Liberal Arts,1150681,327345,0.28447936482830605,823336,0.715520635171694,2012,2012.csv
6092,Les aimants,1150414,1150414,1.0,0,0.0,2004,2004.csv
6093,Humko Deewana Kar Gaye,1149417,250083,0.21757377870694447,899334,0.7824262212930555,2006,2006.csv
6094,The Goonies 2019 Re-release,1148562,864378,0.7525740882947547,284184,0.24742591170524533,2019,2019.csv
6095,Cartel Land,1145923,704352,0.6146591001315097,441571,0.3853408998684903,2015,2015.csv
6096,Sugar,1144438,1082124,0.945550567177951,62314,0.0544494328220489,2009,2009.csv
6097,Elliot the Littlest Reindeer 2018 Re-release,1142187,24262,0.021241705605124204,1117925,0.9787582943948758,2018,2018.csv
6098,House,1141018,575048,0.5039780266393694,565970,0.4960219733606306,2008,2008.csv
6099,Roma,1140769,0,0.0,1140769,1.0,2018,2018.csv
6100,The Song of Names,1138700,1077584,0.946328269078774,61116,0.05367173092122596,2019,2019.csv
6101,The Hollars,1138609,1016985,0.8931819439333433,121624,0.10681805606665677,2016,2016.csv
6102,Fathom Premieres 6 Below: Miracle on the Mountain,1135531,14838,0.01306701446283721,1120693,0.9869329855371628,2017,2017.csv
6103,"Yoo-Hoo, Mrs. Goldberg",1134623,1134623,1.0,0,0.0,2009,2009.csv
6104,Cell,1133031,0,0.0,1133031,1.0,2016,2016.csv
6105,Miral,1132843,373420,0.3296308491114832,759423,0.6703691508885168,2010,2010.csv
6106,Dancer,1131649,71917,0.06355062391253825,1059732,0.9364493760874617,2016,2016.csv
6107,Cold Souls,1131536,905209,0.7999825016614585,226327,0.2000174983385416,2009,2009.csv
6108,Stranger by the Lake,1131241,325196,0.2874683643891974,806045,0.7125316356108027,2013,2013.csv
6109,American Teen,1130270,942441,0.8338193528979801,187829,0.16618064710201988,2008,2008.csv
6110,Weekend,1128477,484592,0.4294212465118917,643885,0.5705787534881083,2011,2011.csv
6111,Red Road,1128345,154892,0.1372736175549145,973453,0.8627263824450855,2006,2006.csv
6112,Dil Bole Hadippa!,1128211,644046,0.5708559834995405,484165,0.4291440165004596,2009,2009.csv
6113,The Lady and the Duke,1128137,331051,0.29344928851726343,797086,0.7065507114827366,2001,2001.csv
6114,In the Name Of,1127938,9883,0.008762006422338816,1118055,0.9912379935776612,2013,2013.csv
6115,Tosca,1125058,69613,0.06187503222056107,1055445,0.9381249677794389,2001,2001.csv
6116,La Danse: The Paris Opera Ballet,1124838,567493,0.5045108717877597,557345,0.49548912821224034,2009,2009.csv
6117,Man-Thing,1123136,0,0.0,1123136,1.0,2005,2005.csv
6118,Paper Clips,1121744,1121744,1.0,0,0.0,2004,2004.csv
6119,The Stoning of Soraya M.,1120476,637421,0.5688841171073722,483055,0.43111588289262776,2009,2009.csv
6120,Look Away,1119537,0,0.0,1119537,1.0,2018,2018.csv
6121,Papa Hemingway in Cuba,1117399,1115615,0.9984034351203106,1784,0.00159656487968935,2016,2016.csv
6122,Flashbacks of a Fool,1117269,1664,0.0014893458961091734,1115605,0.9985106541038908,2008,2008.csv
6123,The Mill and the Cross,1116180,312187,0.2796923435288215,803993,0.7203076564711784,2011,2011.csv
6124,Fraude: México 2006,1115939,3637,0.003259138716363529,1112302,0.9967408612836365,2007,2007.csv
6125,Surveillance,1115493,27349,0.02451741068747182,1088144,0.9754825893125282,2008,2008.csv
6126,Great Performances at the Met: Donizetti: L'Elisir d'Amore,1115018,1115018,1.0,0,0.0,2018,2018.csv
6127,A War,1114663,122902,0.11025933398704361,991761,0.8897406660129564,2015,2015.csv
6128,The Selfish Giant,1114027,12189,0.01094138651935725,1101838,0.9890586134806427,2013,2013.csv
6129,Walking With The Enemy,1112592,1112592,1.0,0,0.0,2014,2014.csv
6130,Jet Lag 2003 Re-release,1112018,544964,0.49006760681931405,567054,0.509932393180686,2003,2003.csv
6131,The R.M.,1111615,1111615,1.0,0,0.0,2003,2003.csv
6132,Sordid Lives,1111273,1111273,1.0,0,0.0,2001,2001.csv
6133,The Overnight,1110522,1110522,1.0,0,0.0,2015,2015.csv
6134,Sacred Planet,1108356,1108356,1.0,0,0.0,2004,2004.csv
6135,Intimate Stories,1108009,102897,0.09286657418847681,1005112,0.9071334258115232,2002,2002.csv
6136,My Neighbor Totoro 2019 Re-release,1105564,1105564,1.0,0,0.0,2019,2019.csv
6137,"Peace, Love & Misunderstanding",1105020,590700,0.5345604604441548,514320,0.46543953955584516,2012,2012.csv
6138,American Desi,1104408,907835,0.822010525095798,196573,0.17798947490420208,2001,2001.csv
6139,The Heart Specialist,1103037,1103037,1.0,0,0.0,2011,2011.csv
6140,The Insanity of God,1102525,1102525,1.0,0,0.0,2016,2016.csv
6141,El Coyote,1101470,1101470,1.0,0,0.0,2019,2019.csv
6142,Chaar Sahibzaade 2: Rise of Banda Singh Bahadur 2016 Re-release,1100947,700723,0.6364729637303158,400224,0.3635270362696842,2016,2016.csv
6143,Beyond the Reach,1100432,45895,0.04170634805240124,1054537,0.9582936519475987,2015,2015.csv
6144,The Salvation Poem,1097750,914818,0.8333573217945798,182932,0.16664267820542017,2009,2009.csv
6145,Yaadein...,1093819,1000229,0.9144373977778774,93590,0.08556260222212267,2001,2001.csv
6146,Columbus,1093077,1017107,0.9304989492963441,75970,0.06950105070365582,2017,2017.csv
6147,Northern Soul,1092359,8886,0.008134688321330259,1083473,0.9918653116786698,2014,2014.csv
6148,Bombshell: The Hedy Lamarr Story,1092277,820300,0.7509999752809956,271977,0.24900002471900443,2017,2017.csv
6149,The Son of No One,1091132,30680,0.028117587972857547,1060452,0.9718824120271424,2011,2011.csv
6150,Snowboarder,1090565,27732,0.02542902073695745,1062833,0.9745709792630426,2003,2003.csv
6151,The Man Who Cried,1090432,747092,0.6851339652541378,343340,0.31486603474586217,2001,2001.csv
6152,The Sky Is Pink,1088641,652592,0.5994556515876216,436049,0.40054434841237835,2019,2019.csv
6153,Terror's Advocate,1086656,47724,0.04391822251015961,1038932,0.9560817774898404,2007,2007.csv
6154,Tycoon: A New Russian,1086121,123159,0.1133934432719743,962962,0.8866065567280257,2002,2002.csv
6155,Sunset,1083299,164906,0.15222574746215034,918393,0.8477742525378497,2018,2018.csv
6156,Undiscovered,1082784,1069318,0.9875635399119307,13466,0.012436460088069274,2005,2005.csv
6157,Jesus Is King,1082629,973000,0.8987381642280042,109629,0.10126183577199577,2019,2019.csv
6158,Mystify: Michael Hutchence,1082456,289573,0.2675147996777698,792883,0.7324852003222302,2019,2019.csv
6159,Flight of the Red Balloon 2008 Re-release,1080135,461674,0.42742249811366173,618461,0.5725775018863383,2008,2008.csv
6160,Grace Is Gone,1080022,50899,0.047127743694109936,1029123,0.9528722563058901,2007,2007.csv
6161,The Statement,1079822,765637,0.7090400084458365,314185,0.2909599915541636,2003,2003.csv
6162,The Cup,1079108,1079108,1.0,0,0.0,2000,2000.csv
6163,Page One: Inside the New York Times,1077982,1067028,0.9898384203075747,10954,0.010161579692425291,2011,2011.csv
6164,Turtles Can Fly,1075553,258578,0.24041400098368002,816975,0.75958599901632,2005,2005.csv
6165,Merci pour tout,1073969,1073969,1.0,0,0.0,2019,2019.csv
6166,The Salton Sea,1073198,764554,0.7124072165620883,308644,0.2875927834379117,2002,2002.csv
6167,The First Monday in May,1072943,527474,0.4916141864013279,545469,0.5083858135986721,2016,2016.csv
6168,Killing Season,1071322,39881,0.03722596940975729,1031441,0.9627740305902427,2013,2013.csv
6169,Chal Mera Putt 2,1070997,445000,0.4155006970140906,625997,0.5844993029859094,2020,2020.csv
6170,When Brendan Met Trudy,1069648,133376,0.12469148729301602,936272,0.875308512706984,2001,2001.csv
6171,September Dawn,1066555,1066555,1.0,0,0.0,2007,2007.csv
6172,Au nom de ma fille,1066493,1623,0.001521810269734541,1064870,0.9984781897302655,2016,2016.csv
6173,The Oogieloves in the Big Balloon Adventure,1065907,1065907,1.0,0,0.0,2012,2012.csv
6174,50 to 1,1064454,1064454,1.0,0,0.0,2014,2014.csv
6175,La Mission,1062941,1062941,1.0,0,0.0,2010,2010.csv
6176,Family Law,1062915,38605,0.03631993150910468,1024310,0.9636800684908953,2006,2006.csv
6177,The Girlfriend Experience,1060941,695840,0.6558705903532808,365101,0.3441294096467193,2009,2009.csv
6178,Carlos,1059369,145526,0.1373704535435717,913843,0.8626295464564283,2010,2010.csv
6179,Bamako,1059232,112351,0.1060683589619649,946881,0.8939316410380351,2006,2006.csv
6180,Bennett's War,1056416,1056416,1.0,0,0.0,2019,2019.csv
6181,Borgman,1052010,57474,0.05463256052699119,994536,0.9453674394730088,2013,2013.csv
6182,All Over the Guy,1051948,1022324,0.971838912189576,29624,0.02816108781042409,2001,2001.csv
6183,The Ten Commandments,1051907,952820,0.9058025091571783,99087,0.09419749084282165,2007,2007.csv
6184,No One Lives,1048704,74918,0.07143865189796167,973786,0.9285613481020383,2013,2013.csv
6185,Reservation,1048507,651096,0.6209743950207295,397411,0.3790256049792705,2011,2011.csv
6186,Extremedays,1047553,1047553,1.0,0,0.0,2001,2001.csv
6187,Princess Mononoke 2019 Re-release,1046446,1046446,1.0,0,0.0,2019,2019.csv
6188,King of California,1045786,268461,0.2567073952032251,777325,0.7432926047967748,2007,2007.csv
6189,A Tale of Two Sisters,1045252,72541,0.06940048906866478,972711,0.9305995109313352,2003,2003.csv
6190,A Brilliant Young Mind,1043620,171793,0.16461259845537649,871827,0.8353874015446235,2015,2015.csv
6191,Made In Mexico,1042673,151133,0.14494764897527795,891540,0.855052351024722,2012,2012.csv
6192,Khatta Meetha,1040814,541904,0.5206540265599809,498910,0.47934597344001906,2010,2010.csv
6193,Spark: A Space Tail,1040689,196458,0.18877685840822764,844231,0.8112231415917723,2017,2017.csv
6194,Befikre,1040421,498000,0.4786523916760619,542421,0.5213476083239381,2016,2016.csv
6195,The Time That Remains,1037505,32869,0.03168081117681361,1004636,0.9683191888231863,2009,2009.csv
6196,The Dark Crystal 2018 Re-release,1036956,1036956,1.0,0,0.0,2018,2018.csv
6197,Swept Away,1036520,598645,0.5775527727395515,437875,0.4224472272604484,2002,2002.csv
6198,Noah,1035603,1035603,1.0,0,0.0,2019,2019.csv
6199,The Brothers Solomon,1035056,900926,0.8704128085823376,134130,0.12958719141766242,2007,2007.csv
6200,Unconditional,1034448,1005800,0.9723060028150279,28648,0.02769399718497208,2012,2012.csv
6201,Relic,1033872,966111,0.9344590045963137,67761,0.06554099540368634,2020,2020.csv
6202,Margaret Cho: Notorious C.H.O.,1033395,1033395,1.0,0,0.0,2002,2002.csv
6203,Urbania,1032075,1032075,1.0,0,0.0,2000,2000.csv
6204,Ain't Them Bodies Saints,1031243,396519,0.38450588270659775,634724,0.6154941172934022,2013,2013.csv
6205,We Are Family,1031070,638144,0.6189143317136567,392926,0.3810856682863433,2010,2010.csv
6206,The Bubble,1029926,157121,0.15255562050089036,872805,0.8474443794991097,2007,2007.csv
6207,The Eyes of Tammy Faye,1029591,1029591,1.0,0,0.0,2000,2000.csv
6208,Up the Yangtze,1029211,783969,0.7617184425739717,245242,0.2382815574260283,2008,2008.csv
6209,Breaking News,1028420,0,0.0,1028420,1.0,2004,2004.csv
6210,La Bohème,1026897,54464,0.053037451662630235,972433,0.9469625483373698,2008,2008.csv
6211,Knight of Cups,1026288,566006,0.5515079587796018,460282,0.44849204122039815,2015,2015.csv
6212,Ma tante Aline,1025852,1025852,1.0,0,0.0,2007,2007.csv
6213,Casablanca 2017 Re-release,1024560,1024560,1.0,0,0.0,2017,2017.csv
6214,Tangerines,1024132,144501,0.14109606964727203,879631,0.8589039303527279,2015,2015.csv
6215,Great Performances at the Met: Puccini: La Fanciulla del West,1023233,1023233,1.0,0,0.0,2018,2018.csv
6216,"The Bread, My Sweet",1023156,1023156,1.0,0,0.0,2001,2001.csv
6217,Pinjar,1022336,66290,0.06484169588080631,956046,0.9351583041191937,2003,2003.csv
6218,Ma Mère,1022148,71616,0.07006421770624215,950532,0.9299357822937578,2004,2004.csv
6219,The Taste of Others,1021938,891369,0.8722339319997886,130569,0.12776606800021137,2000,2000.csv
6220,Conversations with God,1021803,425045,0.4159754864685267,596758,0.5840245135314733,2006,2006.csv
6221,Leaves of Grass,1018753,70066,0.06877623918653492,948687,0.9312237608134651,2010,2010.csv
6222,The Oscar Nominated Short Films 2010: Live Action,1018169,1018169,1.0,0,0.0,2010,2010.csv
6223,On a Clear Day,1017257,191033,0.1877922688170246,826224,0.8122077311829754,2005,2005.csv
6224,Husband Material,1016545,567417,0.5581818807824543,449128,0.4418181192175457,2018,2018.csv
6225,Savage Messiah,1015671,1015671,1.0,0,0.0,2002,2002.csv
6226,Two Family House,1015122,1015122,1.0,0,0.0,2000,2000.csv
6227,Jesus Camp,1013596,902544,0.8904376102510271,111052,0.10956238974897296,2006,2006.csv
6228,Assassination Tango,1013272,1013272,1.0,0,0.0,2003,2003.csv
6229,Big Stone Gap,1012804,1009301,0.9965412853819693,3503,0.0034587146180307345,2015,2015.csv
6230,Transit,1012747,815290,0.8050283042062825,197457,0.19497169579371748,2018,2018.csv
6231,Perfect Creature,1012639,0,0.0,1012639,1.0,2007,2007.csv
6232,L'attesa,1010766,55804,0.05520961330317799,954962,0.944790386696822,2015,2015.csv
6233,Elvis: The Comeback Special,1010657,1010657,1.0,0,0.0,2018,2018.csv
6234,Far from Men,1010485,5336,0.0052806325675294535,1005149,0.9947193674324706,2015,2015.csv
6235,Cold Blood,1009888,5083,0.005033231407839285,1004805,0.9949667685921607,2019,2019.csv
6236,The Song,1009620,1009620,1.0,0,0.0,2014,2014.csv
6237,Francofonia,1008154,307040,0.3045566451157264,701114,0.6954433548842737,2015,2015.csv
6238,Sidewalls,1008116,2377,0.0023578635791912834,1005739,0.9976421364208087,2011,2011.csv
6239,Lilya 4-Ever,1007747,184023,0.18260833324237136,823724,0.8173916667576286,2002,2002.csv
6240,The Princess and the Warrior,1004858,872091,0.8678748639111198,132767,0.1321251360888802,2001,2001.csv
6241,Ghost House,1004155,0,0.0,1004155,1.0,2017,2017.csv
6242,Faith of Our Fathers,1004105,1004105,1.0,0,0.0,2015,2015.csv
6243,Kiki's Delivery Service 2019 Re-release,1004057,1004057,1.0,0,0.0,2019,2019.csv
6244,Color Out of Space,1002270,765561,0.7638271124547278,236709,0.23617288754527224,2020,2020.csv
6245,Valentin 2003 Re-release,1002172,275968,0.2753698965846182,726204,0.7246301034153818,2003,2003.csv
6246,The Workshop,1000056,22061,0.022059764653179423,977995,0.9779402353468206,2017,2017.csv
6247,Yella,999588,30647,0.030659631768288533,968941,0.9693403682317114,2007,2007.csv
6248,Gabbar is Back,998582,534601,0.5353601406794835,463981,0.4646398593205165,2015,2015.csv
6249,National Theatre Live: Antony & Cleopatra,998079,83672,0.08383304327613346,914407,0.9161669567238665,2018,2018.csv
6250,The Son,997544,70262,0.07043498833134178,927282,0.9295650116686582,2002,2002.csv
6251,"Polina, danser sa vie",996425,165203,0.16579571969792006,831222,0.8342042803020799,2016,2016.csv
6252,Photograph,996171,344534,0.34585829139776203,651637,0.654141708602238,2019,2019.csv
6253,Burn,996103,996103,1.0,0,0.0,2012,2012.csv
6254,Long Live Freedom 2014 Re-release,995990,48541,0.04873643309671784,947449,0.9512635669032822,2014,2014.csv
6255,Duma,994790,870067,0.8746237899456166,124723,0.12537621005438335,2005,2005.csv
6256,Child's Pose,994126,97170,0.09774414913200137,896956,0.9022558508679986,2013,2013.csv
6257,Labyrinth 2018 Re-release,993336,993336,1.0,0,0.0,2013,2013.csv
6258,Blue Ruin,993313,258384,0.2601234454799243,734929,0.7398765545200757,2014,2014.csv
6259,All Access: Front Row. Backstage. Live!,992683,992683,1.0,0,0.0,2001,2001.csv
6260,Beyond Skyline,992181,0,0.0,992181,1.0,2017,2017.csv
6261,First Descent,988368,750805,0.7596411458080391,237563,0.2403588541919609,2005,2005.csv
6262,Blackthorn,987883,200558,0.20301796872706585,787325,0.7969820312729341,2011,2011.csv
6263,The 11th Hour,985207,707343,0.717963839071383,277864,0.28203616092861705,2007,2007.csv
6264,The Greatest,985181,114766,0.1164922993845801,870415,0.8835077006154199,2010,2010.csv
6265,American Masters: Miles Davis: Birth of the Cool,984499,614201,0.6238716342017615,370298,0.3761283657982385,2019,2019.csv
6266,Being Flynn,983124,540152,0.5494240807873676,442972,0.4505759192126324,2012,2012.csv
6267,The Duchess of Langeais,982795,282749,0.28769885886680335,700046,0.7123011411331966,2007,2007.csv
6268,Schindler's List 2018 Re-release,981489,833050,0.8487614226955167,148439,0.15123857730448328,2018,2018.csv
6269,Mr. Pip,977855,1714,0.0017528161128183626,976141,0.9982471838871816,2013,2013.csv
6270,Stuck in Love.,977671,81071,0.08292257824973841,896600,0.9170774217502616,2013,2013.csv
6271,Saraband,975181,645634,0.6620658113724529,329547,0.3379341886275471,2004,2004.csv
6272,Conversations with Other Women,973525,379418,0.3897362676870137,594107,0.6102637323129864,2006,2006.csv
6273,Who Killed Bambi?,973173,14532,0.014932596773646618,958641,0.9850674032263533,2003,2003.csv
6274,35 Shots of Rum,971841,177511,0.18265436424271048,794330,0.8173456357572895,2009,2009.csv
6275,Journey's End,970809,161796,0.166661001288616,809013,0.8333389987113841,2018,2018.csv
6276,An American Rhapsody,970676,850255,0.8759410967202238,120421,0.12405890327977616,2001,2001.csv
6277,The Irishman,968853,0,0.0,968853,1.0,2019,2019.csv
6278,Trishna,967672,240381,0.24841165188204267,727291,0.7515883481179573,2012,2012.csv
6279,Tyson,964920,887918,0.9201985656842018,77002,0.0798014343157982,2009,2009.csv
6280,Chup Chup Ke,962812,334618,0.34754240703273326,628194,0.6524575929672667,2006,2006.csv
6281,Fanboys,961203,688529,0.716320069745933,272674,0.283679930254067,2009,2009.csv
6282,More Than a Game,960387,950675,0.9898874099711887,9712,0.010112590028811302,2009,2009.csv
6283,Ryuichi Sakamoto: Coda,960212,117460,0.12232715275376688,842752,0.8776728472462332,2018,2018.csv
6284,Rush: Cinema Strangiato 2019,960073,960073,1.0,0,0.0,2019,2019.csv
6285,A Prayer Before Dawn,958883,14453,0.015072746101453462,944430,0.9849272538985465,2018,2018.csv
6286,The Nightmare Before Christmas 2009 3D Release,957826,406085,0.42396531311532576,551741,0.5760346868846743,2009,2009.csv
6287,Eight Miles High,957744,2616,0.002731418834260512,955128,0.9972685811657395,2007,2007.csv
6288,The Endless,956425,272020,0.2844133099824869,684405,0.7155866900175132,2018,2018.csv
6289,The Fighting Preacher,954641,954641,1.0,0,0.0,2019,2019.csv
6290,The Catcher Was a Spy,953953,725223,0.7602292775430236,228730,0.2397707224569764,2018,2018.csv
6291,The Farewell Party,951531,172860,0.1816651270426292,778671,0.8183348729573708,2015,2015.csv
6292,Anvil: The Story of Anvil,951380,667911,0.7020443986629948,283469,0.2979556013370052,2009,2009.csv
6293,Gimme Danger,950040,440627,0.4637983663845733,509413,0.5362016336154267,2016,2016.csv
6294,Under the Tree,944991,67596,0.07153083997625374,877395,0.9284691600237462,2017,2017.csv
6295,Paprika,944915,882267,0.9336998566008583,62648,0.06630014339914173,2007,2007.csv
6296,The Dinner,944808,7282,0.0077073860509225154,937526,0.9922926139490775,2014,2014.csv
6297,Gray Matters,944479,71561,0.0757676983818592,872918,0.9242323016181409,2007,2007.csv
6298,Rebel in the Rye,944370,378294,0.4005781632199244,566076,0.5994218367800757,2017,2017.csv
6299,Dark Horse 2016 Re-release,944061,940715,0.9964557375000133,3346,0.0035442624999867593,2016,2016.csv
6300,Afterimage,943029,33443,0.03546338447704153,909586,0.9645366155229584,2017,2017.csv
6301,Goodbye Solo,942209,870781,0.9241909173017876,71428,0.07580908269821239,2009,2009.csv
6302,The Road,942041,92476,0.0981655787805414,849565,0.9018344212194586,2011,2011.csv
6303,Landline,940854,940854,1.0,0,0.0,2017,2017.csv
6304,Tokyo Sonata,940430,278356,0.2959880054868518,662074,0.7040119945131482,2008,2008.csv
6305,Becoming Astrid,938766,120486,0.12834508280018664,818280,0.8716549171998134,2018,2018.csv
6306,Revenge,938055,102091,0.10883263774512156,835964,0.8911673622548785,2018,2018.csv
6307,Becky,936456,936456,1.0,0,0.0,2020,2020.csv
6308,Kaili Blues,935236,32164,0.034391319410287884,903072,0.9656086805897122,2016,2016.csv
6309,Barely Lethal,933847,6075,0.006505348306521304,927772,0.9934946516934787,2015,2015.csv
6310,Perfect Sense,933352,2959,0.0031702937369824033,930393,0.9968297062630176,2011,2011.csv
6311,A Borrowed Identity,930958,281540,0.30241965802968557,649418,0.6975803419703145,2015,2015.csv
6312,Simpatico,929606,929606,1.0,0,0.0,2000,2000.csv
6313,White Christmas 2018 Re-release,928298,928298,1.0,0,0.0,2018,2018.csv
6314,Santa vs. the Snowman 3D 2006 Re-release,928275,928275,1.0,0,0.0,2006,2006.csv
6315,Like Arrows,928265,817990,0.8812031047168642,110275,0.11879689528313574,2018,2018.csv
6316,Toni Morrison: The Pieces I Am,927495,903018,0.9736095612375268,24477,0.026390438762473115,2019,2019.csv
6317,Aimee & Jaguar,927107,927107,1.0,0,0.0,2000,2000.csv
6318,How I Live Now,925762,60213,0.06504155495688957,865549,0.9349584450431104,2013,2013.csv
6319,Patterns of Evidence: Exodus,925576,925576,1.0,0,0.0,2015,2015.csv
6320,The Uniform,924170,587877,0.6361134856141186,336293,0.3638865143858814,2004,2004.csv
6321,The Yards,924036,889352,0.9624646658788186,34684,0.03753533412118142,2000,2000.csv
6322,Gentleman,923884,897876,0.9718492797797126,26008,0.028150720220287397,2016,2016.csv
6323,ATM,921752,3010,0.003265520443676824,918742,0.9967344795563232,2012,2012.csv
6324,Paradise,921242,14873,0.01614450926032465,906369,0.9838554907396754,2017,2017.csv
6325,Hideaway,920225,34525,0.03751799831562933,885700,0.9624820016843707,2009,2009.csv
6326,Riverdance 25th Anniversary Show,919732,81879,0.08902484636828989,837853,0.9109751536317101,2020,2020.csv
6327,Palo Alto,919591,767732,0.8348624551566947,151859,0.16513754484330534,2014,2014.csv
6328,Back to 1942,918487,312954,0.3407277402946367,605533,0.6592722597053633,2012,2012.csv
6329,Kirk Cameron: Connect,918127,918127,1.0,0,0.0,2018,2018.csv
6330,Faithless,918033,739055,0.8050418666867095,178978,0.19495813331329048,2001,2001.csv
6331,Hasee Toh Phasee,916906,646035,0.7045814947224688,270871,0.29541850527753116,2014,2014.csv
6332,The Lodgers,916727,7362,0.00803074415829358,909365,0.9919692558417064,2018,2018.csv
6333,The Ballad of Jack and Rose,916051,712275,0.7775495032481816,203776,0.2224504967518184,2005,2005.csv
6334,Memories of Murder,914793,15357,0.016787404363610127,899436,0.9832125956363899,2003,2003.csv
6335,Jellyfish,910314,341221,0.374838791889392,569093,0.6251612081106079,2007,2007.csv
6336,Kings,910269,274635,0.3017075172284237,635634,0.6982924827715763,2018,2018.csv
6337,Battle in Seattle,908847,224169,0.2466520767521926,684678,0.7533479232478074,2008,2008.csv
6338,Seymour: An Introduction,907742,743541,0.8191104961541936,164201,0.1808895038458064,2015,2015.csv
6339,Go Go Tales,907456,0,0.0,907456,1.0,2008,2008.csv
6340,Sholem Aleichem: Laughing in the Darkness,906666,906666,1.0,0,0.0,2011,2011.csv
6341,The Dead Lands,906158,5240,0.0057826560048026944,900918,0.9942173439951973,2014,2014.csv
6342,Jerichow,905600,60379,0.06667292402826855,845221,0.9333270759717315,2009,2009.csv
6343,The Dead Girl,905291,19875,0.021954266639124878,885416,0.9780457333608751,2006,2006.csv
6344,Bitter Harvest,904399,557241,0.6161450864054472,347158,0.38385491359455287,2017,2017.csv
6345,The Celestine Prophecy,903680,617236,0.6830249645892351,286444,0.3169750354107649,2006,2006.csv
6346,Looking for Comedy in the Muslim World,902312,888975,0.9852190816480331,13337,0.014780918351966947,2006,2006.csv
6347,Generation Iron,901649,849521,0.9421859282270595,52128,0.05781407177294047,2013,2013.csv
6348,The Great Buck Howard,900689,750587,0.833347581684688,150102,0.16665241831531194,2009,2009.csv
6349,A Song for Martin,900626,27983,0.031070610886205816,872643,0.9689293891137942,2001,2001.csv
6350,Starting Out in the Evening,898786,898786,1.0,0,0.0,2007,2007.csv
6351,The Wildest Dream,898137,898137,1.0,0,0.0,2010,2010.csv
6352,The Game Changers,897992,739711,0.8237389642669423,158281,0.17626103573305776,2019,2019.csv
6353,The Disappearance of Alice Creed,896919,166980,0.1861706575510163,729939,0.8138293424489836,2010,2010.csv
6354,A Woman's Life,895944,37626,0.04199592831694838,858318,0.9580040716830516,2016,2016.csv
6355,Place Vendôme,895788,895788,1.0,0,0.0,2000,2000.csv
6356,You're Not You,894964,11486,0.01283403578244488,883478,0.9871659642175551,2014,2014.csv
6357,Best of Enemies: Buckley vs. Vidal,892802,892802,1.0,0,0.0,2015,2015.csv
6358,Lucky: No Time for Love,891789,453507,0.5085362120411892,438282,0.4914637879588109,2005,2005.csv
6359,Personal Velocity,890502,811299,0.9110580324356374,79203,0.08894196756436257,2002,2002.csv
6360,Believe,890303,890303,1.0,0,0.0,2016,2016.csv
6361,Mafia Inc,889863,889863,1.0,0,0.0,2020,2020.csv
6362,Alone Yet Not Alone,887851,887851,1.0,0,0.0,2013,2013.csv
6363,The Future,887172,568662,0.6409828082942203,318510,0.3590171917057797,2011,2011.csv
6364,La otra conquista,886410,886410,1.0,0,0.0,2000,2000.csv
6365,Revanche,886407,258388,0.29150040556990187,628019,0.7084995944300981,2008,2008.csv
6366,Code 46,886018,285585,0.3223241514280748,600433,0.6776758485719252,2004,2004.csv
6367,The Nightingale,885916,400209,0.4517459894617548,485707,0.5482540105382452,2019,2019.csv
6368,The Claim,885836,669258,0.7555100492641978,216578,0.24448995073580213,2000,2000.csv
6369,Gaz Bar Blues,884664,884664,1.0,0,0.0,2003,2003.csv
6370,Princess Kaiulani,883887,883887,1.0,0,0.0,2010,2010.csv
6371,Pandora's Box,881950,881950,1.0,0,0.0,2002,2002.csv
6372,Emma Smith: My Story,881787,881787,1.0,0,0.0,2008,2008.csv
6373,Venom,881779,881779,1.0,0,0.0,2005,2005.csv
6374,Ai Weiwei: Never Sorry,881661,534100,0.6057883925908031,347561,0.394211607409197,2012,2012.csv
6375,No One Knows About Persian Cats,879937,81768,0.09292483439155304,798169,0.9070751656084469,2009,2009.csv
6376,The Hummingbird Project,876980,371784,0.423936691828776,505196,0.576063308171224,2019,2019.csv
6377,Between Me and My Mind,875191,875191,1.0,0,0.0,2019,2019.csv
6378,The Polar Express 2017 IMAX Release,875150,875150,1.0,0,0.0,2017,2017.csv
6379,After Dark's Horrorfest 2,874635,874635,1.0,0,0.0,2007,2007.csv
6380,Lajja,871706,376000,0.43133808875928353,495706,0.5686619112407165,2001,2001.csv
6381,Particle Fever,869838,869838,1.0,0,0.0,2014,2014.csv
6382,Death of a President,869352,519086,0.5970953077694651,350266,0.40290469223053493,2006,2006.csv
6383,Mirrormask,866999,866999,1.0,0,0.0,2005,2005.csv
6384,The Other Side of the Bed 2003 Re-release,866250,113543,0.1310741702741703,752707,0.8689258297258298,2003,2003.csv
6385,Bird People,866211,32111,0.037070644450370636,834100,0.9629293555496293,2014,2014.csv
6386,Howl's Moving Castle 2019 Re-release,865647,865647,1.0,0,0.0,2019,2019.csv
6387,Great Performances at the Met: Nico Muhly: Marnie,865551,849710,0.981698363239139,15841,0.018301636760861002,2018,2018.csv
6388,The Battle of Algiers 2004 Re-release,865058,822941,0.9513130911453336,42117,0.048686908854666394,2004,2004.csv
6389,Latter Days,865028,834685,0.9649225227391484,30343,0.03507747726085167,2004,2004.csv
6390,Brave,861630,527193,0.6118554367884127,334437,0.38814456321158736,2010,2010.csv
6391,Love,861057,249083,0.2892758551408327,611974,0.7107241448591672,2015,2015.csv
6392,Highway,858783,529136,0.6161463373168775,329647,0.3838536626831225,2014,2014.csv
6393,Night Moves,858513,271755,0.3165415083988245,586758,0.6834584916011756,2014,2014.csv
6394,Sarah Landon and the Paranormal Hour,858415,858415,1.0,0,0.0,2007,2007.csv
6395,Himalaya,857100,132007,0.15401586746003967,725093,0.8459841325399603,2000,2000.csv
6396,Steel Magnolias 2019 Re-release,855421,855421,1.0,0,0.0,2019,2019.csv
6397,Chain Letter,855185,138788,0.16229003081204652,716397,0.8377099691879535,2010,2010.csv
6398,A Touch of Sin,854891,154120,0.18028029304320667,700771,0.8197197069567933,2013,2013.csv
6399,Happythankyoumoreplease,853862,216110,0.2530971046843635,637752,0.7469028953156365,2011,2011.csv
6400,I'm Going Home,853526,140872,0.1650471104570921,712654,0.8349528895429079,2002,2002.csv
6401,Down in the Valley,852872,568932,0.6670778264499245,283940,0.33292217355007553,2006,2006.csv
6402,Brigham City,852206,852206,1.0,0,0.0,2001,2001.csv
6403,Silent Light,851621,60200,0.07068872186101564,791421,0.9293112781389844,2007,2007.csv
6404,The Sea of Trees,850985,20444,0.02402392521607314,830541,0.9759760747839269,2016,2016.csv
6405,31,850419,779820,0.9169832753031153,70599,0.08301672469688472,2016,2016.csv
6406,Wilson,848646,653951,0.7705816088215817,194695,0.22941839117841833,2017,2017.csv
6407,Atlas Shrugged: Who Is John Galt?,846704,846704,1.0,0,0.0,2014,2014.csv
6408,Monty Python's Life of Brian 2004 Re-release,846635,646951,0.7641439345172358,199684,0.2358560654827641,2004,2004.csv
6409,The Polar Express 2015 IMAX Release,846602,846602,1.0,0,0.0,2015,2015.csv
6410,Plastic Planet,846200,3164,0.003739068778066651,843036,0.9962609312219334,2009,2009.csv
6411,Lizzie,844786,642157,0.7601416216651318,202629,0.23985837833486823,2018,2018.csv
6412,Alone with Her,844377,10787,0.012775099274376256,833590,0.9872249007256237,2007,2007.csv
6413,American Masters: Sketches of Frank Gehry,844333,439309,0.5203030084101888,405024,0.4796969915898111,2006,2006.csv
6414,Fugitive Pieces,843945,635783,0.7533464858491963,208162,0.24665351415080367,2008,2008.csv
6415,Heartbeats,843423,68723,0.08148105991892561,774700,0.9185189400810744,2010,2010.csv
6416,Higher Ground 2011 Re-release,843370,841733,0.9980589776729075,1637,0.001941022327092498,2011,2011.csv
6417,Gunday,843232,0,0.0,843232,1.0,2014,2014.csv
6418,Mary Kom,839840,621300,0.739783768336826,218540,0.2602162316631739,2014,2014.csv
6419,BANDSTAND: The Broadway Musical on Screen,839554,839554,1.0,0,0.0,2018,2018.csv
6420,Hôtel Normandy,836709,4640,0.005545536142195196,832069,0.9944544638578048,2013,2013.csv
6421,Khiladi 786,835095,379466,0.4543986013567319,455629,0.5456013986432682,2012,2012.csv
6422,The Exception,834572,708973,0.8495048959227005,125599,0.1504951040772995,2017,2017.csv
6423,Premam,834525,828278,0.9925143045445014,6247,0.007485695455498637,2016,2016.csv
6424,Blind Dating,834457,90560,0.10852566399466959,743897,0.8914743360053304,2007,2007.csv
6425,Children's Party,832150,6330,0.0076068016583548635,825820,0.9923931983416452,2011,2011.csv
6426,Blow Dry,830286,637769,0.7681317040152429,192517,0.23186829598475706,2001,2001.csv
6427,Gold Diggers,829140,527000,0.6355983308005886,302140,0.3644016691994114,2004,2004.csv
6428,Byzantium,828284,89237,0.10773720124981287,739047,0.8922627987501871,2013,2013.csv
6429,Detective Byomkesh Bakshy!,827437,579055,0.6998176296201403,248382,0.30018237037985973,2015,2015.csv
6430,Mary,827179,0,0.0,827179,1.0,2005,2005.csv
6431,13 Sins,826913,13809,0.01669945931434141,813104,0.9833005406856586,2014,2014.csv
6432,I.O.U.S.A.,826799,821046,0.9930418396732459,5753,0.006958160326754144,2008,2008.csv
6433,The Shape of Things,826617,735992,0.890366397013369,90625,0.10963360298663105,2003,2003.csv
6434,K: Missing Kings,826323,33531,0.04057856310425826,792792,0.9594214368957418,2014,2014.csv
6435,The Saddest Music in the World,824777,699225,0.8477746105917114,125552,0.15222538940828853,2004,2004.csv
6436,Inside,824414,0,0.0,824414,1.0,2017,2017.csv
6437,The King of Staten Island,824139,0,0.0,824139,1.0,2020,2020.csv
6438,The Thing About My Folks,823337,816403,0.9915781751579243,6934,0.008421824842075602,2005,2005.csv
6439,Que Leones,822828,822828,1.0,0,0.0,2019,2019.csv
6440,Leonera,822504,14739,0.01791966969157597,807765,0.982080330308424,2008,2008.csv
6441,Grbavica: The Land of My Dreams,820170,43460,0.052989014472609335,776710,0.9470109855273907,2006,2006.csv
6442,The Groomsmen,818970,128911,0.15740625419734544,690059,0.8425937458026546,2006,2006.csv
6443,The Lord of the Rings: The Return of the King 2011 Re-release,818580,818580,1.0,0,0.0,2011,2011.csv
6444,Break Ke Baad,816988,427628,0.5234201726341146,389360,0.47657982736588544,2010,2010.csv
6445,Life Itself,815645,810454,0.9936357116147343,5191,0.0063642883852656484,2014,2014.csv
6446,Saw 10th Anniversary Release,815324,815324,1.0,0,0.0,2014,2014.csv
6447,What If...,814906,814906,1.0,0,0.0,2010,2010.csv
6448,Tangerine,814868,702354,0.861923648983639,112514,0.13807635101636093,2015,2015.csv
6449,Charly,814666,814666,1.0,0,0.0,2002,2002.csv
6450,Age of Uprising: The Legend of Michael Kohlhaas,813550,3313,0.004072275828160531,810237,0.9959277241718395,2013,2013.csv
6451,The Heiresses,811196,78473,0.09673740994778081,732723,0.9032625900522192,2018,2018.csv
6452,Army of Shadows,810532,741766,0.9151594261546737,68766,0.08484057384532628,2006,2006.csv
6453,Bangistan,810419,48694,0.06008496839289306,761725,0.939915031607107,2015,2015.csv
6454,So Close,810243,76584,0.094519792210485,733659,0.905480207789515,2002,2002.csv
6455,Bill W.,809590,809590,1.0,0,0.0,2012,2012.csv
6456,Joni 75: A Birthday Celebration,808831,752205,0.9299903193621412,56626,0.07000968063785884,2019,2019.csv
6457,The Whistlers,808743,55608,0.06875855494267029,753135,0.9312414450573298,2019,2019.csv
6458,Breathing,807436,4630,0.005734200605373057,802806,0.9942657993946269,2011,2011.csv
6459,Behind the Sun,805755,19861,0.02464893174724327,785894,0.9753510682527567,2001,2001.csv
6460,V/H/S/2,805574,21833,0.027102413930936202,783741,0.9728975860690638,2013,2013.csv
6461,My Year Without Sex,805283,3119,0.0038731725368597127,802164,0.9961268274631403,2009,2009.csv
6462,About Adam,802951,159668,0.19885148657888216,643283,0.8011485134211178,2001,2001.csv
6463,Mean Creek,802948,603951,0.7521670145513781,198997,0.24783298544862184,2004,2004.csv
6464,The Tillman Story,802535,802535,1.0,0,0.0,2010,2010.csv
6465,The Wrecking Crew!,801606,801606,1.0,0,0.0,2015,2015.csv
6466,My Mother Likes Women 2004 Re-release,801048,82916,0.10350940268248594,718132,0.896490597317514,2004,2004.csv
6467,Chunhyang,798977,798977,1.0,0,0.0,2000,2000.csv
6468,Red Army,798680,694600,0.8696849802173586,104080,0.13031501978264134,2015,2015.csv
6469,Wakefield,798214,262599,0.32898320500517403,535615,0.6710167949948259,2017,2017.csv
6470,13 Tzameti,795223,121390,0.15264900537333553,673833,0.8473509946266645,2006,2006.csv
6471,Twin Sisters 2004 Re-release,794365,1563,0.001967609348347422,792802,0.9980323906516526,2004,2004.csv
6472,Vita & Virginia,793439,42741,0.05386803522387985,750698,0.9461319647761202,2019,2019.csv
6473,The Shining 2019 Re-release,792620,551257,0.6954871186697282,241363,0.30451288133027177,2019,2019.csv
6474,Santa vs. the Snowman 3D 2007 Re-release,792252,769405,0.9711619535198397,22847,0.02883804648016035,2007,2007.csv
6475,Tickled,790519,613956,0.7766492645970559,176563,0.22335073540294414,2016,2016.csv
6476,Thin Ice,790421,790421,1.0,0,0.0,2012,2012.csv
6477,The King of Kong: A Fistful of Quarters,790128,677914,0.857979972865156,112214,0.14202002713484396,2007,2007.csv
6478,Lootera,789671,581813,0.7367789877050063,207858,0.26322101229499373,2013,2013.csv
6479,Momentum,789406,0,0.0,789406,1.0,2015,2015.csv
6480,Trembling Before G-d,788896,788896,1.0,0,0.0,2001,2001.csv
6481,Chonda Pierce: Unashamed,787979,787979,1.0,0,0.0,2019,2019.csv
6482,Elf 2019 Re-release,786249,786249,1.0,0,0.0,2019,2019.csv
6483,The Ten,785528,769726,0.9798835942194295,15802,0.020116405780570522,2007,2007.csv
6484,The Wedding Weekend 2007 Re-release,785292,21908,0.027897902945655882,763384,0.9721020970543441,2007,2007.csv
6485,George Takei's Allegiance,784850,784850,1.0,0,0.0,2017,2017.csv
6486,Life During Wartime,783232,281447,0.3593405274554666,501785,0.6406594725445334,2010,2010.csv
6487,Party Monster,782606,742898,0.9492618252351758,39708,0.05073817476482419,2003,2003.csv
6488,Redacted,782102,65388,0.08360546322602423,716714,0.9163945367739758,2007,2007.csv
6489,The Paris Opera,781039,55482,0.07103614544216102,725557,0.928963854557839,2017,2017.csv
6490,The Wonder of It All,781016,781016,1.0,0,0.0,2009,2009.csv
6491,Futuro Beach,779835,20262,0.025982419357941103,759573,0.9740175806420589,2014,2014.csv
6492,Blonde and Blonder,779273,42183,0.054131222305918464,737090,0.9458687776940815,2008,2008.csv
6493,Panic,779137,779137,1.0,0,0.0,2000,2000.csv
6494,Foolproof,779036,458990,0.5891768801441782,320046,0.4108231198558218,2003,2003.csv
6495,Mrs. Hyde,778142,18627,0.023937790274782753,759515,0.9760622097252173,2018,2018.csv
6496,Enter the Void,775385,336467,0.43393539983363105,438918,0.566064600166369,2010,2010.csv
6497,The D Train,774780,673151,0.8688285706910349,101629,0.13117142930896514,2015,2015.csv
6498,New Waterford Girl,774469,774469,1.0,0,0.0,2000,2000.csv
6499,Morvern Callar,772336,267907,0.34687881958111494,504429,0.653121180418885,2002,2002.csv
6500,The Church,772000,772000,1.0,0,0.0,2019,2019.csv
6501,The Girl Next Door,771792,771792,1.0,0,0.0,2000,2000.csv
6502,Grand Masti,770535,413903,0.5371631398963058,356632,0.4628368601036942,2013,2013.csv
6503,Pariah,769552,769552,1.0,0,0.0,2011,2011.csv
6504,Passion of Mind,769272,769272,1.0,0,0.0,2000,2000.csv
6505,The Lord of the Rings: The Fellowship of the Ring 2011 Re-release,768580,768580,1.0,0,0.0,2011,2011.csv
6506,Theeb,768449,283024,0.3683055088886836,485425,0.6316944911113165,2015,2015.csv
6507,Little Ashes,767567,481586,0.6274188442181594,285981,0.37258115578184053,2009,2009.csv
6508,Yalom's Cure,766974,1164,0.0015176524888718523,765810,0.9984823475111282,2014,2014.csv
6509,Lo and Behold: Reveries of the Connected World,765796,594912,0.7768544103129293,170884,0.2231455896870707,2016,2016.csv
6510,Fat Girl,765705,725854,0.9479551524412143,39851,0.052044847558785697,2001,2001.csv
6511,DanTDM Presents The Contest,765363,307484,0.4017492353301636,457879,0.5982507646698364,2019,2019.csv
6512,Patterns of Evidence: Moses Controversy,765361,765361,1.0,0,0.0,2019,2019.csv
6513,The Polar Express 2016 IMAX Release,765154,765154,1.0,0,0.0,2016,2016.csv
6514,The Lord of the Rings: The Two Towers 2011 Re-release,764607,764607,1.0,0,0.0,2011,2011.csv
6515,Kahlil Gibran's The Prophet,764498,355343,0.4648056633241683,409155,0.5351943366758317,2015,2015.csv
6516,The Invisibles,764250,407373,0.5330363101079489,356877,0.466963689892051,2018,2018.csv
6517,Chronicle of an Escape,763742,2370,0.0031031421605725493,761372,0.9968968578394275,2006,2006.csv
6518,Texas Rangers,763740,623374,0.8162123235656114,140366,0.18378767643438867,2001,2001.csv
6519,Pick of the Litter,763688,578717,0.7577924492724778,184971,0.24220755072752223,2018,2018.csv
6520,Broken Wings,760318,421454,0.5543128006965506,338864,0.44568719930344936,2003,2003.csv
6521,The Shining 2017 Re-release,760309,421572,0.5544745623161109,338737,0.445525437683889,2017,2017.csv
6522,Rocket Science,759676,714943,0.9411156861609423,44733,0.058884313839057706,2007,2007.csv
6523,Museo,759626,148505,0.19549752114856522,611121,0.8045024788514348,2018,2018.csv
6524,Bombay Velvet,758478,450692,0.59420576470247,307786,0.40579423529753006,2015,2015.csv
6525,Uzak,757008,96293,0.12720209033458035,660715,0.8727979096654197,2003,2003.csv
6526,Boundaries,755977,703438,0.9305018538923803,52539,0.06949814610761967,2018,2018.csv
6527,I Love Lucy: A Colorized Celebration,754323,754323,1.0,0,0.0,2019,2019.csv
6528,Middle Men,754301,754301,1.0,0,0.0,2010,2010.csv
6529,How About You,754184,78234,0.10373330646102277,675950,0.8962666935389773,2007,2007.csv
6530,Malamaal Weekly,754009,204612,0.27136546115497295,549397,0.728634538845027,2006,2006.csv
6531,The Passenger 2005 Re-release,751607,620155,0.825105407480239,131452,0.174894592519761,2005,2005.csv
6532,Tommy's Honour,751345,569306,0.7577158296122287,182039,0.24228417038777125,2017,2017.csv
6533,Little Secrets,750582,405792,0.5406364661023046,344790,0.4593635338976954,2002,2002.csv
6534,A Five Star Life 2014 Re-release,749653,306917,0.4094120879927113,442736,0.5905879120072887,2014,2014.csv
6535,Cronicas,749607,300322,0.40063926830992774,449285,0.5993607316900723,2005,2005.csv
6536,Everybody's Everything,748539,547207,0.731033386369982,201332,0.26896661363001795,2019,2019.csv
6537,Hobo with a Shotgun,748453,703372,0.9397677609682906,45081,0.060232239031709406,2011,2011.csv
6538,Arthur Newman,747140,207853,0.27819819578659954,539287,0.7218018042134005,2013,2013.csv
6539,The Bride of Humpty Sharma,746788,380011,0.5088606137216988,366777,0.4911393862783012,2014,2014.csv
6540,Another Gay Movie,745327,654132,0.8776443091421617,91195,0.12235569085783823,2006,2006.csv
6541,Holy Rollers,744266,303064,0.40719850161098314,441202,0.5928014983890169,2010,2010.csv
6542,C.S.A.: The Confederate States of America,744165,672156,0.9032351696196408,72009,0.0967648303803592,2005,2005.csv
6543,Saturday's Warrior,744046,744046,1.0,0,0.0,2016,2016.csv
6544,Fade to Black,742076,728921,0.9822727052215676,13155,0.0177272947784324,2004,2004.csv
6545,Jurassic Park 2020 Re-release,741600,741600,1.0,0,0.0,2020,2020.csv
6546,The Cross,741557,741557,1.0,0,0.0,2009,2009.csv
6547,The King,740210,282183,0.3812201942691939,458027,0.6187798057308062,2006,2006.csv
6548,Scarface 2003 Re-release,739905,739905,1.0,0,0.0,2003,2003.csv
6549,"Kumiko, The Treasure Hunter",739623,623383,0.8428388516852504,116240,0.15716114831474953,2015,2015.csv
6550,Forks Over Knives,739561,739561,1.0,0,0.0,2011,2011.csv
6551,Vicky Donor,739085,549001,0.7428117198968995,190084,0.25718828010310046,2012,2012.csv
6552,Kadosh,736812,736812,1.0,0,0.0,2000,2000.csv
6553,Ordinary Love,735716,323688,0.4399632466875805,412028,0.5600367533124194,2019,2019.csv
6554,Ramen Shop,735008,88455,0.12034562889111411,646553,0.8796543711088859,2018,2018.csv
6555,Wiener-Dog,734729,477453,0.6498355175853955,257276,0.35016448241460457,2016,2016.csv
6556,David Crosby: Remember My Name,732793,732793,1.0,0,0.0,2019,2019.csv
6557,Once I Was a Beehive,732655,732655,1.0,0,0.0,2015,2015.csv
6558,Tabloid,731925,696921,0.9521754278102265,35004,0.04782457218977354,2011,2011.csv
6559,The Polar Express 2018 Re-release,731018,731018,1.0,0,0.0,2018,2018.csv
6560,Slaughterhouse Rulez,730762,4665,0.006383747376026668,726097,0.9936162526239734,2018,2018.csv
6561,How I Ended This Summer,730412,8733,0.011956265778765957,721679,0.988043734221234,2010,2010.csv
6562,Land Ho!,727594,727594,1.0,0,0.0,2014,2014.csv
6563,Peggy Guggenheim: Art Addict,727591,498428,0.6850387099345648,229163,0.3149612900654351,2015,2015.csv
6564,Deep Water,727202,271143,0.372857885429358,456059,0.627142114570642,2006,2006.csv
6565,Liz and the Blue Bird,726454,63204,0.08700344412722623,663250,0.9129965558727737,2018,2018.csv
6566,Motherhood,726354,93388,0.128570917211167,632966,0.871429082788833,2009,2009.csv
6567,Bullett Raja,725588,0,0.0,725588,1.0,2013,2013.csv
6568,May It Last,725286,725286,1.0,0,0.0,2017,2017.csv
6569,A Tale of Love and Darkness,724885,572212,0.7893831435331121,152673,0.21061685646688785,2015,2015.csv
6570,Levity,723040,209695,0.2900185328612525,513345,0.7099814671387475,2003,2003.csv
6571,The Act of Killing,722714,486919,0.6737367755432992,235795,0.3262632244567007,2013,2013.csv
6572,Where's My Roy Cohn?,722603,705274,0.9760186437089245,17329,0.023981356291075458,2019,2019.csv
6573,Singham,722451,350864,0.4856578508438635,371587,0.5143421491561365,2011,2011.csv
6574,12 Days,722049,5204,0.007207267096831379,716845,0.9927927329031686,2017,2017.csv
6575,Time,721712,16070,0.022266499656372625,705642,0.9777335003436274,2006,2006.csv
6576,Effie Gray,721143,352534,0.4888544990383322,368609,0.5111455009616678,2014,2014.csv
6577,Joshua,719968,482355,0.6699672763233921,237613,0.33003272367660785,2007,2007.csv
6578,Forever Strong,719556,719556,1.0,0,0.0,2008,2008.csv
6579,Revive Us 2,718607,718607,1.0,0,0.0,2017,2017.csv
6580,Garage Days,716888,32500,0.045334836125029296,684388,0.9546651638749707,2002,2002.csv
6581,Free Style,716355,141108,0.19698054735431456,575247,0.8030194526456854,2008,2008.csv
6582,The Shining 2012 Re-release,715736,342749,0.4788762895816335,372987,0.5211237104183666,2012,2012.csv
6583,Passion,713616,92181,0.12917451402434924,621435,0.8708254859756508,2013,2013.csv
6584,Gerhard Richter Painting,713188,242646,0.34022726125509684,470542,0.6597727387449032,2011,2011.csv
6585,Shanghai Ghetto,712446,712446,1.0,0,0.0,2002,2002.csv
6586,Shootout at Wadala,711366,369573,0.5195258137161461,341793,0.48047418628385385,2013,2013.csv
6587,The Polar Express 2011 IMAX Release,711168,711168,1.0,0,0.0,2011,2011.csv
6588,Extraction,710636,16775,0.023605615251690037,693861,0.97639438474831,2015,2015.csv
6589,Inside Deep Throat,709832,691880,0.974709508728826,17952,0.025290491271174026,2005,2005.csv
6590,Kaal,709777,345091,0.4861963687186257,364686,0.5138036312813743,2005,2005.csv
6591,Muscle Shoals,709415,696241,0.9814297695988948,13174,0.018570230401105135,2013,2013.csv
6592,Paris Countdown,708757,1055,0.001488521453756365,707702,0.9985114785462437,2013,2013.csv
6593,Gori Tere Pyaar Mein!,708440,342184,0.48301055841002766,366256,0.5169894415899723,2013,2013.csv
6594,$9.99,708354,52384,0.07395172470262044,655970,0.9260482752973795,2008,2008.csv
6595,HBO Boxing: Canelo Alvarez vs. Gennady Golovkin II,707875,707875,1.0,0,0.0,2018,2018.csv
6596,Passione,707460,255355,0.3609462019054081,452105,0.639053798094592,2010,2010.csv
6597,Palindromes,707269,553368,0.7824010383602279,153901,0.21759896163977213,2005,2005.csv
6598,Bread and Roses,706876,533479,0.7546995512650027,173397,0.24530044873499737,2001,2001.csv
6599,The Lost Medallion: The Adventures of Billy Stone,705854,549632,0.7786766101771755,156222,0.22132338982282454,2013,2013.csv
6600,Itzhak,704968,607290,0.8614433562941864,97678,0.1385566437058136,2018,2018.csv
6601,Blaze,704955,704955,1.0,0,0.0,2018,2018.csv
6602,Bully,704808,480811,0.6821872055935801,223997,0.3178127944064199,2001,2001.csv
6603,Crossing the Bridge: The Sound of Istanbul,704094,70685,0.1003914250085926,633409,0.8996085749914075,2005,2005.csv
6604,Countdown to Canelo vs. Golovkin,703396,703396,1.0,0,0.0,2017,2017.csv
6605,Outsourced,703324,163561,0.23255427086236216,539763,0.7674457291376379,2007,2007.csv
6606,Buena Vista Social Club: Adios,701575,123445,0.1759541032676478,578130,0.8240458967323522,2017,2017.csv
6607,Le Quattro Volte,701334,152530,0.21748553470956777,548804,0.7825144652904322,2010,2010.csv
6608,56 Up,701278,701278,1.0,0,0.0,2013,2013.csv
6609,Our Children,700215,23203,0.033136965075012674,677012,0.9668630349249874,2012,2012.csv
6610,The Greatest Movie Ever Sold,698249,638476,0.914395867376824,59773,0.08560413262317597,2011,2011.csv
6611,49 Up,696975,241772,0.3468876215072277,455203,0.6531123784927724,2006,2006.csv
6612,Look What's Happened Now,696718,336909,0.48356580424217543,359809,0.5164341957578246,2004,2004.csv
6613,Himmatwala,696334,270880,0.3890087228255406,425454,0.6109912771744593,2013,2013.csv
6614,Patterns of Evidence: The Red Sea Miracle,696191,696191,1.0,0,0.0,2020,2020.csv
6615,Frankie & Alice 2014 Re-release,695876,695876,1.0,0,0.0,2014,2014.csv
6616,Deewane Huye Paagal,695849,364357,0.5236150371704206,331492,0.47638496282957943,2005,2005.csv
6617,Frankie,695680,171781,0.24692531048758048,523899,0.7530746895124195,2019,2019.csv
6618,The Least of These: The Graham Staines Story,695164,607015,0.8731968283743117,88149,0.12680317162568833,2019,2019.csv
6619,The Congress 2013 Re-release,695131,137815,0.19825759461166312,557316,0.8017424053883369,2013,2013.csv
6620,Jim Henson's Holiday Special with Fraggle Rock and Emmet Otter,695130,695130,1.0,0,0.0,2018,2018.csv
6621,The Secret Scripture,694981,0,0.0,694981,1.0,2017,2017.csv
6622,Delgo,694782,694782,1.0,0,0.0,2008,2008.csv
6623,In the Aisles,694586,28394,0.04087902721909166,666192,0.9591209727809084,2018,2018.csv
6624,Christmas in Wonderland,694509,689,0.0009920677773794149,693820,0.9990079322226206,2007,2007.csv
6625,Donkey Punch,694422,19367,0.027889381384806358,675055,0.9721106186151937,2008,2008.csv
6626,Raise Hell: The Life & Times of Molly Ivins,694410,694410,1.0,0,0.0,2019,2019.csv
6627,Chris Brown: Welcome To My Life,693984,693984,1.0,0,0.0,2017,2017.csv
6628,Titanic 2017 Re-release,693626,691642,0.997139668928212,1984,0.0028603310717879664,2017,2017.csv
6629,Heartbeat Detector,692575,5309,0.0076655957838501244,687266,0.9923344042161498,2007,2007.csv
6630,Close Your Eyes,691495,41392,0.059858711921272026,650103,0.940141288078728,2004,2004.csv
6631,Ferrari Ki Sawaari,689861,434107,0.6292673451608367,255754,0.37073265483916323,2012,2012.csv
6632,"The Prize Winner of Defiance, Ohio",689028,627844,0.9112024475057617,61184,0.08879755249423826,2005,2005.csv
6633,Feast,688854,56131,0.08148461067221792,632723,0.9185153893277821,2006,2006.csv
6634,Romeo Akbar Walter,688719,236299,0.34309929013138885,452420,0.6569007098686112,2019,2019.csv
6635,Happy Accidents,688523,688523,1.0,0,0.0,2001,2001.csv
6636,Mama's Boy,688145,0,0.0,688145,1.0,2007,2007.csv
6637,Cobain: Montage of Heck,687649,0,0.0,687649,1.0,2015,2015.csv
6638,Vettai,687636,204373,0.29721102443734765,483263,0.7027889755626523,2012,2012.csv
6639,Tony Manero,687406,20677,0.03007974908569317,666729,0.9699202509143068,2008,2008.csv
6640,Never Forever,687229,14485,0.021077399236644555,672744,0.9789226007633555,2007,2007.csv
6641,The Caveman's Valentine,687194,687194,1.0,0,0.0,2001,2001.csv
6642,Mr. Church,685780,685780,1.0,0,0.0,2016,2016.csv
6643,Spun,685608,411119,0.5996414860970117,274489,0.4003585139029883,2003,2003.csv
6644,Bethany Hamilton: Unstoppable,684078,590671,0.8634556293288193,93407,0.13654437067118078,2019,2019.csv
6645,Stefan Zweig: Farewell to Europe 2017 Re-release,683063,78372,0.11473612243672984,604691,0.8852638775632702,2017,2017.csv
6646,Masti,683021,308566,0.45176649034217103,374455,0.548233509657829,2004,2004.csv
6647,Brigsby Bear,681632,532669,0.7814612576874325,148963,0.21853874231256748,2017,2017.csv
6648,"Right Now, Wrong Then",680728,24470,0.035946809885886874,656258,0.9640531901141132,2015,2015.csv
6649,3 Generations,680351,155936,0.2291993397525689,524415,0.7708006602474311,2016,2016.csv
6650,Timber Falls,680299,0,0.0,680299,1.0,2007,2007.csv
6651,A Matter of Faith,680113,680113,1.0,0,0.0,2014,2014.csv
6652,I Spit on Your Grave 2,678604,809,0.0011921533029572474,677795,0.9988078466970427,2013,2013.csv
6653,All I See Is You,678150,217644,0.32093784560937844,460506,0.6790621543906216,2017,2017.csv
6654,Baaghi,676602,438207,0.6476584461766297,238395,0.3523415538233703,2016,2016.csv
6655,Tyrannosaur,676111,22321,0.03301380986258173,653790,0.9669861901374183,2011,2011.csv
6656,Towelhead,675662,372124,0.5507546672744656,303538,0.44924533272553435,2008,2008.csv
6657,Manderlay,674918,78378,0.11612966315908006,596540,0.88387033684092,2005,2005.csv
6658,Anamorph,674839,6950,0.010298752739542321,667889,0.9897012472604577,2008,2008.csv
6659,5 to 7,674579,162685,0.24116523046225868,511894,0.7588347695377413,2015,2015.csv
6660,Beyond the Hills,673493,124919,0.18547928486264892,548574,0.8145207151373511,2012,2012.csv
6661,The Trump Prophecy,671198,671198,1.0,0,0.0,2018,2018.csv
6662,Anna and the Apocalypse,670430,545597,0.8138015900243127,124833,0.18619840997568723,2018,2018.csv
6663,The Polar Express 2012 IMAX Release,669289,669289,1.0,0,0.0,2012,2012.csv
6664,Bright Days Ahead 2013 Re-release,669085,21770,0.03253697213358542,647315,0.9674630278664146,2013,2013.csv
6665,The Torn Poster Let Out a Hero,669070,410526,0.6135770547177425,258544,0.38642294528225746,2013,2013.csv
6666,Travelers and Magicians,668639,506793,0.7579471134648144,161846,0.24205288653518564,2004,2004.csv
6667,Tai Chi 2: The Hero Rises,668484,35067,0.05245750085267561,633417,0.9475424991473244,2012,2012.csv
6668,Girlfriend Boyfriend,667626,64414,0.09648216216863933,603212,0.9035178378313606,2012,2012.csv
6669,Alias Betty,667087,208400,0.31240302988965457,458687,0.6875969701103454,2001,2001.csv
6670,My Mexican Shivah,666553,13042,0.01956633606029828,653511,0.9804336639397018,2007,2007.csv
6671,Balzac and the Little Chinese Seamstress 2005 Re-release,666327,666327,1.0,0,0.0,2005,2005.csv
6672,My First Wedding,666154,14982,0.022490295036883365,651172,0.9775097049631166,2006,2006.csv
6673,Beer for My Horses,666045,666045,1.0,0,0.0,2008,2008.csv
6674,A Bottle in the Gaza Sea,666011,5872,0.008816671196121385,660139,0.9911833288038786,2012,2012.csv
6675,Mr. Gaga: A True Story of Love and Dance,665617,173994,0.2614025783596272,491623,0.7385974216403728,2016,2016.csv
6676,Stockholm,665527,292590,0.43963655869709267,372937,0.5603634413029073,2019,2019.csv
6677,The Stanford Prison Experiment,663114,660561,0.9961499832607967,2553,0.0038500167392032138,2015,2015.csv
6678,Yes,661946,396760,0.5993842398020383,265186,0.40061576019796175,2005,2005.csv
6679,Max,660763,539879,0.8170539209973924,120884,0.1829460790026076,2002,2002.csv
6680,City of Gold,660445,640979,0.9705259332722634,19466,0.0294740667277366,2016,2016.csv
6681,Camille Claudel 1915,660355,35296,0.05345003823700888,625059,0.9465499617629911,2013,2013.csv
6682,Another Happy Day,659937,8464,0.012825466673333969,651473,0.987174533326666,2011,2011.csv
6683,La femme du Vème,659769,113800,0.1724846120384559,545969,0.8275153879615441,2011,2011.csv
6684,Delirious,659589,86460,0.13108162810477433,573129,0.8689183718952257,2007,2007.csv
6685,Play the Game,659483,659483,1.0,0,0.0,2009,2009.csv
6686,Dragon Ball Z: Broly - The Legendary Super Saiyan,658982,658982,1.0,0,0.0,2018,2018.csv
6687,Madame Bovary,658532,44235,0.06717213438375053,614297,0.9328278656162495,2015,2015.csv
6688,Jaws 2020 Re-release,656367,656300,0.9998979229607826,67,0.00010207703921738905,2020,2020.csv
6689,Terri,655802,655802,1.0,0,0.0,2011,2011.csv
6690,Dekalog,655720,655720,1.0,0,0.0,2000,2000.csv
6691,The Patience Stone,654587,148671,0.22712183407247624,505916,0.7728781659275238,2013,2013.csv
6692,No Problem,654369,285468,0.4362492721996305,368901,0.5637507278003695,2010,2010.csv
6693,Whisky Galore,653866,20991,0.032102907935265025,632875,0.967897092064735,2017,2017.csv
6694,Ponyo 2018 Re-release,653072,653072,1.0,0,0.0,2018,2018.csv
6695,Rascals,652756,273829,0.4194967185288224,378927,0.5805032814711776,2011,2011.csv
6696,In Secret,652228,444179,0.6810179875748972,208049,0.3189820124251029,2013,2013.csv
6697,Where in the World Is Osama Bin Laden?,651778,384955,0.5906228807968358,266823,0.4093771192031643,2008,2008.csv
6698,Salinger,650675,583633,0.8969654589464786,67042,0.10303454105352135,2013,2013.csv
6699,Metropolis 2002 Re-release,650422,650422,1.0,0,0.0,2002,2002.csv
6700,The Extra Man,649626,453377,0.6979046405162355,196249,0.3020953594837645,2010,2010.csv
6701,The Family Fang,649555,262921,0.4047709585793351,386634,0.5952290414206649,2016,2016.csv
6702,Journey from the Fall,648483,641039,0.9885209018586455,7444,0.011479098141354515,2007,2007.csv
6703,The Oh in Ohio,648183,418689,0.6459425810303572,229494,0.3540574189696428,2006,2006.csv
6704,Jodorowsky's Dune,647280,647280,1.0,0,0.0,2014,2014.csv
6705,American Masters: The Life and Times of Allen Ginsberg 2004 Re-release,646951,646951,1.0,0,0.0,2004,2004.csv
6706,Storage 24,646175,72,0.00011142492358881108,646103,0.9998885750764112,2012,2012.csv
6707,Miss Minoes 2004 Re-release,645970,256770,0.3974952397170147,389200,0.6025047602829853,2004,2004.csv
6708,Focus,645418,645418,1.0,0,0.0,2001,2001.csv
6709,The Public,644740,573503,0.889510500356733,71237,0.11048949964326706,2019,2019.csv
6710,The Oscar Nominated Short Films 2009: Live Action,644635,644635,1.0,0,0.0,2009,2009.csv
6711,Dracula 3D,643758,8139,0.012642949679848638,635619,0.9873570503201513,2012,2012.csv
6712,The Inheritance 2003 Re-release,642318,68215,0.10620128970385385,574103,0.8937987102961461,2003,2003.csv
6713,Love and Honor,641929,19684,0.030663827308004467,622245,0.9693361726919956,2012,2012.csv
6714,Marjaavaan,641154,174164,0.2716414465167495,466990,0.7283585534832505,2019,2019.csv
6715,Dust to Glory,640013,640013,1.0,0,0.0,2005,2005.csv
6716,Museum Hours,639121,561457,0.87848310413834,77664,0.12151689586166,2012,2012.csv
6717,Aquarela,638907,307346,0.48104966763550877,331561,0.5189503323644913,2019,2019.csv
6718,Sleeping Dogs Lie,638627,15745,0.02465445400836482,622882,0.9753455459916351,2006,2006.csv
6719,Beautiful Boxer,638317,133920,0.20980171294200217,504397,0.7901982870579979,2003,2003.csv
6720,Jack Goes Boating,637479,541992,0.8502115363800219,95487,0.14978846361997808,2010,2010.csv
6721,Welcome to Me,636819,608852,0.9560832826910001,27967,0.04391671730899989,2015,2015.csv
6722,The Virginity Hit,636706,636706,1.0,0,0.0,2010,2010.csv
6723,Not Fade Away,636399,610792,0.9597626646176377,25607,0.04023733538236232,2012,2012.csv
6724,Elsa & Fred,635901,285863,0.4495401013679802,350038,0.5504598986320197,2014,2014.csv
6725,Batti Gul Meter Chalu,635869,249539,0.39243775054295776,386330,0.6075622494570423,2018,2018.csv
6726,Goya in Bordeaux,635361,635361,1.0,0,0.0,2000,2000.csv
6727,The Last Lions,635325,635325,1.0,0,0.0,2011,2011.csv
6728,Kaboom,635162,118919,0.18722625094070489,516243,0.8127737490592951,2010,2010.csv
6729,A Beautiful Life,634784,66171,0.10424175782628421,568613,0.8957582421737158,2011,2011.csv
6730,Dinner Rush,634566,634566,1.0,0,0.0,2001,2001.csv
6731,No One Killed Jessica,634297,440525,0.6945090391409703,193772,0.30549096085902977,2011,2011.csv
6732,Wassup Rockers,634074,221574,0.34944501745853007,412500,0.6505549825414699,2006,2006.csv
6733,The Black Prince,632823,0,0.0,632823,1.0,2017,2017.csv
6734,Grace Jones: Bloodlight and Bami,632394,375208,0.5933136620524546,257186,0.4066863379475454,2017,2017.csv
6735,Summer of '04,632017,20474,0.03239469824387635,611543,0.9676053017561237,2006,2006.csv
6736,Jonah: The Musical,631154,631154,1.0,0,0.0,2017,2017.csv
6737,Mera Pind: My Home,630370,176976,0.28074940114535907,453394,0.7192505988546409,2008,2008.csv
6738,Shut Up and Play the Hits,629107,510334,0.8112038174746108,118773,0.18879618252538916,2012,2012.csv
6739,Short Peace,628807,22862,0.03635773774783042,605945,0.9636422622521695,2013,2013.csv
6740,The Trumpet of the Swan,628387,102202,0.1626418114951455,526185,0.8373581885048544,2001,2001.csv
6741,Asako I & II,627102,25559,0.04075732496467879,601543,0.9592426750353212,2019,2019.csv
6742,Korkoro,627088,8242,0.013143290893782054,618846,0.9868567091062179,2010,2010.csv
6743,The Outpost,627065,0,0.0,627065,1.0,2020,2020.csv
6744,I'm Still Here,626396,408983,0.652914450283846,217413,0.347085549716154,2010,2010.csv
6745,"Love, Gilda",626318,626318,1.0,0,0.0,2018,2018.csv
6746,Sleepless Night,624913,3358,0.005373547997881305,621555,0.9946264520021187,2011,2011.csv
6747,Our Lady of the Assassins,624525,525330,0.8411672871382251,99195,0.15883271286177494,2001,2001.csv
6748,Give Me Liberty,624445,242734,0.38871958298969483,381711,0.6112804170103051,2019,2019.csv
6749,The Sound of Music 2018 Re-release,624392,616171,0.9868335917180233,8221,0.013166408281976707,2018,2018.csv
6750,Winter in Wartime 2010 Re-release,623392,543100,0.8712014270314665,80292,0.12879857296853345,2010,2010.csv
6751,Nancy Drew and the Hidden Staircase,623088,623088,1.0,0,0.0,2019,2019.csv
6752,Dirty Dancing 2019 Re-release,622968,622968,1.0,0,0.0,2017,2017.csv
6753,Sherrybaby,622806,199176,0.31980424080692865,423630,0.6801957591930714,2006,2006.csv
6754,Range 15,621738,621738,1.0,0,0.0,2016,2016.csv
6755,The Grey Zone,621592,517872,0.8331381356259411,103720,0.16686186437405887,2001,2001.csv
6756,LOC: Kargil,621103,621103,1.0,0,0.0,2003,2003.csv
6757,Die Hard 30th Anniversary Release,620525,510241,0.822273075218565,110284,0.17772692478143506,2018,2018.csv
6758,Better Than Sex,620388,19521,0.031465792375094295,600867,0.9685342076249057,2000,2000.csv
6759,"Happy, Happy",620238,45154,0.0728010860347157,575084,0.9271989139652843,2010,2010.csv
6760,The Transformers,619597,619597,1.0,0,0.0,2018,2018.csv
6761,Nowitzki: The Perfect Shot,619517,41340,0.06672940371289246,578177,0.9332705962871075,2014,2014.csv
6762,Paradise: Faith,618696,6508,0.010518897810879656,612188,0.9894811021891203,2013,2013.csv
6763,London Dreams,618067,300293,0.4858583292749815,317774,0.5141416707250185,2009,2009.csv
6764,Paulo Coelho's Best Story,617377,8808,0.014266809421147856,608569,0.9857331905788521,2014,2014.csv
6765,The Butterfly 2003 Re-release,616355,38438,0.06236341069675755,577917,0.9376365893032425,2003,2003.csv
6766,The Bronze,615816,615816,1.0,0,0.0,2016,2016.csv
6767,Lost River,615500,45431,0.07381153533712428,570069,0.9261884646628757,2015,2015.csv
6768,Omar,614444,356000,0.5793855908756534,258444,0.42061440912434656,2013,2013.csv
6769,Killerman,614366,291477,0.47443543425254653,322889,0.5255645657474535,2019,2019.csv
6770,Going Upriver: The Long War of John Kerry,614138,614138,1.0,0,0.0,2004,2004.csv
6771,Walking the Camino: Six Ways to Santiago,612717,612717,1.0,0,0.0,2013,2013.csv
6772,The Returned,612521,0,0.0,612521,1.0,2013,2013.csv
6773,The Filth and the Fury,612192,612192,1.0,0,0.0,2000,2000.csv
6774,In Another Country,611365,25079,0.04102132114203463,586286,0.9589786788579654,2012,2012.csv
6775,The Muppet Movie 2019 Re-release,610475,610475,1.0,0,0.0,2019,2019.csv
6776,Project Nim,609880,411184,0.6742047615924445,198696,0.3257952384075556,2011,2011.csv
6777,Friday Night,609542,156918,0.25743591089703416,452624,0.7425640891029658,2002,2002.csv
6778,Dead Before Dawn 3D,608881,0,0.0,608881,1.0,2012,2012.csv
6779,The Last Suit,608209,73548,0.12092553710977641,534661,0.8790744628902236,2017,2017.csv
6780,Gunner Palace,607844,607844,1.0,0,0.0,2005,2005.csv
6781,Mr. Right,607595,34694,0.057100535718694195,572901,0.9428994642813058,2016,2016.csv
6782,Dear Wendy,607229,23106,0.038051542334111184,584123,0.9619484576658888,2005,2005.csv
6783,The Reports on Sarah and Saleem,607206,117479,0.1934747021603871,489727,0.8065252978396129,2018,2018.csv
6784,Life in a Day,607169,252788,0.4163387788243471,354381,0.5836612211756529,2011,2011.csv
6785,Bolshoi Ballet: The Sleeping Beauty,606872,311368,0.513070301480378,295504,0.4869296985196219,2019,2019.csv
6786,The Walking Dead: Wrath/The Walking Dead/Fear the Walking Dead: What's Your Story?/Fear the Walking Dead,605764,605764,1.0,0,0.0,2018,2018.csv
6787,Summer in February,605403,1624,0.0026825106581896685,603779,0.9973174893418103,2013,2013.csv
6788,Shortcut to Happiness,605294,0,0.0,605294,1.0,2007,2007.csv
6789,Blue Collar Comedy Tour: The Movie,604856,604856,1.0,0,0.0,2003,2003.csv
6790,The Golden Glove,604479,6160,0.010190593883327626,598319,0.9898094061166723,2019,2019.csv
6791,Wild West Comedy Show: 30 Days & 30 Nights - Hollywood to the Heartland,603894,603894,1.0,0,0.0,2008,2008.csv
6792,The Holy Land,603520,603520,1.0,0,0.0,2003,2003.csv
6793,"DCI 2019: Big, Loud & Live 16",603320,603320,1.0,0,0.0,2018,2018.csv
6794,Undertow,602059,108620,0.1804142118961763,493439,0.8195857881038238,2010,2010.csv
6795,A Talking Picture,601815,20237,0.033626612829524026,581578,0.9663733871704759,2003,2003.csv
6796,The Little Death,601162,18238,0.03033791224328883,582924,0.9696620877567111,2014,2014.csv
6797,The Grateful Dead Meet-Up 2018,600554,600554,1.0,0,0.0,2018,2018.csv
6798,Oh Lucy!,600145,375391,0.6255005040448558,224754,0.37449949595514415,2018,2018.csv
6799,Jimi: All Is by My Side,599840,340911,0.568336556415044,258929,0.431663443584956,2014,2014.csv
6800,The Fencer 2016 Re-release,599537,95952,0.1600435002343475,503585,0.8399564997656525,2016,2016.csv
6801,The Fluffer,599523,563373,0.9397020631401964,36150,0.060297936859803544,2001,2001.csv
6802,The One I Love,596933,513447,0.8601417579527351,83486,0.13985824204726494,2014,2014.csv
6803,Fiza,596591,596591,1.0,0,0.0,2000,2000.csv
6804,Disgrace 2009 Re-release,596554,69705,0.1168460860207123,526849,0.8831539139792877,2009,2009.csv
6805,Trust,595802,120016,0.20143604754599684,475786,0.7985639524540031,2011,2011.csv
6806,Skin Trade,595268,1242,0.002086455176491933,594026,0.997913544823508,2015,2015.csv
6807,Blue Like Jazz,595018,595018,1.0,0,0.0,2012,2012.csv
6808,My First Mister,595005,568762,0.955894488281611,26243,0.04410551171838892,2001,2001.csv
6809,Ixcanul,594836,295157,0.4961989523162687,299679,0.5038010476837314,2015,2015.csv
6810,Are You Here,594396,0,0.0,594396,1.0,2014,2014.csv
6811,The Armstrong Lie,594394,383294,0.644848366571668,211100,0.35515163342833206,2013,2013.csv
6812,Boss,594283,0,0.0,594283,1.0,2013,2013.csv
6813,The Big Lebowski 2018 Re-release,592832,582585,0.9827151705710893,10247,0.01728482942891072,2018,2018.csv
6814,Not One Less,592586,592586,1.0,0,0.0,2000,2000.csv
6815,To Kill a Mockingbird 2019 Re-release,592237,592237,1.0,0,0.0,2019,2019.csv
6816,Compliance,592116,319285,0.5392271109039445,272831,0.4607728890960555,2012,2012.csv
6817,Tarnation,592014,592014,1.0,0,0.0,2004,2004.csv
6818,The Cure: Anniversary 1978-2018 Live in Hyde Park,591904,378405,0.6393013056171271,213499,0.3606986943828729,2019,2019.csv
6819,The Wonderland,591857,50876,0.08595995316436233,540981,0.9140400468356377,2019,2019.csv
6820,The Human Resources Manager,590567,64014,0.10839413648239743,526553,0.8916058635176026,2010,2010.csv
6821,The Walker,590416,79698,0.13498617923633505,510718,0.865013820763665,2007,2007.csv
6822,Refugee,590000,590000,1.0,0,0.0,2000,2000.csv
6823,Storm Surfers 3D,589945,117090,0.19847612913068166,472855,0.8015238708693183,2012,2012.csv
6824,Starry Starry Night,589299,10033,0.01702531312627376,579266,0.9829746868737262,2011,2011.csv
6825,Neither Wolf Nor Dog,589289,589289,1.0,0,0.0,2017,2017.csv
6826,Phir Bhi Dil Hai Hindustani,588606,588606,1.0,0,0.0,2000,2000.csv
6827,Elvis on Tour,587818,587818,1.0,0,0.0,2010,2010.csv
6828,A Time for Drunken Horses,587654,587654,1.0,0,0.0,2000,2000.csv
6829,Thunderstruck,587211,587211,1.0,0,0.0,2012,2012.csv
6830,Upstream Color,587174,444098,0.7563311727017885,143076,0.24366882729821143,2013,2013.csv
6831,Seberg,585845,434702,0.7420085517500363,151143,0.25799144824996373,2020,2020.csv
6832,The Piano Player,585604,585604,1.0,0,0.0,2003,2003.csv
6833,Klimt,584991,97656,0.166935901577973,487335,0.833064098422027,2006,2006.csv
6834,The Black Panthers: Vanguard of the Revolution,584109,516893,0.8849255875187679,67216,0.1150744124812321,2015,2015.csv
6835,The Opportunists,584054,584054,1.0,0,0.0,2000,2000.csv
6836,Undefeated,583844,562218,0.9629592836442611,21626,0.03704071635573886,2012,2012.csv
6837,Gleason,583664,583664,1.0,0,0.0,2016,2016.csv
6838,The Flat,583443,471842,0.8087199606473983,111601,0.1912800393526017,2012,2012.csv
6839,Forgive Me Father,582787,582787,1.0,0,0.0,2001,2001.csv
6840,White God,581904,282358,0.48523124089196845,299546,0.5147687591080315,2014,2014.csv
6841,Three Times,581875,151922,0.261090440386681,429953,0.7389095596133191,2005,2005.csv
6842,Touch of Pink,581055,564535,0.9715689564671158,16520,0.02843104353288415,2004,2004.csv
6843,Novitiate,580346,580346,1.0,0,0.0,2017,2017.csv
6844,And Then We Danced,580216,177262,0.3055103616584169,402954,0.6944896383415832,2019,2019.csv
6845,All the Real Girls,579986,549666,0.9477228760694224,30320,0.05227712393057764,2003,2003.csv
6846,Bedeviled,579942,0,0.0,579942,1.0,2017,2017.csv
6847,Viva Pedro!,579539,579539,1.0,0,0.0,2006,2006.csv
6848,Around the Bend,579350,193637,0.3342314662984379,385713,0.6657685337015621,2004,2004.csv
6849,The Painted Bird,578855,1289,0.0022268098228399166,577566,0.99777319017716,2019,2019.csv
6850,Harry & Snowman,578820,561460,0.9700079472029302,17360,0.0299920527970699,2016,2016.csv
6851,Tibet: Cry of the Snow Lion,578241,578241,1.0,0,0.0,2003,2003.csv
6852,Bilal: A New Breed of Hero 2018 Re-release,576805,490973,0.8511940777212402,85832,0.14880592227875972,2018,2018.csv
6853,Blizzard,576320,504600,0.8755552470849528,71720,0.1244447529150472,2003,2003.csv
6854,Fados,574044,129150,0.22498275393523842,444894,0.7750172460647616,2007,2007.csv
6855,Light of My Life,573790,20056,0.03495355443629202,553734,0.965046445563708,2019,2019.csv
6856,Mesrine Part 1: Killer Instinct 2010 Re-release,572790,551697,0.9631749855968156,21093,0.03682501440318441,2010,2010.csv
6857,The Twilight Samurai 2004 Re-release,572565,559765,0.9776444595810083,12800,0.02235554041899173,2004,2004.csv
6858,The Room 2017 Re-release,572340,549602,0.9602718663731349,22738,0.03972813362686515,2017,2017.csv
6859,My Father My Lord,571566,203708,0.3564032850099551,367858,0.6435967149900449,2008,2008.csv
6860,Wondrous Oblivion 2006 Re-release,571562,88560,0.15494382061788572,483002,0.8450561793821143,2006,2006.csv
6861,The Falling,569498,0,0.0,569498,1.0,2015,2015.csv
6862,Youth,567746,331166,0.5832995741053217,236580,0.41670042589467826,2004,2004.csv
6863,The Passion of the Christ Recut Release,567692,508326,0.895425688577609,59366,0.10457431142239101,2005,2005.csv
6864,Tideland,566611,66453,0.11728152118472815,500158,0.8827184788152719,2006,2006.csv
6865,Goodbye to Language,566423,401889,0.7095209763727814,164534,0.2904790236272185,2014,2014.csv
6866,Sangre de mi sangre,565024,55730,0.09863297842215552,509294,0.9013670215778444,2007,2007.csv
6867,Margaret,564864,46495,0.08231184851574892,518369,0.9176881514842511,2011,2011.csv
6868,The Goonies 2020 Re-release,564852,213000,0.3770899279811349,351852,0.6229100720188652,2019,2019.csv
6869,The Weather Underground,564632,564632,1.0,0,0.0,2003,2003.csv
6870,The Cat Returns 2018 Re-release,563718,563718,1.0,0,0.0,2018,2018.csv
6871,Poolhall Junkies,563711,563711,1.0,0,0.0,2003,2003.csv
6872,Ira & Abby,563611,221096,0.39228474958792503,342515,0.607715250412075,2007,2007.csv
6873,Like Someone in Love,562878,239056,0.4247030439988772,323822,0.5752969560011229,2012,2012.csv
6874,Beetlejuice 2018 Re-release,562613,512947,0.911722622833102,49666,0.08827737716689803,2018,2018.csv
6875,The Happiest Day in the Life of Olli Maki,562537,0,0.0,562537,1.0,2016,2016.csv
6876,Kurosawa & Mifune Festival,561692,561692,1.0,0,0.0,2002,2002.csv
6877,Kitchen Stories 2004 Re-release,561380,351235,0.6256635434108804,210145,0.3743364565891197,2004,2004.csv
6878,Me You Them,560943,323923,0.577461524611235,237020,0.422538475388765,2001,2001.csv
6879,My Fair Lady 2019 Re-release,560711,560711,1.0,0,0.0,2019,2019.csv
6880,Forrest Gump 2014 IMAX Release,559422,557683,0.9968914343733354,1739,0.003108565626664665,2014,2014.csv
6881,Fiddler: A Miracle of Miracles,558816,549386,0.9831250357899559,9430,0.016874964210044092,2019,2019.csv
6882,The Dance of Reality,558636,293680,0.5257090484680543,264956,0.47429095153194567,2013,2013.csv
6883,The Wedding Song,558489,31160,0.05579339969095184,527329,0.9442066003090481,2008,2008.csv
6884,Kusama: Infinity,558052,360931,0.6467694766795926,197121,0.35323052332040744,2018,2018.csv
6885,Castle in the Sky 2018 Re-release,557541,523664,0.9392385492726095,33877,0.060761450727390455,2018,2018.csv
6886,Rojo,557092,94757,0.1700921930309536,462335,0.8299078069690464,2018,2018.csv
6887,Tony Takitani,556268,129783,0.23331020299567834,426485,0.7666897970043216,2005,2005.csv
6888,Samaritan's Purse presents Facing Darkness,555533,555533,1.0,0,0.0,2017,2017.csv
6889,Circumstance,555511,454121,0.8174833621656457,101390,0.18251663783435432,2011,2011.csv
6890,Dolores,555309,555309,1.0,0,0.0,2017,2017.csv
6891,Every Thing Will Be Fine,554953,9233,0.01663744497281752,545720,0.9833625550271825,2015,2015.csv
6892,Water Lilies,554770,85440,0.15400976981451772,469330,0.8459902301854823,2005,2005.csv
6893,Endless Poetry,554706,153440,0.2766149996574762,401266,0.7233850003425238,2016,2016.csv
6894,American Violet,554434,554434,1.0,0,0.0,2009,2009.csv
6895,Timecrimes,553198,39127,0.07072874450016088,514071,0.9292712554998391,2008,2008.csv
6896,Viral,551760,0,0.0,551760,1.0,2016,2016.csv
6897,Open Windows,550108,1750,0.0031811935110923673,548358,0.9968188064889076,2014,2014.csv
6898,Dhadak,549628,0,0.0,549628,1.0,2018,2018.csv
6899,From Mexico with Love,549495,548787,0.9987115442360713,708,0.0012884557639286983,2009,2009.csv
6900,23 Blast,549185,549185,1.0,0,0.0,2014,2014.csv
6901,We Are X,548126,45270,0.0825904992647676,502856,0.9174095007352324,2016,2016.csv
6902,Planetarium,546584,3262,0.005967975645097551,543322,0.9940320243549025,2016,2016.csv
6903,A Girl Walks Home Alone at Night,546352,491910,0.9003536181802209,54442,0.0996463818197792,2014,2014.csv
6904,My Generation,546183,0,0.0,546183,1.0,2018,2018.csv
6905,Rudderless,546149,58293,0.10673460905357329,487856,0.8932653909464268,2014,2014.csv
6906,Masked and Anonymous,546106,533569,0.9770429184077817,12537,0.022957081592218362,2003,2003.csv
6907,"DCI 2019: Big, Loud & Live 16",546060,546060,1.0,0,0.0,2019,2019.csv
6908,Cet amour-là,545905,72844,0.13343713649810865,473061,0.8665628635018914,2002,2002.csv
6909,Nobel Son,545582,540382,0.9904688937684895,5200,0.00953110623151057,2008,2008.csv
6910,Private Property,545473,62897,0.11530726543751936,482576,0.8846927345624807,2007,2007.csv
6911,Primer,545436,424760,0.778753144273572,120676,0.22124685572642802,2004,2004.csv
6912,Boarding Gate,545436,49333,0.09044690852822329,496103,0.9095530914717767,2007,2007.csv
6913,Dog Days,545059,13031,0.02390750359135433,532028,0.9760924964086457,2002,2002.csv
6914,Honeydripper,544925,267880,0.4915905858604395,277045,0.5084094141395605,2007,2007.csv
6915,The Art of the Steal,544890,544890,1.0,0,0.0,2010,2010.csv
6916,He's Out There,544674,0,0.0,544674,1.0,2018,2018.csv
6917,Once Upon a Time in the Midlands,544512,172564,0.3169149623883404,371948,0.6830850376116596,2002,2002.csv
6918,The Day Shall Come,543993,26972,0.04958152035044568,517021,0.9504184796495543,2019,2019.csv
6919,Love & Sex,543896,543896,1.0,0,0.0,2000,2000.csv
6920,On Any Sunday: The Next Chapter,543044,543044,1.0,0,0.0,2014,2014.csv
6921,The Club,541515,52761,0.09743220409406941,488754,0.9025677959059306,2015,2015.csv
6922,Saathiya,541367,317564,0.5865965232457834,223803,0.4134034767542166,2002,2002.csv
6923,Passionada,540833,540833,1.0,0,0.0,2003,2003.csv
6924,Dragon Ball Z: Bardock - The Father of Goku/Dragon Ball Z: Fusion Reborn,540707,540707,1.0,0,0.0,2018,2018.csv
6925,On the Way to School 2015 Re-release,540658,7424,0.013731416163267722,533234,0.9862685838367323,2015,2015.csv
6926,Lymelife,540403,421307,0.7796163233734824,119096,0.22038367662651762,2009,2009.csv
6927,Lawless Heart,539596,330067,0.6116928220372279,209529,0.38830717796277214,2003,2003.csv
6928,The Last Shot,538526,464275,0.8621217917055073,74251,0.13787820829449274,2004,2004.csv
6929,Lila dit ça,537871,121365,0.22563960503540811,416506,0.7743603949645919,2005,2005.csv
6930,Kids in America,537667,537667,1.0,0,0.0,2005,2005.csv
6931,Grateful Dead Meet-Up 2019,537153,537153,1.0,0,0.0,2019,2019.csv
6932,Pretty Persuasion,537126,305800,0.5693263777958989,231326,0.4306736222041011,2005,2005.csv
6933,CatVideoFest,536566,470923,0.8776609028525848,65643,0.12233909714741523,2019,2019.csv
6934,Karwaan,536525,182009,0.3392367550440334,354516,0.6607632449559666,2018,2018.csv
6935,Intacto 2002 Re-release,535420,307333,0.5740035859698928,228087,0.4259964140301072,2002,2002.csv
6936,Hungry Hearts,534549,6921,0.012947363104224308,527628,0.9870526368957757,2015,2015.csv
6937,What They Had,533579,260136,0.4875304312950847,273443,0.5124695687049153,2018,2018.csv
6938,Creature,533235,508714,0.9540146464504393,24521,0.0459853535495607,2011,2011.csv
6939,Kill Your Friends,533147,0,0.0,533147,1.0,2015,2015.csv
6940,Noah's Arc: Jumping the Broom,532878,532878,1.0,0,0.0,2008,2008.csv
6941,Kahaani 2,532877,350703,0.6581312385409767,182174,0.3418687614590234,2016,2016.csv
6942,Followed,532839,532839,1.0,0,0.0,2020,2020.csv
6943,Everybody Wants to Be Italian,532726,351416,0.6596561834789366,181310,0.3403438165210634,2008,2008.csv
6944,Standing Ovation,531806,531806,1.0,0,0.0,2010,2010.csv
6945,Metropolis 2010 Re-release,529603,529603,1.0,0,0.0,2010,2010.csv
6946,Margaret Atwood: Live in Cinemas,529285,93690,0.177012384632098,435595,0.822987615367902,2019,2019.csv
6947,Evil,528245,15530,0.029399237096423062,512715,0.9706007629035769,2003,2003.csv
6948,Willy Wonka & the Chocolate Factory 2016 Re-release,526954,526633,0.9993908386690299,321,0.0006091613309700657,2016,2016.csv
6949,Dil Ka Rishta,526571,352128,0.6687189381868732,174443,0.33128106181312683,2003,2003.csv
6950,Only Yesterday 2016 Re-release,525958,453243,0.8617475159613506,72715,0.13825248403864948,2016,2016.csv
6951,Casa de los babys,525715,478031,0.9092968623683935,47684,0.09070313763160648,2003,2003.csv
6952,12:08 East of Bucharest,523703,91881,0.17544486092308045,431822,0.8245551390769196,2006,2006.csv
6953,The Audience 2019 Re-release,523432,106529,0.20352022803344083,416903,0.7964797719665592,2019,2019.csv
6954,Of Time and the City,523417,32677,0.06243014651797706,490740,0.9375698534820229,2008,2008.csv
6955,Trouble the Water,522766,520151,0.994997761904944,2615,0.0050022380950559145,2008,2008.csv
6956,Bolshoi Ballet: Carmen Suite/Petrushka,522179,207523,0.39741736071347183,314656,0.6025826392865282,2019,2019.csv
6957,The Cremaster Cycle,522029,514622,0.9858111330979696,7407,0.014188866902030348,2003,2003.csv
6958,The Trials of Henry Kissinger,521266,516726,0.9912904352096626,4540,0.008709564790337371,2002,2002.csv
6959,Hawayein,521260,409978,0.7865134481832483,111282,0.21348655181675172,2003,2003.csv
6960,Sound City,521181,422853,0.8113361768752123,98328,0.18866382312478774,2013,2013.csv
6961,Shadowboxer,519802,370627,0.7130157252184486,149175,0.2869842747815514,2006,2006.csv
6962,The Spy Behind Home Plate,519525,519525,1.0,0,0.0,2019,2019.csv
6963,Wild Nights with Emily,519487,519487,1.0,0,0.0,2019,2019.csv
6964,The Circle 2001 Re-release,519354,440554,0.8482730469005726,78800,0.15172695309942735,2001,2001.csv
6965,I'm Your Hero,519274,274579,0.528774789417533,244695,0.4712252105824671,2014,2014.csv
6966,The Rental,518627,403852,0.7786945145547763,114775,0.22130548544522363,2020,2020.csv
6967,Scatter My Ashes at Bergdorf's,518342,518342,1.0,0,0.0,2013,2013.csv
6968,Madison,517262,517262,1.0,0,0.0,2005,2005.csv
6969,Trespass Against Us,517197,5711,0.011042214088635472,511486,0.9889577859113645,2017,2017.csv
6970,Grave of the Fireflies,516962,516962,1.0,0,0.0,2018,2018.csv
6971,"A White, White Day",516941,0,0.0,516941,1.0,2019,2019.csv
6972,Listen to Me Marlon,516337,425831,0.824715253797423,90506,0.175284746202577,2015,2015.csv
6973,The Sandlot 2018 Re-release,516130,516130,1.0,0,0.0,2018,2018.csv
6974,"Love, Wedding, Marriage",515823,1926,0.003733838933122408,513897,0.9962661610668776,2011,2011.csv
6975,Preacher's Kid,515065,515065,1.0,0,0.0,2010,2010.csv
6976,A Hard Day's Night 2014 Re-release,515005,515005,1.0,0,0.0,2014,2014.csv
6977,Goodbye First Love,514913,95000,0.18449718690341863,419913,0.8155028130965813,2011,2011.csv
6978,The Polar Express 2009 IMAX Release,514354,514354,1.0,0,0.0,2009,2009.csv
6979,Big Eden,512451,512451,1.0,0,0.0,2001,2001.csv
6980,Mifune,512434,512434,1.0,0,0.0,2000,2000.csv
6981,Bullitt 2018 Re-release,511350,511350,1.0,0,0.0,2018,2018.csv
6982,Black Butler: Book of the Atlantic,511132,248286,0.4857571038401039,262846,0.514242896159896,2017,2017.csv
6983,Monsters and Men,510967,500101,0.9787344388189453,10866,0.021265561181054746,2018,2018.csv
6984,Unsullied,510957,510957,1.0,0,0.0,2016,2016.csv
6985,Splinter,510358,14154,0.027733473365755018,496204,0.972266526634245,2008,2008.csv
6986,Bol,509872,188850,0.3703870775410299,321022,0.62961292245897,2011,2011.csv
6987,Karmina 2,508969,508969,1.0,0,0.0,2001,2001.csv
6988,The 2007 Academy Award Nominated Short Films: Live Action,508695,508695,1.0,0,0.0,2008,2008.csv
6989,Saving Private Ryan 2019 Re-release,508694,508694,1.0,0,0.0,2019,2019.csv
6990,Una,508169,22815,0.04489648128870514,485354,0.9551035187112948,2017,2017.csv
6991,The Good Night,508084,22441,0.04416789349792554,485643,0.9558321065020745,2007,2007.csv
6992,The Other End of the Line,507534,115592,0.22775222940729095,391942,0.7722477705927091,2008,2008.csv
6993,The Inevitable Defeat of Mister & Pete,506303,494608,0.9769011836785482,11695,0.02309881632145178,2013,2013.csv
6994,Our Last Tango,505885,100086,0.19784338337764512,405799,0.8021566166223549,2015,2015.csv
6995,Gabriel and the Mountain,505769,18415,0.03640990254444223,487354,0.9635900974555578,2017,2017.csv
6996,A Town Called Panic,505699,165509,0.3272875762063995,340190,0.6727124237936005,2009,2009.csv
6997,Manna from Heaven,505675,505675,1.0,0,0.0,2002,2002.csv
6998,Have a Nice Day,504003,79393,0.15752485600284125,424610,0.8424751439971587,2018,2018.csv
6999,Letters From Baghdad,502941,359735,0.7152628240688271,143206,0.2847371759311728,2017,2017.csv
7000,Chuck,502518,320725,0.6382358442881648,181793,0.3617641557118352,2017,2017.csv
7001,Amadeus Director's Cut,502511,408749,0.8134130397145535,93762,0.1865869602854465,2002,2002.csv
7002,Shaadi No. 1,502389,336772,0.6703411101755811,165617,0.32965888982441893,2005,2005.csv
7003,Deli Man,502294,502294,1.0,0,0.0,2015,2015.csv
7004,The Triumph of Love,501442,447267,0.8919615827952186,54175,0.10803841720478141,2002,2002.csv
7005,Bride Flight 2011 Re-release,501360,501360,1.0,0,0.0,2011,2011.csv
7006,Synonyms,501223,206003,0.411000692306618,295220,0.5889993076933819,2019,2019.csv
7007,His Secret Life,500930,215449,0.430098017687102,285481,0.569901982312898,2001,2001.csv
7008,Alice and Martin,500896,500896,1.0,0,0.0,2000,2000.csv
7009,Ghostbusters 2020 Re-release,500000,500000,1.0,0,0.0,2020,2020.csv
7010,CQ,499891,414358,0.8288966994804867,85533,0.17110330051951325,2002,2002.csv
7011,Smashed,499725,376597,0.7536084846665666,123128,0.2463915153334334,2012,2012.csv
7012,Home of the Brave,499620,51708,0.10349465593851327,447912,0.8965053440614867,2006,2006.csv
7013,Time of the Wolf,499149,61439,0.12308749491634763,437710,0.8769125050836524,2003,2003.csv
7014,Hamari Adhuri Kahani,498774,235361,0.4718790474242843,263413,0.5281209525757157,2015,2015.csv
7015,Whisper of the Heart 2019 Re-release,498156,498156,1.0,0,0.0,2019,2019.csv
7016,The Five Senses,497091,497091,1.0,0,0.0,2000,2000.csv
7017,Color Me Kubrick,497009,71190,0.14323684279359125,425819,0.8567631572064087,2006,2006.csv
7018,Kahlil Gibran's The Prophet 2015 Re-release,496914,370146,0.7448894577331289,126768,0.25511054226687113,2015,2015.csv
7019,Felix and Meira,496714,447353,0.9006249068880684,49361,0.09937509311193161,2015,2015.csv
7020,The Great Alaskan Race,496065,485603,0.9789100218721337,10462,0.021089978127866307,2019,2019.csv
7021,April and the Extraordinary World,495879,295488,0.5958873031525836,200391,0.4041126968474164,2015,2015.csv
7022,Nausicaä of the Valley of the Wind 2019 Re-release,495770,495770,1.0,0,0.0,2019,2019.csv
7023,Idiocracy,495303,444093,0.8966087425273015,51210,0.10339125747269853,2006,2006.csv
7024,Eden,494949,65460,0.13225605062339757,429489,0.8677439493766025,2014,2014.csv
7025,The Invisible Circus,494630,77578,0.1568404666114065,417052,0.8431595333885935,2001,2001.csv
7026,Steve Jobs: The Man in the Machine,494506,494506,1.0,0,0.0,2015,2015.csv
7027,À Tout de Suite,494030,248565,0.503137461287776,245465,0.49686253871222397,2004,2004.csv
7028,Monty Python's Life of Brian 2019 Re-release,493971,161507,0.32695644076271685,332464,0.6730435592372832,2019,2019.csv
7029,L'incomparable mademoiselle C.,493905,493905,1.0,0,0.0,2004,2004.csv
7030,The Polar Express 2013 IMAX Release,493776,493776,1.0,0,0.0,2013,2013.csv
7031,Rain,492661,455164,0.9238888403993821,37497,0.07611115960061787,2002,2002.csv
7032,Two Night Stand,492332,18612,0.03780375843942705,473720,0.9621962415605729,2014,2014.csv
7033,Soul on a String,491294,3669,0.007468033397517576,487625,0.9925319666024824,2017,2017.csv
7034,Beyond the Gates 2006 Re-release,491155,40848,0.08316722826806201,450307,0.916832771731938,2006,2006.csv
7035,Wolves,491154,12139,0.024715262422783893,479015,0.9752847375772161,2014,2014.csv
7036,I'll Sleep When I'm Dead,490964,360759,0.734797256010624,130205,0.265202743989376,2004,2004.csv
7037,Tape,490475,490475,1.0,0,0.0,2001,2001.csv
7038,Joker,490291,169181,0.34506242211258215,321110,0.6549375778874179,2012,2012.csv
7039,Open Grave,489812,0,0.0,489812,1.0,2013,2013.csv
7040,Brothers,489706,389220,0.7948034126598408,100486,0.2051965873401592,2004,2004.csv
7041,Zama,489692,200600,0.40964524639977784,289092,0.5903547536002222,2017,2017.csv
7042,L'amour fou,489126,312494,0.638882414756116,176632,0.361117585243884,2010,2010.csv
7043,What Richard Did,488327,2749,0.0056294245454377905,485578,0.9943705754545622,2012,2012.csv
7044,Asa Nu Maan Watna Da: In Search of Our Roots,487893,235075,0.4818167098113726,252818,0.5181832901886274,2004,2004.csv
7045,At Any Price,487455,380594,0.7807777128145162,106861,0.21922228718548378,2013,2013.csv
7046,London Fields,487420,252676,0.5183948135078577,234744,0.4816051864921423,2018,2018.csv
7047,Full of It,486722,14273,0.02932474800810319,472449,0.9706752519918969,2007,2007.csv
7048,Beach Rats,486623,473771,0.973589411104695,12852,0.02641058889530499,2017,2017.csv
7049,Kisna: The Warrior Poet,485613,147000,0.3027101827998839,338613,0.6972898172001162,2005,2005.csv
7050,Cooties,485544,60058,0.12369218855551711,425486,0.8763078114444829,2015,2015.csv
7051,The Russian Five,485049,485049,1.0,0,0.0,2019,2019.csv
7052,In Praise of Love,485003,252074,0.5197369913175794,232929,0.4802630086824205,2001,2001.csv
7053,10 Questions for the Dalai Lama,484487,224546,0.46347167209852896,259941,0.5365283279014711,2007,2007.csv
7054,Dynamite Warrior,483737,52292,0.10810006263734219,431445,0.8918999373626578,2006,2006.csv
7055,63 Up,483684,483684,1.0,0,0.0,2019,2019.csv
7056,Our Little Sister 2016 Re-release,483559,467555,0.9669037283971552,16004,0.03309627160284474,2016,2016.csv
7057,Lawrence of Arabia 2019 Re-release,482281,482281,1.0,0,0.0,2012,2012.csv
7058,The Journey,482209,155475,0.32242243508520163,326734,0.6775775649147984,2017,2017.csv
7059,Tere Naal Love Ho Gaya,481796,177743,0.3689175501664605,304053,0.6310824498335396,2012,2012.csv
7060,I Origins,481234,336472,0.6991858430617953,144762,0.3008141569382047,2014,2014.csv
7061,Breathe In,481079,89661,0.1863747949920907,391418,0.8136252050079094,2013,2013.csv
7062,Father of My Children,480834,144022,0.29952540793704274,336812,0.7004745920629573,2010,2010.csv
7063,The Cuckoo,480578,243936,0.5075887785125411,236642,0.49241122148745886,2002,2002.csv
7064,The Third Man 2015 Re-release,478945,449191,0.9378759565294553,29754,0.062124043470544635,2015,2015.csv
7065,Brotherly Love,478595,478595,1.0,0,0.0,2015,2015.csv
7066,The Last September,478053,478053,1.0,0,0.0,2000,2000.csv
7067,Liam Gallagher: As It Was,477009,0,0.0,477009,1.0,2019,2019.csv
7068,Blue Car,476551,465310,0.9764117586575204,11241,0.02358824134247961,2003,2003.csv
7069,Heart of a Dog,476384,420813,0.8833483072479345,55571,0.11665169275206556,2015,2015.csv
7070,The Babymakers,475511,7889,0.016590573088740325,467622,0.9834094269112597,2012,2012.csv
7071,Gorillaz: Reject False Icons,475465,453687,0.9541964182431935,21778,0.045803581756806495,2019,2019.csv
7072,Producing Adults,474752,935,0.001969449312483149,473817,0.9980305506875169,2004,2004.csv
7073,The Stone Angel,473993,459166,0.9687189473262263,14827,0.031281052673773665,2008,2008.csv
7074,Humpday,473980,407377,0.8594814127178362,66603,0.1405185872821638,2009,2009.csv
7075,On the Job,472890,164620,0.34811478356488823,308270,0.6518852164351118,2013,2013.csv
7076,Beer League,472185,472185,1.0,0,0.0,2006,2006.csv
7077,Pearl Jam Twenty,471334,471334,1.0,0,0.0,2011,2011.csv
7078,Reconstruction,471107,73516,0.15604947496004093,397591,0.843950525039959,2003,2003.csv
7079,About Elly 2015 Re-release,470760,470760,1.0,0,0.0,2015,2015.csv
7080,White Bird in a Blizzard,469701,33821,0.07200538214736608,435880,0.9279946178526339,2014,2014.csv
7081,When the Road Bends... Tales of a Gypsy Caravan,469507,442936,0.9434065945768647,26571,0.05659340542313533,2007,2007.csv
7082,Matangi/Maya/M.I.A,469489,230808,0.49161535201037726,238681,0.5083846479896228,2018,2018.csv
7083,Joe Gould's Secret,468684,468684,1.0,0,0.0,2000,2000.csv
7084,DCI 2017 Tour Premeire,467817,467817,1.0,0,0.0,2017,2017.csv
7085,Time Freak,467693,10003,0.021387961761240814,457690,0.9786120382387592,2018,2018.csv
7086,Hail Satan?,467361,424284,0.9078292797216713,43077,0.09217072027832875,2019,2019.csv
7087,Tully,466664,466664,1.0,0,0.0,2002,2002.csv
7088,The Broken Line,466309,466309,1.0,0,0.0,2008,2008.csv
7089,Last Days in Vietnam,466114,466114,1.0,0,0.0,2014,2014.csv
7090,Neighboring Sounds,465082,60255,0.1295577984097428,404827,0.8704422015902572,2012,2012.csv
7091,Venus Beauty,465080,465080,1.0,0,0.0,2000,2000.csv
7092,Church Ball,464991,464991,1.0,0,0.0,2006,2006.csv
7093,Ghanchakkar,464803,203044,0.43683883279582963,261759,0.5631611672041704,2013,2013.csv
7094,Puffs: Filmed Live Off Broadway,464483,464483,1.0,0,0.0,2018,2018.csv
7095,Rififi 2000 Re-release,463593,460226,0.9927371638484619,3367,0.0072628361515380945,2000,2000.csv
7096,The Second Chance,463542,463542,1.0,0,0.0,2006,2006.csv
7097,True History of the Kelly Gang,463071,33817,0.07302767826100101,429254,0.926972321738999,2020,2020.csv
7098,Romeo & Juliet: Sealed with a Kiss,463002,463002,1.0,0,0.0,2006,2006.csv
7099,Demonlover,462976,232044,0.5012009261819187,230932,0.4987990738180813,2002,2002.csv
7100,Deepsea Challenge,462959,235659,0.5090277972779447,227300,0.4909722027220553,2014,2014.csv
7101,Before We Go,462875,37151,0.08026140966783689,425724,0.9197385903321631,2015,2015.csv
7102,The Bag Man,461780,56574,0.12251288492355668,405206,0.8774871150764433,2014,2014.csv
7103,MFKZ,461724,229423,0.4968834195320148,232301,0.5031165804679852,2018,2018.csv
7104,Scotty and the Secret History of Hollywood,461689,461689,1.0,0,0.0,2018,2018.csv
7105,Outfoxed: Rupert Murdoch's War on Journalism,461572,461572,1.0,0,0.0,2004,2004.csv
7106,Bully,461405,279202,0.6051126450732003,182203,0.39488735492679966,2012,2012.csv
7107,Disorder,460997,51879,0.11253652409885531,409118,0.8874634759011447,2015,2015.csv
7108,Alexandra,460139,128222,0.2786592746974284,331917,0.7213407253025717,2007,2007.csv
7109,Manglehorn,459636,143101,0.3113354915628889,316535,0.6886645084371111,2015,2015.csv
7110,Christmas Jars,459462,459462,1.0,0,0.0,2019,2019.csv
7111,Eric Clapton: A Life in 12 Bars,459088,0,0.0,459088,1.0,2017,2017.csv
7112,The Legend of Suriyothai,458564,454736,0.991652201219459,3828,0.008347798780540993,2003,2003.csv
7113,Brooklyn Rules,458232,458232,1.0,0,0.0,2007,2007.csv
7114,Shade,458144,25032,0.054637843123559404,433112,0.9453621568764405,2004,2004.csv
7115,The Memory of a Killer 2005 Re-release,458042,333707,0.7285510935678388,124335,0.27144890643216124,2005,2005.csv
7116,South Pacific 2018 Re-release,458000,458000,1.0,0,0.0,2018,2018.csv
7117,The Promotion,457690,408709,0.8929821494898293,48981,0.10701785051017064,2008,2008.csv
7118,We Steal Secrets,457517,166243,0.3633591757246179,291274,0.6366408242753822,2013,2013.csv
7119,Life Partner,457340,110240,0.24104604889141557,347100,0.7589539511085844,2009,2009.csv
7120,Paradise: Hope,457132,6701,0.014658785646159096,450431,0.9853412143538409,2013,2013.csv
7121,Sound of Noise,456366,24565,0.05382741045564306,431801,0.9461725895443569,2010,2010.csv
7122,Staying Vertical,456271,12158,0.026646444766377876,444113,0.9733535552336221,2016,2016.csv
7123,Lola Versus,455754,252603,0.5542529522505563,203151,0.4457470477494438,2012,2012.csv
7124,The Gospel According to André,454550,400713,0.881559784402156,53837,0.11844021559784403,2018,2018.csv
7125,The Little Traitor,454481,402088,0.8847190531617384,52393,0.11528094683826166,2009,2009.csv
7126,Wristcutters: A Love Story,454026,446165,0.982686013576315,7861,0.017313986423684986,2007,2007.csv
7127,The Most Dangerous Man in America: Daniel Ellsberg and the Pentagon Papers,453993,453993,1.0,0,0.0,2010,2010.csv
7128,Warm Water Under a Red Bridge,453754,71094,0.15667961053786852,382660,0.8433203894621315,2001,2001.csv
7129,The Safety of Objects,453292,319299,0.7044002541408187,133993,0.29559974585918125,2002,2002.csv
7130,Ten,452895,105990,0.23402775477759746,346905,0.7659722452224026,2002,2002.csv
7131,Leaning Into The Wind,452372,400530,0.8853996268557736,51842,0.11460037314422643,2018,2018.csv
7132,Sailor Moon R: The Movie: The Promise of the Rose,452053,452053,1.0,0,0.0,2017,2017.csv
7133,The Perfect Host,450885,48764,0.10815174601062355,402121,0.8918482539893764,2011,2011.csv
7134,Fear(s) of the Dark,450813,77876,0.17274568390884912,372937,0.8272543160911509,2008,2008.csv
7135,Perfect Blue 2017 Re-release,450594,446062,0.9899421652307843,4532,0.010057834769215747,2017,2017.csv
7136,Kill List,450275,29063,0.06454500027760812,421212,0.9354549997223919,2011,2011.csv
7137,Pearl Jam: Let's Play Two,450273,348833,0.7747144510108313,101440,0.2252855489891688,2017,2017.csv
7138,Hesher,449702,382946,0.8515550297752734,66756,0.1484449702247266,2011,2011.csv
7139,London to Brighton,449681,6700,0.014899450944113716,442981,0.9851005490558863,2006,2006.csv
7140,17 Girls,449626,15123,0.033634620773709704,434503,0.9663653792262903,2011,2011.csv
7141,Once Were Brothers: Robbie Robertson and the Band,449561,449561,1.0,0,0.0,2020,2020.csv
7142,Lockdown,449482,449482,1.0,0,0.0,2003,2003.csv
7143,The Rocket,449064,56823,0.1265365293143071,392241,0.8734634706856929,2013,2013.csv
7144,Before We Vanish,448829,52087,0.11605087906530104,396742,0.8839491209346989,2017,2017.csv
7145,The Heart of the Game,446446,445374,0.9975988137423115,1072,0.0024011862576885,2006,2006.csv
7146,The Sleeping Beauty,446131,29066,0.06515126722868395,417065,0.9348487327713161,2011,2011.csv
7147,I Am Trying to Break Your Heart,445522,445522,1.0,0,0.0,2002,2002.csv
7148,Cruel Intentions 2019 Re-release,445218,445218,1.0,0,0.0,2019,2019.csv
7149,Baise-moi,444243,420224,0.9459327440162254,24019,0.05406725598377465,2000,2000.csv
7150,Charlie Countryman,443990,11650,0.026239329714633212,432340,0.9737606702853668,2013,2013.csv
7151,The Hammer,443591,443591,1.0,0,0.0,2008,2008.csv
7152,Modern Times 2003 Re-release,443427,163577,0.3688927376997792,279850,0.6311072623002207,2003,2003.csv
7153,It's All About Love,443400,6140,0.013847541723049165,437260,0.9861524582769509,2003,2003.csv
7154,Porco Rosso 2018 Re-release,443059,443059,1.0,0,0.0,2018,2018.csv
7155,The Beautiful Country 2005 Re-release,442813,442813,1.0,0,0.0,2005,2005.csv
7156,As You Like It,442515,0,0.0,442515,1.0,2006,2006.csv
7157,Prince Avalanche,442313,205139,0.46378695629565486,237174,0.5362130437043451,2013,2013.csv
7158,Elf 2018 Re-release,442073,442073,1.0,0,0.0,2018,2018.csv
7159,Aitraaz,440684,91998,0.20876183387642847,348686,0.7912381661235716,2004,2004.csv
7160,Bastards,439935,24525,0.05574687169695523,415410,0.9442531283030448,2013,2013.csv
7161,Short Cut to Nirvana: Kumbh Mela,439651,381225,0.8671082290271147,58426,0.13289177097288532,2004,2004.csv
7162,Bitch Slap,439587,17365,0.03950298803194817,422222,0.9604970119680518,2010,2010.csv
7163,StarDog and TurboCat,439262,80490,0.18323916022783668,358772,0.8167608397721633,2019,2019.csv
7164,Santa vs. the Snowman 3D 2008 Re-release,438385,433797,0.9895343134459437,4588,0.010465686554056367,2008,2008.csv
7165,Desert Dancer,438165,155271,0.3543665057683749,282894,0.6456334942316251,2014,2014.csv
7166,CatVideoFest 2020,437625,437625,1.0,0,0.0,2020,2020.csv
7167,Offside,437055,180530,0.41306014117216366,256525,0.5869398588278363,2006,2006.csv
7168,Dorm Daze,436365,56127,0.12862397305008422,380238,0.8713760269499158,2003,2003.csv
7169,My Kingdom,435759,36533,0.08383762584364293,399226,0.916162374156357,2011,2011.csv
7170,The Singing Detective,435625,337174,0.7740005738880918,98451,0.22599942611190818,2003,2003.csv
7171,The Wayward Cloud,435251,0,0.0,435251,1.0,2005,2005.csv
7172,We the Animals,434743,400961,0.9222943210126443,33782,0.07770567898735575,2018,2018.csv
7173,Moolaadé,434553,215646,0.4962478684993545,218907,0.5037521315006455,2004,2004.csv
7174,What We Left Behind: Star Trek DS9,434437,382457,0.8803508909231949,51980,0.11964910907680515,2019,2019.csv
7175,Chaos 2002 Re-release,434432,206789,0.47599854522687096,227643,0.5240014547731291,2002,2002.csv
7176,DCI 2018 Tour Premeire,434008,434008,1.0,0,0.0,2018,2018.csv
7177,Rosenwald,433924,433924,1.0,0,0.0,2015,2015.csv
7178,Bjork: Biophilia Live,433686,127754,0.29457718256987775,305932,0.7054228174301223,2014,2014.csv
7179,I Want Your Money,433588,433588,1.0,0,0.0,2010,2010.csv
7180,The Sower,433112,36233,0.08365734498236022,396879,0.9163426550176398,2018,2018.csv
7181,The Devil and Daniel Johnston,432339,334450,0.7735827672266439,97889,0.2264172327733561,2006,2006.csv
7182,Me and Mrs. Khanna,431630,197183,0.4568333989759748,234447,0.5431666010240253,2009,2009.csv
7183,La petite Jérusalem,431623,53580,0.12413610952150372,378043,0.8758638904784963,2005,2005.csv
7184,When Do We Eat?,431513,431513,1.0,0,0.0,2006,2006.csv
7185,Promises,430862,247948,0.5754696399311149,182914,0.42453036006888517,2002,2002.csv
7186,Harmony,430568,23248,0.0539937942438825,407320,0.9460062057561175,2015,2015.csv
7187,Ghostbusters 2019 Re-release,430435,369612,0.8586941117706506,60823,0.1413058882293494,2019,2019.csv
7188,Andy Irons: Kissed by God,430393,285933,0.6643532771211428,144460,0.3356467228788572,2018,2018.csv
7189,Go Goa Gone,429350,298457,0.6951368347502038,130893,0.30486316524979623,2013,2013.csv
7190,On the Beach at Night Alone,429159,37489,0.08735457021756506,391670,0.9126454297824349,2017,2017.csv
7191,Infamous,429148,429148,1.0,0,0.0,2020,2020.csv
7192,Revolver 2007 Re-release,428620,84738,0.19769959404600812,343882,0.8023004059539919,2007,2007.csv
7193,"A Woman, a Gun and a Noodle Shop",428249,190946,0.4458761141298637,237303,0.5541238858701363,2009,2009.csv
7194,The Singing Revolution,426855,426855,1.0,0,0.0,2007,2007.csv
7195,Blackway,426491,27079,0.06349254732221782,399412,0.9365074526777821,2016,2016.csv
7196,Happy Bhaag Jayegi 2016 Re-release,426345,351840,0.825247158990958,74505,0.17475284100904198,2016,2016.csv
7197,Josh,426318,426318,1.0,0,0.0,2000,2000.csv
7198,Fido,426224,304533,0.7144905026464957,121691,0.2855094973535043,2007,2007.csv
7199,Luck,426221,149333,0.35036518613583095,276888,0.6496348138641691,2009,2009.csv
7200,Killing Sarai,425332,425332,1.0,0,0.0,2019,2019.csv
7201,Vertigo 2018 Re-release,425152,394212,0.9272260273972602,30940,0.07277397260273973,2018,2018.csv
7202,8 ½ Women,424123,424123,1.0,0,0.0,2000,2000.csv
7203,Sound of My Voice,424088,408015,0.9620998472015242,16073,0.037900152798475785,2012,2012.csv
7204,Viva,423976,178008,0.41985395399739606,245968,0.5801460460026039,2016,2016.csv
7205,God Help the Girl,423306,102757,0.2427487444071192,320549,0.7572512555928808,2014,2014.csv
7206,Taking Sides,422832,188952,0.44687251674423883,233880,0.5531274832557611,2002,2002.csv
7207,Cirque du Soleil in Cinema: KURIOS - Cabinet of Curiosities,422760,413039,0.9770058662125083,9721,0.02299413378749172,2018,2018.csv
7208,Mississippi Grind,422746,130541,0.3087929868053157,292205,0.6912070131946842,2015,2015.csv
7209,Behaving Badly,422697,0,0.0,422697,1.0,2014,2014.csv
7210,Ben-Hur 2019 Re-release,422622,422622,1.0,0,0.0,2019,2019.csv
7211,Super,422618,327716,0.7754425982802436,94902,0.22455740171975638,2011,2011.csv
7212,Settai,422247,87838,0.20802516062873153,334409,0.7919748393712684,2013,2013.csv
7213,Mad Max: Fury Road 2016 Re-release,421986,421986,1.0,0,0.0,2016,2016.csv
7214,She's Beautiful When She's Angry,421573,421573,1.0,0,0.0,2014,2014.csv
7215,Porn Star: The Legend of Ron Jeremy,421516,421516,1.0,0,0.0,2001,2001.csv
7216,The Bounce Back,421404,321910,0.7638987764710349,99494,0.23610122352896507,2016,2016.csv
7217,The Cold Blue,420177,420177,1.0,0,0.0,2019,2019.csv
7218,Voiceless,419952,419952,1.0,0,0.0,2016,2016.csv
7219,Madame Satã,419046,198309,0.47323921478787534,220737,0.5267607852121247,2002,2002.csv
7220,Amandla! A Revolution in Four Part Harmony,418941,405331,0.9675133252653715,13610,0.032486674734628504,2003,2003.csv
7221,Strength and Honour,418721,51933,0.12402769385820152,366788,0.8759723061417984,2007,2007.csv
7222,Frankenstein 2018 Re-release,417783,417783,1.0,0,0.0,2018,2018.csv
7223,Happy Phirr Bhag Jayegi,417669,103385,0.2475285453313509,314284,0.7524714546686491,2018,2018.csv
7224,Bolshoi Ballet: Le Corsaire,417152,190192,0.4559297330469469,226960,0.544070266953053,2019,2019.csv
7225,In the Realms of the Unreal,417120,417120,1.0,0,0.0,2004,2004.csv
7226,Dirty Wars,416853,384473,0.922322737271892,32380,0.07767726272810799,2013,2013.csv
7227,Tales of Halloween,416792,0,0.0,416792,1.0,2015,2015.csv
7228,Killer of Sheep,416509,404508,0.9711866970461622,12001,0.028813302953837733,2007,2007.csv
7229,Manifesto,416389,161101,0.3869002303134809,255288,0.6130997696865191,2017,2017.csv
7230,Status Update,416178,4764,0.011447025071003272,411414,0.9885529749289967,2018,2018.csv
7231,Sand Storm,414698,86800,0.20930894289338264,327898,0.7906910571066174,2016,2016.csv
7232,Snow Angels,414404,402858,0.9721382998233608,11546,0.02786170017663922,2008,2008.csv
7233,Wonderland,414254,414254,1.0,0,0.0,2000,2000.csv
7234,The Ottoman Lieutenant,413844,240978,0.5822918780989939,172866,0.4177081219010062,2017,2017.csv
7235,Bobby Z,413454,0,0.0,413454,1.0,2007,2007.csv
7236,The Mafia Kills Only in Summer 2015 Re-release,413236,37134,0.08986148351063315,376102,0.9101385164893668,2015,2015.csv
7237,The Moth Diaries,413035,3838,0.009292190734441392,409197,0.9907078092655586,2012,2012.csv
7238,Unbranded,412792,410185,0.9936844706292758,2607,0.006315529370724239,2015,2015.csv
7239,Dogtooth,412728,110248,0.26712023414936714,302480,0.7328797658506329,2009,2009.csv
7240,Godzilla,412520,412520,1.0,0,0.0,2004,2004.csv
7241,Rage,411967,5594,0.013578757521840342,406373,0.9864212424781597,2010,2010.csv
7242,Tuvalu,411678,411678,1.0,0,0.0,2001,2001.csv
7243,R... Rajkumar,410495,166503,0.4056151719265764,243992,0.5943848280734235,2013,2013.csv
7244,El bonaerense,410474,9470,0.023070888777364705,401004,0.9769291112226353,2002,2002.csv
7245,Free Zone,410392,32381,0.07890261018733309,378011,0.9210973898126669,2005,2005.csv
7246,Mobsters and Mormons,409604,409604,1.0,0,0.0,2005,2005.csv
7247,City of Revenge,409166,409166,1.0,0,0.0,2015,2015.csv
7248,Song One,408918,32251,0.0788691131229244,376667,0.9211308868770756,2015,2015.csv
7249,The Reliant,408747,408747,1.0,0,0.0,2019,2019.csv
7250,Sleeping Beauty,408680,36578,0.08950278946853284,372102,0.9104972105314671,2011,2011.csv
7251,The 5th Quarter,408159,408159,1.0,0,0.0,2011,2011.csv
7252,Le Cercle Rouge,407878,369970,0.9070604445446923,37908,0.09293955545530772,2002,2002.csv
7253,"Love, Kennedy",407871,407871,1.0,0,0.0,2017,2017.csv
7254,Mister Lonely,407674,167396,0.4106124010851808,240278,0.5893875989148192,2008,2008.csv
7255,Cinema Paradiso 2002 Re-release,406809,406809,1.0,0,0.0,2002,2002.csv
7256,Please Stand By,406732,9868,0.024261675993037184,396864,0.9757383240069628,2018,2018.csv
7257,Chasing Trane: The John Coltrane Documentary,406284,406284,1.0,0,0.0,2017,2017.csv
7258,Gabrielle,406256,5534,0.013621952660391477,400722,0.9863780473396085,2013,2013.csv
7259,Every Heart That Loves,406235,406235,1.0,0,0.0,2000,2000.csv
7260,The Square 2010 Re-release,406116,406116,1.0,0,0.0,2010,2010.csv
7261,The Hunting Ground,405917,405917,1.0,0,0.0,2015,2015.csv
7262,The Tempest,405861,277943,0.6848231291008497,127918,0.3151768708991502,2010,2010.csv
7263,Stake Land,405380,33245,0.08200947259361586,372135,0.9179905274063841,2011,2011.csv
7264,Happy Magic,405268,10697,0.02639487943780412,394571,0.9736051205621958,2011,2011.csv
7265,Tezz,405214,229931,0.5674310364400046,175283,0.43256896355999547,2012,2012.csv
7266,Preaching to the Choir,405191,405191,1.0,0,0.0,2006,2006.csv
7267,Marilyn Hotchkiss' Ballroom Dancing & Charm School,404870,349132,0.8623311186306716,55738,0.13766888136932842,2006,2006.csv
7268,The Philadelphia Story 2018 Re-release,404524,404524,1.0,0,0.0,2018,2018.csv
7269,Wanted,404099,349637,0.8652260955854877,54462,0.13477390441451229,2009,2009.csv
7270,God's Pocket,403713,169976,0.4210317725711087,233737,0.5789682274288913,2014,2014.csv
7271,Meet Me in St. Louis 75th Anniversary,403521,403521,1.0,0,0.0,2019,2019.csv
7272,A Wake in Providence,403069,403069,1.0,0,0.0,2005,2005.csv
7273,24 City,402917,30800,0.07644254275694498,372117,0.923557457243055,2009,2009.csv
7274,The Apu Trilogy,402723,402723,1.0,0,0.0,2015,2015.csv
7275,The Brown Bunny,402599,366301,0.9098408093413048,36298,0.09015919065869513,2004,2004.csv
7276,Flanders,402252,22788,0.05665105456281137,379464,0.9433489454371886,2006,2006.csv
7277,Raju Chacha,402226,194698,0.48405125476722044,207528,0.5159487452327796,2000,2000.csv
7278,Gang Land,402000,402000,1.0,0,0.0,2000,2000.csv
7279,Drinking Buddies,401914,343341,0.8542648427275487,58573,0.14573515727245132,2013,2013.csv
7280,The Oath,401463,401463,1.0,0,0.0,2018,2018.csv
7281,The Signal,401462,251150,0.6255884741270655,150312,0.3744115258729344,2008,2008.csv
7282,Freetown,401328,401328,1.0,0,0.0,2015,2015.csv
7283,An Affair of Love,401299,359050,0.8947193987525511,42249,0.10528060124744891,2000,2000.csv
7284,"Hello, Dolly!",400881,400881,1.0,0,0.0,2019,2019.csv
7285,Crimson Gold,400768,148959,0.37168386697540723,251809,0.6283161330245928,2004,2004.csv
7286,Racer and the Jailbird,400026,46337,0.11583497072690276,353689,0.8841650292730973,2017,2017.csv
7287,Mafioso,400019,400019,1.0,0,0.0,2007,2007.csv
7288,The Mystic Masseur,399110,399110,1.0,0,0.0,2002,2002.csv
7289,West Side Story 2018 Re-release,398670,398670,1.0,0,0.0,2018,2018.csv
7290,Space Mutiny,397887,397887,1.0,0,0.0,2018,2018.csv
7291,Berlin Syndrome,397783,28660,0.07204933343053876,369123,0.9279506665694612,2017,2017.csv
7292,Transylmania,397641,397641,1.0,0,0.0,2009,2009.csv
7293,Krull 2018 Re-release,397157,397157,1.0,0,0.0,2018,2018.csv
7294,Lost and Delirious,396897,307233,0.7740874836544493,89664,0.2259125163455506,2001,2001.csv
7295,Still We Believe: The Boston Red Sox Movie,396803,396803,1.0,0,0.0,2004,2004.csv
7296,Very Annie Mary,396090,46352,0.11702390870761696,349738,0.8829760912923831,2002,2002.csv
7297,13 Minutes 2015 Re-release,395557,161531,0.40836339642579955,234026,0.5916366035742004,2015,2015.csv
7298,Pauline and Paulette,395175,139789,0.3537394825077497,255386,0.6462605174922502,2001,2001.csv
7299,Keane,394390,33256,0.08432262481300236,361134,0.9156773751869977,2005,2005.csv
7300,The Yes Men,394154,255364,0.6478787479005668,138790,0.35212125209943324,2004,2004.csv
7301,God Bless America,393880,122550,0.3111353711790393,271330,0.6888646288209607,2012,2012.csv
7302,Into the Abyss,393714,223880,0.5686361165719278,169834,0.43136388342807214,2011,2011.csv
7303,Millennium Mambo,393351,14904,0.037889823592669146,378447,0.9621101764073309,2001,2001.csv
7304,Jee Aayan Nu,393117,393117,1.0,0,0.0,2002,2002.csv
7305,Cuban Fury 2014 Re-release,392705,92384,0.235250378783056,300321,0.764749621216944,2014,2014.csv
7306,Hamara Dil Aapke Paas Hai,392076,392076,1.0,0,0.0,2000,2000.csv
7307,Three,391957,331507,0.8457738986674559,60450,0.15422610133254414,2016,2016.csv
7308,End of the Century,391950,391950,1.0,0,0.0,2004,2004.csv
7309,Tiny Furniture,391674,391674,1.0,0,0.0,2010,2010.csv
7310,Bittersweet Motel,391653,391653,1.0,0,0.0,2000,2000.csv
7311,While She Was Out,391410,0,0.0,391410,1.0,2008,2008.csv
7312,The Escape,390881,14018,0.03586257710147078,376863,0.9641374228985292,2018,2018.csv
7313,The Marc Pease Experience,390584,4033,0.010325563771173423,386551,0.9896744362288266,2009,2009.csv
7314,Hell Ride,390128,213608,0.5475331173358488,176520,0.45246688266415125,2008,2008.csv
7315,Detropia,390024,390024,1.0,0,0.0,2012,2012.csv
7316,Shortkut - The Con Is On,389832,100304,0.25730058076299533,289528,0.7426994192370047,2009,2009.csv
7317,Once Upon a Time in Mumbaai Dobara,389237,0,0.0,389237,1.0,2013,2013.csv
7318,House of D,389199,388532,0.9982862237569984,667,0.0017137762430016522,2005,2005.csv
7319,The Game of Their Lives,388998,375750,0.9659432696312064,13248,0.03405673036879367,2005,2005.csv
7320,Singh Saab the Great,388622,225668,0.580687660503008,162954,0.4193123394969919,2013,2013.csv
7321,The Last Sin Eater,388390,388390,1.0,0,0.0,2007,2007.csv
7322,Keep the Lights On,388331,246112,0.6337686149187163,142219,0.3662313850812838,2012,2012.csv
7323,The Escapist,388174,13439,0.034621071993487455,374735,0.9653789280065126,2008,2008.csv
7324,Times and Winds,387396,6176,0.015942343235345744,381220,0.9840576567646543,2006,2006.csv
7325,The Shawshank Redemption 2019 Re-release,387095,358507,0.9261473281752541,28588,0.07385267182474586,2019,2019.csv
7326,"Westwood: Punk, Icon, Activist",386856,58979,0.15245724507310213,327877,0.8475427549268979,2018,2018.csv
7327,Hitchcock/Truffaut,386471,260430,0.6738668619378945,126041,0.3261331380621056,2015,2015.csv
7328,The Wedding Guest,386166,386166,1.0,0,0.0,2019,2019.csv
7329,How to Talk to Girls at Parties,385733,84809,0.21986451768451235,300924,0.7801354823154877,2018,2018.csv
7330,Samurai Cop,384756,384756,1.0,0,0.0,2017,2017.csv
7331,Bethlehem,384670,201700,0.5243455429329035,182970,0.47565445706709647,2014,2014.csv
7332,Adoration,384659,294244,0.7649476549359303,90415,0.23505234506406975,2009,2009.csv
7333,The Embalmer,384336,56878,0.1479903001540319,327458,0.8520096998459681,2002,2002.csv
7334,The Secret World of Arrietty 2019 Re-release,384289,384289,1.0,0,0.0,2019,2019.csv
7335,"Scotland, Pa.",384098,384098,1.0,0,0.0,2002,2002.csv
7336,Imagining Argentina,383106,8899,0.02322855815361806,374207,0.976771441846382,2003,2003.csv
7337,Into the Arms of Strangers,382807,382807,1.0,0,0.0,2000,2000.csv
7338,First Snow,382267,214864,0.5620783379156453,167403,0.4379216620843547,2007,2007.csv
7339,The Informers,382174,300000,0.7849827565454479,82174,0.21501724345455211,2009,2009.csv
7340,Digimon Adventure tri. Part 5: Coexistence,382119,52339,0.1369704202094112,329780,0.8630295797905888,2017,2017.csv
7341,Game,381911,139528,0.3653416633718327,242383,0.6346583366281673,2011,2011.csv
7342,Z for Zachariah,381839,121461,0.3180947991169053,260378,0.6819052008830947,2015,2015.csv
7343,The Children of the Century,381624,56611,0.14834234744146071,325013,0.8516576525585393,2002,2002.csv
7344,The Quiet,381420,381420,1.0,0,0.0,2006,2006.csv
7345,Flower,380553,328188,0.8623976161007797,52365,0.13760238389922033,2018,2018.csv
7346,Jane and Emma,380030,380030,1.0,0,0.0,2018,2018.csv
7347,Daughter of Mine,379010,10628,0.02804147647819319,368382,0.9719585235218068,2018,2018.csv
7348,I'll Push You: A Real-Life Inspiration,378899,378899,1.0,0,0.0,2017,2017.csv
7349,Blind Spot. Hitler's Secretary,378382,378382,1.0,0,0.0,2003,2003.csv
7350,Miss Hokusai,377702,222670,0.589538842791407,155032,0.410461157208593,2015,2015.csv
7351,Attack on Titan: Smoke Signal,377334,377334,1.0,0,0.0,2018,2018.csv
7352,Pride and Prejudice,377271,377271,1.0,0,0.0,2003,2003.csv
7353,Hochelaga,376714,376714,1.0,0,0.0,2000,2000.csv
7354,The Hunting of the President,376612,376612,1.0,0,0.0,2004,2004.csv
7355,The Nightmare Before Christmas 2000 Re-release,376586,376586,1.0,0,0.0,2000,2000.csv
7356,Le talent de mes amis,376522,889,0.0023610838144915835,375633,0.9976389161855084,2015,2015.csv
7357,Born Romantic,376090,15545,0.04133319152330559,360545,0.9586668084766944,2001,2001.csv
7358,American Hardcore,376057,279665,0.7436771553248577,96392,0.2563228446751423,2006,2006.csv
7359,Great Performances at the Met: Puccini: Turandot,375295,0,0.0,375295,1.0,2019,2019.csv
7360,Southland Tales,374743,275380,0.7348502840613433,99363,0.2651497159386566,2007,2007.csv
7361,Chronic,374704,9033,0.024107028481147787,365671,0.9758929715188522,2016,2016.csv
7362,Annie Brocoli dans les fonds marins,374360,374360,1.0,0,0.0,2003,2003.csv
7363,Waking Up in Reno,374312,267109,0.713599884588258,107203,0.2864001154117421,2002,2002.csv
7364,Jurassic Park 2018 Re-release,374238,374238,1.0,0,0.0,2018,2018.csv
7365,How to Cook Your Life,373727,87370,0.23378027276594948,286357,0.7662197272340505,2007,2007.csv
7366,Keep the River on Your Right: A Modern Cannibal Tale,373366,373366,1.0,0,0.0,2001,2001.csv
7367,Everything Is Fine,373360,336569,0.9014597171630597,36791,0.09854028283694022,2008,2008.csv
7368,Nico and Dani,372850,370562,0.9938634839747887,2288,0.006136516025211211,2001,2001.csv
7369,Pom Poko 2018 Re-release,372405,372405,1.0,0,0.0,2018,2018.csv
7370,Eloise,372137,0,0.0,372137,1.0,2017,2017.csv
7371,Fanny,371657,8735,0.023502853437443665,362922,0.9764971465625564,2013,2013.csv
7372,Havoc,371000,0,0.0,371000,1.0,2005,2005.csv
7373,7 Boxes,370892,38106,0.10274149887298728,332786,0.8972585011270127,2013,2013.csv
7374,Hava Nagila,370218,370218,1.0,0,0.0,2013,2013.csv
7375,Me Myself I,369975,369975,1.0,0,0.0,2000,2000.csv
7376,"Ruben Brandt, Collector 2018 Re-release",369809,117963,0.31898358341738575,251846,0.6810164165826142,2018,2018.csv
7377,Unmistaken Child,369742,306140,0.8279827555430543,63602,0.17201724445694566,2009,2009.csv
7378,Me Without You,369226,304909,0.825805874992552,64317,0.17419412500744802,2001,2001.csv
7379,Mooz-Lum,369129,369129,1.0,0,0.0,2011,2011.csv
7380,When Comedy Went to School,369065,369065,1.0,0,0.0,2013,2013.csv
7381,The Void,368372,151042,0.41002573485498356,217330,0.5899742651450165,2017,2017.csv
7382,Dark Awakening,367925,0,0.0,367925,1.0,2015,2015.csv
7383,Room 237,367406,296359,0.8066253681213699,71047,0.1933746318786302,2012,2012.csv
7384,The Big White,367241,0,0.0,367241,1.0,2005,2005.csv
7385,Black Panther 2020 Re-release,367000,367000,1.0,0,0.0,2020,2020.csv
7386,INXS: Baby Live at Wembly Stadium,366425,161750,0.44142730435969163,204675,0.5585726956403084,2019,2019.csv
7387,The Animation Show,366344,366344,1.0,0,0.0,2003,2003.csv
7388,Blindsight,366247,89169,0.24346684068401925,277078,0.7565331593159808,2007,2007.csv
7389,Grease 2010 Sing-a-long,365802,365802,1.0,0,0.0,2010,2010.csv
7390,Baadasssss!,365727,365727,1.0,0,0.0,2004,2004.csv
7391,Seven Sins Forgiven,365672,270207,0.7389327047189831,95465,0.26106729528101685,2011,2011.csv
7392,Eat That Question,365540,355074,0.9713683864966899,10466,0.02863161350331017,2016,2016.csv
7393,Glen Campbell: I'll Be Me,365422,365422,1.0,0,0.0,2014,2014.csv
7394,Lords of Chaos,365353,253184,0.692984592982677,112169,0.307015407017323,2019,2019.csv
7395,Your Magical Spell Worked,365318,365318,1.0,0,0.0,2000,2000.csv
7396,Clemency,364952,364716,0.9993533396172647,236,0.0006466603827352638,2019,2019.csv
7397,BOSTON: An American Running Story,364369,364369,1.0,0,0.0,2017,2017.csv
7398,Five Minutes of Heaven,364355,15676,0.04302397387163618,348679,0.9569760261283639,2009,2009.csv
7399,The Adventures of Felix,363409,363409,1.0,0,0.0,2001,2001.csv
7400,Jig,363320,183790,0.5058626004624023,179530,0.4941373995375977,2011,2011.csv
7401,The Breadwinner,363307,312381,0.8598265378866908,50926,0.14017346211330914,2017,2017.csv
7402,Scorched,363057,8000,0.022035107434920688,355057,0.9779648925650793,2003,2003.csv
7403,Breathless 2010 Re-release,363031,363031,1.0,0,0.0,2010,2010.csv
7404,Happy Times,361000,240093,0.6650775623268698,120907,0.3349224376731302,2002,2002.csv
7405,The Tobacconist,360996,0,0.0,360996,1.0,2019,2019.csv
7406,Grateful Dawg,360251,360251,1.0,0,0.0,2001,2001.csv
7407,These Final Hours,360234,0,0.0,360234,1.0,2014,2014.csv
7408,Souvenir,359798,11411,0.031715017871138805,348387,0.9682849821288612,2016,2016.csv
7409,Disney Junior HalloVeen Party!,359745,359745,1.0,0,0.0,2017,2017.csv
7410,Happy Ending,359542,313770,0.8726935935161956,45772,0.1273064064838044,2014,2014.csv
7411,K-12,359377,303230,0.8437657390428436,56147,0.15623426095715642,2019,2019.csv
7412,Government 3,358928,249588,0.695370659296572,109340,0.304629340703428,2017,2017.csv
7413,Love in Space,358486,34787,0.09703865701868414,323699,0.9029613429813159,2011,2011.csv
7414,Everly,358156,0,0.0,358156,1.0,2015,2015.csv
7415,Welcome to the Rileys,358014,158898,0.4438318054601217,199116,0.5561681945398783,2010,2010.csv
7416,Crazy Love,357659,301027,0.8416592340749149,56632,0.15834076592508506,2007,2007.csv
7417,2001: A Space Odyssey Undated Domestic Release,356543,135370,0.37967369994643,221173,0.6203263000535699,2001,2001.csv
7418,National Gallery,354971,253941,0.715385200481166,101030,0.28461479951883395,2014,2014.csv
7419,Hello I Must Be Going,354939,106709,0.3006403917292831,248230,0.699359608270717,2012,2012.csv
7420,The Invitation,354835,231737,0.6530838276945623,123098,0.34691617230543775,2016,2016.csv
7421,Kaashmora,354631,327959,0.9247894290121281,26672,0.0752105709878719,2016,2016.csv
7422,Filth and Wisdom,354628,22406,0.06318170026055472,332222,0.9368182997394453,2008,2008.csv
7423,Las Acacias,354391,6000,0.016930452522778514,348391,0.9830695474772215,2011,2011.csv
7424,The Tomorrow Man,354103,354103,1.0,0,0.0,2019,2019.csv
7425,"Broadway: The Golden Age, by the Legends Who Were There",353580,353580,1.0,0,0.0,2004,2004.csv
7426,How My Mother Gave Birth to Me During Menopause,353275,353275,1.0,0,0.0,2003,2003.csv
7427,Bab'Aziz: The Prince That Contemplated His Soul,353119,89672,0.25394272185863687,263447,0.7460572781413631,2007,2007.csv
7428,Like Dandelion Dust,352810,352810,1.0,0,0.0,2010,2010.csv
7429,Lumumba,352296,352296,1.0,0,0.0,2001,2001.csv
7430,Five Fingers,352089,0,0.0,352089,1.0,2006,2006.csv
7431,Long Strange Trip - The Untold Story of The Grateful Dead,351957,351957,1.0,0,0.0,2017,2017.csv
7432,The Wizard of Oz 2018 Re-release,351839,351839,1.0,0,0.0,2018,2018.csv
7433,Yossi & Jagger,351707,267005,0.7591688536196323,84702,0.24083114638036776,2003,2003.csv
7434,The Chumscrubber,351401,52597,0.14967800319293342,298804,0.8503219968070665,2005,2005.csv
7435,Bel Canto,350264,125569,0.35849816138683965,224695,0.6415018386131603,2018,2018.csv
7436,Aferim!,350110,108110,0.3087886664191254,242000,0.6912113335808746,2015,2015.csv
7437,Tehran Taboo,349886,74758,0.21366387909204712,275128,0.7863361209079529,2017,2017.csv
7438,Manufactured Landscapes,349220,240239,0.687930244544986,108981,0.31206975545501403,2007,2007.csv
7439,Satanic,349183,252,0.0007216846180942371,348931,0.9992783153819058,2016,2016.csv
7440,Marie's Story 2014 Re-release,348906,11720,0.03359070924547013,337186,0.9664092907545299,2014,2014.csv
7441,Serious Moonlight,348327,25339,0.07274486330373471,322988,0.9272551366962652,2009,2009.csv
7442,The Merry Gentleman,347977,347977,1.0,0,0.0,2009,2009.csv
7443,Suicide the Ripple Effect,347468,347468,1.0,0,0.0,2018,2018.csv
7444,Billy: The Early Years,347328,347328,1.0,0,0.0,2008,2008.csv
7445,The Good Heart,346851,20930,0.06034291381601898,325921,0.939657086183981,2010,2010.csv
7446,The Vault,346729,5728,0.016520106480853922,341001,0.9834798935191461,2017,2017.csv
7447,Meet Bill,346592,62597,0.18060716923645093,283995,0.8193928307635491,2008,2008.csv
7448,Star Trek: The Motion Picture 2019 Re-release,346243,346243,1.0,0,0.0,2019,2019.csv
7449,Triple Threat,345900,76289,0.2205521827117664,269611,0.7794478172882336,2019,2019.csv
7450,Billabong Odyssey,345708,156000,0.4512478739282863,189708,0.5487521260717138,2003,2003.csv
7451,Bear Cub,345693,100133,0.2896587434515596,245560,0.7103412565484404,2004,2004.csv
7452,Anatomy of Hell,345365,34506,0.09991168763482113,310859,0.9000883123651788,2004,2004.csv
7453,Tera Mera Ki Rishta,345063,271942,0.788093768384324,73121,0.21190623161567598,2009,2009.csv
7454,The Dying Gaul,345041,342747,0.9933515147475228,2294,0.006648485252477242,2005,2005.csv
7455,American Adobo,344992,344992,1.0,0,0.0,2002,2002.csv
7456,Freaks,344321,276591,0.8032940192436708,67730,0.1967059807563291,2019,2019.csv
7457,The United States of Leland,343847,343847,1.0,0,0.0,2004,2004.csv
7458,Countdown to Canelo vs. Chavez Jr.,343387,343387,1.0,0,0.0,2017,2017.csv
7459,El Bulli: Cooking in Progress,343116,237181,0.6912560183727952,105935,0.3087439816272048,2011,2011.csv
7460,The Idol,343059,0,0.0,343059,1.0,2016,2016.csv
7461,Koch,342941,342941,1.0,0,0.0,2013,2013.csv
7462,"Life, Animated",342664,255388,0.7453015198561856,87276,0.25469848014381435,2016,2016.csv
7463,Lawrence of Arabia 2002 Re-release,342481,342481,1.0,0,0.0,2002,2002.csv
7464,Bolshoi Ballet: Swan Lake,342391,88905,0.25965927842729514,253486,0.7403407215727049,2018,2018.csv
7465,Nureyev: Lifting the Curtain,342255,165203,0.482689807307417,177052,0.517310192692583,2018,2018.csv
7466,Knife + Heart,341847,32516,0.09511857643916723,309331,0.9048814235608328,2018,2018.csv
7467,Dangerous People,341280,341280,1.0,0,0.0,2002,2002.csv
7468,Inside Out 2020 Re-release,340000,340000,1.0,0,0.0,2020,2020.csv
7469,This Film Is Not Yet Rated,339609,306845,0.9035243471168314,32764,0.09647565288316859,2006,2006.csv
7470,The Lady in the Car with Glasses and a Gun,339461,2167,0.006383649373565741,337294,0.9936163506264343,2015,2015.csv
7471,The Green Prince,339208,258237,0.7612939553312422,80971,0.2387060446687578,2014,2014.csv
7472,Happy People: A Year in the Taiga,338987,338987,1.0,0,0.0,2013,2013.csv
7473,Red Hook Summer,338803,338803,1.0,0,0.0,2012,2012.csv
7474,Is It Wrong to Try to Pick Up Girls in a Dungeon - Arrow of the Orion,338632,271489,0.80172281414633,67143,0.19827718585367007,2019,2019.csv
7475,Silencio,338596,158723,0.46876808940448206,179873,0.531231910595518,2018,2018.csv
7476,Winter Solstice,337617,319355,0.9459091218747872,18262,0.05409087812521289,2005,2005.csv
7477,Ran 2000 Re-release,337587,337587,1.0,0,0.0,2000,2000.csv
7478,Dark Horse,337150,166228,0.4930387068070592,170922,0.5069612931929408,2012,2012.csv
7479,The Last Waltz 2002 Re-release,337085,322313,0.956177225328923,14772,0.04382277467107703,2002,2002.csv
7480,Voyage of Time: The IMAX Experience,337038,55409,0.16439985995644407,281629,0.8356001400435559,2016,2016.csv
7481,First Love,336756,218329,0.6483299480929813,118427,0.3516700519070187,2019,2019.csv
7482,Kings of Pastry,336386,336386,1.0,0,0.0,2010,2010.csv
7483,Diane,336166,336166,1.0,0,0.0,2019,2019.csv
7484,Wooly Boys,335726,335726,1.0,0,0.0,2004,2004.csv
7485,Sailor Moon R: The Movie: The Promise of the Rose/Sailor Moon S: The Movie - Hearts in Ice,335697,335697,1.0,0,0.0,2018,2018.csv
7486,The 2006 Academy Award Nominated Short Films: Live Action,335090,335090,1.0,0,0.0,2007,2007.csv
7487,Russ Taff: I Still Believe,334983,334983,1.0,0,0.0,2018,2018.csv
7488,Anthropocene: The Human Epoch,334162,104806,0.3136382951981374,229356,0.6863617048018625,2019,2019.csv
7489,A Silent Voice: The Movie 2019 Re-release,333984,333984,1.0,0,0.0,2019,2019.csv
7490,Dark Days,333843,309648,0.9275258130318743,24195,0.07247418696812574,2000,2000.csv
7491,Ballet 422,333554,333554,1.0,0,0.0,2015,2015.csv
7492,Shine,333388,333388,1.0,0,0.0,2018,2018.csv
7493,Something from Nothing: The Art of Rap,333388,288000,0.8638583272343335,45388,0.13614167276566644,2012,2012.csv
7494,Linsanity,332990,302645,0.9088711372713896,30345,0.09112886272861047,2013,2013.csv
7495,Don't Hang Up,332571,0,0.0,332571,1.0,2017,2017.csv
7496,Zinda,332491,332491,1.0,0,0.0,2006,2006.csv
7497,Shamitabh,331821,324597,0.9782292259983545,7224,0.021770774001645465,2015,2015.csv
7498,Shaadi Se Pehle,331676,111678,0.336708112736526,219998,0.663291887263474,2006,2006.csv
7499,Cheech,329972,329972,1.0,0,0.0,2006,2006.csv
7500,I Am David,329577,288552,0.8755222603519056,41025,0.12447773964809437,2004,2004.csv
7501,Bukowski: Born into This,329097,318816,0.968759970464635,10281,0.031240029535364953,2004,2004.csv
7502,The Big Fight Live: IBF Welterweight Title: Errol Spence Jr. vs. Mikey Garcia,328979,328979,1.0,0,0.0,2019,2019.csv
7503,Ladies vs. Ricky Bahl,328870,0,0.0,328870,1.0,2011,2011.csv
7504,The Last Sentence,328005,62506,0.19056416822914285,265499,0.8094358317708572,2012,2012.csv
7505,Elaine Stritch: Shoot Me,327452,327452,1.0,0,0.0,2014,2014.csv
7506,Deliver Us from Evil,327205,201275,0.615134243058633,125930,0.38486575694136704,2006,2006.csv
7507,Come Undone,326484,326484,1.0,0,0.0,2001,2001.csv
7508,You Will Be My Son 2012 Re-release,326061,285151,0.8745326794679523,40910,0.12546732053204768,2012,2012.csv
7509,Formosa Betrayed,326034,225341,0.6911579773888613,100693,0.3088420226111387,2010,2010.csv
7510,Lucy in the Sky,325950,319976,0.9816720355882804,5974,0.018327964411719588,2019,2019.csv
7511,The Central Park Five,325653,325653,1.0,0,0.0,2012,2012.csv
7512,The Opera House,325235,320079,0.9841468476639968,5156,0.015853152336003196,2018,2018.csv
7513,Camp,324977,324977,1.0,0,0.0,2013,2013.csv
7514,Juan of the Dead,324834,18000,0.05541291859842258,306834,0.9445870814015774,2012,2012.csv
7515,Teefa In Trouble,324633,0,0.0,324633,1.0,2018,2018.csv
7516,Red Hill,324424,21087,0.06499827386383251,303337,0.9350017261361675,2010,2010.csv
7517,Standard Operating Procedure,324217,229117,0.7066779348399375,95100,0.29332206516006254,2008,2008.csv
7518,The Bolshoi Ballet: Live From Moscow - The Nutcracker,323928,323928,1.0,0,0.0,2018,2018.csv
7519,The Boys of Baraka,323860,323860,1.0,0,0.0,2005,2005.csv
7520,The Cured,323776,26630,0.08224822099229097,297146,0.917751779007709,2018,2018.csv
7521,Three Worlds,323748,3952,0.012207025217144198,319796,0.9877929747828558,2012,2012.csv
7522,Sword of Trust,323369,322421,0.9970683646236962,948,0.002931635376303851,2019,2019.csv
7523,Damsel,323235,305136,0.944006682444661,18099,0.055993317555339,2018,2018.csv
7524,Citizen Jane: Battle for the City,323124,313411,0.9699403325039304,9713,0.03005966749606962,2017,2017.csv
7525,Winter Sleepers,323041,323041,1.0,0,0.0,2000,2000.csv
7526,The Day He Arrives,322348,13746,0.042643354387184036,308602,0.957356645612816,2011,2011.csv
7527,In This World,322097,84299,0.26171929574010316,237798,0.7382807042598969,2003,2003.csv
7528,Nocturama,321768,30157,0.09372280649411999,291611,0.90627719350588,2016,2016.csv
7529,The Weight of Water,321279,109130,0.33967361701200516,212149,0.6603263829879948,2001,2001.csv
7530,Double Trouble,321081,44788,0.13949128101631675,276293,0.8605087189836832,2012,2012.csv
7531,Woodstock,320610,126562,0.39475375066279905,194048,0.605246249337201,2019,2019.csv
7532,A Film Unfinished,320486,320486,1.0,0,0.0,2010,2010.csv
7533,Cunningham,320293,265102,0.827685900097723,55191,0.17231409990227697,2019,2019.csv
7534,"Die, Mommie, Die!",320092,320092,1.0,0,0.0,2003,2003.csv
7535,The English Teacher,320013,104810,0.3275179445835013,215203,0.6724820554164987,2013,2013.csv
7536,Meeting Gorbachev,319230,251837,0.7888888888888889,67393,0.2111111111111111,2019,2019.csv
7537,Steve Harvey: Don't Trip... He Ain't Through with Me Yet,319021,319021,1.0,0,0.0,2006,2006.csv
7538,You Are Here: A Come From Away Story,318885,318885,1.0,0,0.0,2019,2019.csv
7539,Neal 'n' Nikki,318860,111551,0.34984319136925296,207309,0.650156808630747,2005,2005.csv
7540,Bride of the Wind,318823,318823,1.0,0,0.0,2001,2001.csv
7541,Steep,318763,260586,0.8174913650580525,58177,0.18250863494194747,2007,2007.csv
7542,The Yellow Handkerchief,318623,318623,1.0,0,0.0,2010,2010.csv
7543,West of Memphis,318317,310154,0.9743557522846722,8163,0.025644247715327802,2012,2012.csv
7544,Ask Dr. Ruth,318230,297195,0.9339000094271439,21035,0.06609999057285611,2019,2019.csv
7545,The Student,318123,1126,0.003539511446830314,316997,0.9964604885531697,2016,2016.csv
7546,Not Today,318121,318121,1.0,0,0.0,2013,2013.csv
7547,Today's Special,317831,317831,1.0,0,0.0,2010,2010.csv
7548,Inch'Allah,317656,9840,0.030976905835243155,307816,0.9690230941647568,2013,2013.csv
7549,Sauvage / Wild,317536,61604,0.19400634888642548,255932,0.8059936511135746,2018,2018.csv
7550,6 Days,316946,0,0.0,316946,1.0,2017,2017.csv
7551,5 Days of War,316944,17479,0.05514854359129689,299465,0.9448514564087032,2011,2011.csv
7552,AmeriGeddon,316554,316554,1.0,0,0.0,2016,2016.csv
7553,The Aryan Couple,316527,290211,0.9168601730658048,26316,0.0831398269341952,2005,2005.csv
7554,Corpo Celeste 2011 Re-release,316504,8919,0.028179738644693274,307585,0.9718202613553067,2011,2011.csv
7555,Poison Friends,316184,13665,0.04321850568023682,302519,0.9567814943197632,2006,2006.csv
7556,The Riot and the Dance,316103,316103,1.0,0,0.0,2018,2018.csv
7557,David and Goliath,316100,316100,1.0,0,0.0,2015,2015.csv
7558,Under the Sun,316020,316020,1.0,0,0.0,2001,2001.csv
7559,The Perfect Candidate,315725,0,0.0,315725,1.0,2020,2020.csv
7560,Action Jackson,315609,256872,0.8138931399294697,58737,0.18610686007053032,2014,2014.csv
7561,Josh Groban Bridges Live from Madison Square Garden,315173,315173,1.0,0,0.0,2019,2019.csv
7562,Obit.,315049,315049,1.0,0,0.0,2017,2017.csv
7563,What's Your Zodiac Sign?,314881,257868,0.8189379479866997,57013,0.18106205201330025,2009,2009.csv
7564,Call,314701,314701,1.0,0,0.0,2000,2000.csv
7565,America's Heart & Soul,314402,314402,1.0,0,0.0,2004,2004.csv
7566,Elevator to the Gallows,314387,263404,0.8378336254361662,50983,0.16216637456383376,2005,2005.csv
7567,Time Out of Mind,314082,166775,0.5309919065721691,147307,0.46900809342783095,2015,2015.csv
7568,Russian Doll,313901,127103,0.40491428826285997,186798,0.5950857117371401,2001,2001.csv
7569,Christine,313465,298525,0.9523391766225895,14940,0.04766082337741056,2016,2016.csv
7570,War Witch,313387,70544,0.22510187084977998,242843,0.77489812915022,2012,2012.csv
7571,The Bolshoi Ballet: Live From Moscow - Romeo and Juliet,313088,313088,1.0,0,0.0,2018,2018.csv
7572,Grass,313039,313039,1.0,0,0.0,2000,2000.csv
7573,Berberian Sound Studio,312757,38493,0.1230763819834568,274264,0.8769236180165432,2012,2012.csv
7574,For the Bible Tells Me So,312751,312751,1.0,0,0.0,2007,2007.csv
7575,The Hornet's Nest,312706,312706,1.0,0,0.0,2014,2014.csv
7576,The Gatekeeper,312434,312434,1.0,0,0.0,2003,2003.csv
7577,David Lynch: The Art Life,311470,171419,0.5503547693196776,140051,0.44964523068032236,2017,2017.csv
7578,Plácido Domingo Gala,311246,52502,0.16868329231540324,258744,0.8313167076845968,2019,2019.csv
7579,Dancing in Jaffa,311001,151098,0.48584409696431846,159903,0.5141559030356816,2014,2014.csv
7580,Being Elmo: A Puppeteer's Journey,310812,304052,0.9782505179980181,6760,0.021749482001981905,2011,2011.csv
7581,I Am Eleven 2014 Re-release,310116,310116,1.0,0,0.0,2014,2014.csv
7582,The Darwin Awards,309408,0,0.0,309408,1.0,2007,2007.csv
7583,Adam & Steve,309404,309404,1.0,0,0.0,2006,2006.csv
7584,Bigger Stronger Faster*,308575,308575,1.0,0,0.0,2008,2008.csv
7585,Pumpkin,308552,308552,1.0,0,0.0,2002,2002.csv
7586,The Amazing Catfish,308349,11342,0.03678299589101959,297007,0.9632170041089804,2014,2014.csv
7587,Merchants of Doubt,308156,308156,1.0,0,0.0,2015,2015.csv
7588,MET Opera: Magic Flute,307686,307686,1.0,0,0.0,2018,2018.csv
7589,Never Again,307631,307631,1.0,0,0.0,2002,2002.csv
7590,Dot the I,307486,307486,1.0,0,0.0,2005,2005.csv
7591,The Trip,306567,306567,1.0,0,0.0,2003,2003.csv
7592,Constellation,306533,306533,1.0,0,0.0,2007,2007.csv
7593,Half of a Yellow Sun,306393,54529,0.17797077609475412,251864,0.8220292239052459,2014,2014.csv
7594,The Mercy 2018 Re-release,306205,29538,0.09646478666253,276667,0.90353521333747,2018,2018.csv
7595,Monsters: Dark Continent,306004,0,0.0,306004,1.0,2015,2015.csv
7596,Under the Sun,305993,105036,0.3432627543767341,200957,0.6567372456232659,2016,2016.csv
7597,The Headless Woman,305766,100177,0.327626354794189,205589,0.672373645205811,2008,2008.csv
7598,The Third Wife,305755,84933,0.27778123006982713,220822,0.7222187699301729,2019,2019.csv
7599,Hair Show,305281,305281,1.0,0,0.0,2004,2004.csv
7600,Happiness,305205,305205,1.0,0,0.0,2003,2003.csv
7601,Showtime Championship Boxing: Deontay Wilder vs. Tyson Fury,304482,304482,1.0,0,0.0,2018,2018.csv
7602,Belle toujours,303867,10921,0.03594006588408745,292946,0.9640599341159125,2006,2006.csv
7603,Microbe & Gasoline,303787,63802,0.21002215368004556,239985,0.7899778463199545,2015,2015.csv
7604,N.H 10,303587,303587,1.0,0,0.0,2015,2015.csv
7605,Alamar,303574,61613,0.20295875140822336,241961,0.7970412485917766,2010,2010.csv
7606,Shrink,303431,189621,0.6249229643642212,113810,0.3750770356357788,2009,2009.csv
7607,Chalk,302845,302845,1.0,0,0.0,2007,2007.csv
7608,The Bolshoi Ballet: Live From Moscow - Giselle,302681,302681,1.0,0,0.0,2018,2018.csv
7609,101 Reykjavík 2001 Re-release,301882,126404,0.4187198971783677,175478,0.5812801028216323,2001,2001.csv
7610,The Unknown Known,301604,276497,0.9167550828238352,25107,0.08324491717616478,2014,2014.csv
7611,God Grew Tired of Us,301447,301447,1.0,0,0.0,2007,2007.csv
7612,Old Joy,301047,255923,0.8501097835221743,45124,0.14989021647782572,2006,2006.csv
7613,Cliffs of Freedom,300842,72476,0.2409105111653293,228366,0.7590894888346706,2019,2019.csv
7614,The Wedding Curse,300454,300454,1.0,0,0.0,2006,2006.csv
7615,Planet B-Boy,300447,273870,0.9115418027139562,26577,0.08845819728604379,2008,2008.csv
7616,Beats,300105,0,0.0,300105,1.0,2019,2019.csv
7617,Series 7: The Contenders,300086,195065,0.6500303246402698,105021,0.3499696753597302,2001,2001.csv
7618,Love's Labour's Lost,299792,299792,1.0,0,0.0,2000,2000.csv
7619,Sunset Blvd. 2018 Re-release,299645,299645,1.0,0,0.0,2018,2018.csv
7620,Cotton Mary,299432,299432,1.0,0,0.0,2000,2000.csv
7621,Kedma,299293,10067,0.033635935354318344,289226,0.9663640646456817,2002,2002.csv
7622,Festival in Cannes,299171,299171,1.0,0,0.0,2002,2002.csv
7623,Zhou Yu's Train 2004 Re-release,298429,142562,0.4777082656176176,155867,0.5222917343823824,2004,2004.csv
7624,Jinn,297381,202348,0.6804335179449931,95033,0.3195664820550069,2014,2014.csv
7625,Kaptaan,296715,203790,0.6868206865173652,92925,0.31317931348263484,2016,2016.csv
7626,Black Dynamite,296557,242578,0.8179810289421595,53979,0.18201897105784048,2009,2009.csv
7627,Bonhoeffer,296181,296181,1.0,0,0.0,2003,2003.csv
7628,The We and the I,295930,42172,0.1425066738755787,253758,0.8574933261244213,2012,2012.csv
7629,Trixie,295683,295683,1.0,0,0.0,2000,2000.csv
7630,Chic!,295295,5587,0.018920062987859598,289708,0.9810799370121404,2015,2015.csv
7631,Wet Hot American Summer,295206,295206,1.0,0,0.0,2001,2001.csv
7632,The Tenth Man,295129,63564,0.21537700463187284,231565,0.7846229953681272,2016,2016.csv
7633,Mickey,294758,294758,1.0,0,0.0,2004,2004.csv
7634,Aftershock,294696,58510,0.19854358389662569,236186,0.8014564161033744,2013,2013.csv
7635,Shakira in Concert: El Dorado World Tour,294677,271586,0.9216396257597301,23091,0.07836037424026986,2019,2019.csv
7636,Khodorkovsky,294599,39522,0.1341552415317092,255077,0.8658447584682908,2011,2011.csv
7637,Special Treatment,294483,8856,0.0300730432656554,285627,0.9699269567343446,2010,2010.csv
7638,Taxi to the Dark Side,294309,274661,0.9332402339038222,19648,0.06675976609617783,2008,2008.csv
7639,44 Inch Chest 2010 Re-release,294245,39033,0.1326547604887084,255212,0.8673452395112916,2010,2010.csv
7640,Surfwise,294236,269994,0.9176103535937139,24242,0.08238964640628611,2008,2008.csv
7641,Karthik Calling Karthik,293499,286409,0.975843188562823,7090,0.024156811437176958,2010,2010.csv
7642,Okko's Inn,293385,134787,0.4594202157574518,158598,0.5405797842425482,2018,2018.csv
7643,The Giant Spider Invasion,293053,293053,1.0,0,0.0,2019,2019.csv
7644,Pianomania,292870,49852,0.17021886843992215,243018,0.8297811315600778,2010,2010.csv
7645,Taxi No. 9 2 11: Nau Do Gyarah,292794,292794,1.0,0,0.0,2006,2006.csv
7646,Stonewall,292669,187674,0.6412500128131097,104995,0.35874998718689033,2015,2015.csv
7647,Luminarias,292309,292309,1.0,0,0.0,2000,2000.csv
7648,Mesrine Part 2: Public Enemy #1 2010 Re-release,292150,275387,0.9426219407838439,16763,0.05737805921615608,2010,2010.csv
7649,Passage to Zarahemla,292102,292102,1.0,0,0.0,2007,2007.csv
7650,The Last Five Years,292092,145427,0.4978808046779782,146665,0.5021191953220219,2015,2015.csv
7651,Dreams of a Life,291898,8405,0.02879430485991682,283493,0.9712056951400831,2011,2011.csv
7652,The Godfather: Part II 45th Anniversary,291754,291754,1.0,0,0.0,2019,2019.csv
7653,The Man in 3B,291513,291513,1.0,0,0.0,2015,2015.csv
7654,Waste Land,291307,187716,0.644392342099572,103591,0.3556076579004281,2010,2010.csv
7655,Big Bad Wolves,291239,33232,0.11410559712126467,258007,0.8858944028787353,2014,2014.csv
7656,Imaginary Heroes,291118,228767,0.7858222439010986,62351,0.21417775609890147,2004,2004.csv
7657,Power and Terror: Noam Chomsky in Our Times,290767,290767,1.0,0,0.0,2002,2002.csv
7658,More Than Funny,290498,290498,1.0,0,0.0,2018,2018.csv
7659,Illégal,290108,651,0.0022439918926744525,289457,0.9977560081073256,2010,2010.csv
7660,Jimmy Vestvood: Amerikan Hero,290080,230069,0.7931225868725869,60011,0.20687741312741312,2016,2016.csv
7661,Best F(r)iends: Volume 1,290064,252410,0.8701872690164929,37654,0.1298127309835071,2018,2018.csv
7662,Scratch,289885,289885,1.0,0,0.0,2002,2002.csv
7663,The Zoya Factor,289631,128831,0.4448108109974416,160800,0.5551891890025584,2019,2019.csv
7664,Best Night Ever,289511,0,0.0,289511,1.0,2014,2014.csv
7665,Chaos Theory,289458,240476,0.8307802859136731,48982,0.16921971408632686,2008,2008.csv
7666,The Silence of Others,289455,67986,0.2348758874436441,221469,0.7651241125563559,2018,2018.csv
7667,Welcome to New York,288837,0,0.0,288837,1.0,2014,2014.csv
7668,Antarctica: A Year on Ice,288757,288757,1.0,0,0.0,2014,2014.csv
7669,Above and Beyond,288751,288751,1.0,0,0.0,2015,2015.csv
7670,The Last of Robin Hood,288545,288545,1.0,0,0.0,2014,2014.csv
7671,Saga of Tanya the Evil - The Movie,288460,288460,1.0,0,0.0,2019,2019.csv
7672,Last Train Home,288328,288328,1.0,0,0.0,2010,2010.csv
7673,American Pimp,287724,287724,1.0,0,0.0,2000,2000.csv
7674,Countdown to Zero,287711,272040,0.9455321485796511,15671,0.05446785142034889,2010,2010.csv
7675,Generation Wealth,287709,237709,0.8262132919025821,50000,0.17378670809741786,2018,2018.csv
7676,The Lucky Ones,287567,266967,0.9283645202683201,20600,0.07163547973167993,2008,2008.csv
7677,Skate Kitchen,287307,236799,0.824201986028882,50508,0.175798013971118,2018,2018.csv
7678,Outrage,287198,287198,1.0,0,0.0,2009,2009.csv
7679,Post Mortem,286702,9750,0.03400743629273601,276952,0.9659925637072639,2010,2010.csv
7680,The Interrupters,286457,282448,0.9860048803136248,4009,0.013995119686375268,2011,2011.csv
7681,My Winnipeg,285469,159363,0.5582497574167423,126106,0.44175024258325774,2008,2008.csv
7682,Notre musique,285354,139922,0.4903453254553993,145432,0.5096546745446008,2004,2004.csv
7683,But Deliver Us from Evil,285169,285169,1.0,0,0.0,2018,2018.csv
7684,Wind Chill,285060,36804,0.1291096611239739,248256,0.8708903388760261,2007,2007.csv
7685,Only Human 2006 Re-release,284961,284961,1.0,0,0.0,2006,2006.csv
7686,Das letzte Schweigen 2012 Re-release,284471,100214,0.35228195492686426,184257,0.6477180450731358,2012,2012.csv
7687,Khalid: Free Spirit,284229,284229,1.0,0,0.0,2019,2019.csv
7688,South of the Border,284214,198600,0.6987692372648778,85614,0.3012307627351221,2010,2010.csv
7689,The Anonymous People,284147,284147,1.0,0,0.0,2013,2013.csv
7690,The Kindergarten Teacher,284065,36190,0.12740041891820533,247875,0.8725995810817947,2014,2014.csv
7691,George Washington,283846,247406,0.8716205266235917,36440,0.12837947337640834,2000,2000.csv
7692,Valhalla Rising,282737,30638,0.10836218818195001,252099,0.89163781181805,2009,2009.csv
7693,The Heart of Me,282519,196067,0.6939958020522513,86452,0.30600419794774864,2003,2003.csv
7694,Disney's Newsies: The Broadway Musical! 2018 Re-release,282429,282429,1.0,0,0.0,2018,2018.csv
7695,Created Equal: Clarence Thomas in His Own Words,282149,282149,1.0,0,0.0,2020,2020.csv
7696,Tumbledown,282083,135026,0.47867471630690256,147057,0.5213252836930974,2016,2016.csv
7697,Ho Mann Jahaan,281926,208611,0.7399494902917787,73315,0.2600505097082213,2016,2016.csv
7698,Green Dragon,281803,281803,1.0,0,0.0,2002,2002.csv
7699,That Evening Sun,281350,281350,1.0,0,0.0,2009,2009.csv
7700,Mike Wallace Is Here,281245,281245,1.0,0,0.0,2019,2019.csv
7701,Zus & Zo,281219,49468,0.17590561092956022,231751,0.8240943890704397,2002,2002.csv
7702,Brand Upon the Brain! A Remembrance in 12 Chapters,281091,263200,0.9363515729781459,17891,0.06364842702185414,2007,2007.csv
7703,"If I Want to Whistle, I Whistle",280892,12135,0.04320165757657748,268757,0.9567983424234225,2010,2010.csv
7704,The Body,280777,36849,0.13123938214312425,243928,0.8687606178568757,2001,2001.csv
7705,Octaman,280710,280710,1.0,0,0.0,2019,2019.csv
7706,I Do... Until I Don't,280668,280668,1.0,0,0.0,2017,2017.csv
7707,Who Is Cletis Tout?,280458,252706,0.9010475721854966,27752,0.09895242781450342,2002,2002.csv
7708,The Battle of Shaker Heights,280351,280351,1.0,0,0.0,2003,2003.csv
7709,Lola Montès,280314,120306,0.4291829876495644,160008,0.5708170123504356,2008,2008.csv
7710,The Black Power Mixtape 1967-1975,280025,273749,0.9775877153825552,6276,0.02241228461744487,2011,2011.csv
7711,Namaste England,279934,104156,0.37207341730550775,175778,0.6279265826944923,2018,2018.csv
7712,Wonders of the Sea,279415,100780,0.360682139469964,178635,0.6393178605300359,2018,2018.csv
7713,Havenhurst,279372,0,0.0,279372,1.0,2016,2016.csv
7714,Christmas in the Clouds,279225,279225,1.0,0,0.0,2005,2005.csv
7715,"Lovely, Still",279170,127564,0.4569402156392163,151606,0.5430597843607837,2010,2010.csv
7716,The Five Obstructions,279032,165845,0.5943583531637948,113187,0.4056416468362052,2004,2004.csv
7717,"Lou Andreas-Salomé, The Audacity to be Free",278982,12875,0.04614993081990953,266107,0.9538500691800905,2017,2017.csv
7718,Smiling Fish & Goat on Fire,278492,278492,1.0,0,0.0,2000,2000.csv
7719,10 Years,278336,203373,0.730674436652104,74963,0.2693255633478961,2012,2012.csv
7720,Bolshoi Ballet: The Golden Age,277666,171916,0.6191467446500472,105750,0.38085325534995285,2019,2019.csv
7721,The Summit,277651,243550,0.8771803451095079,34101,0.12281965489049201,2013,2013.csv
7722,Solas,277596,277596,1.0,0,0.0,2000,2000.csv
7723,Science Fair,277338,276195,0.9958786751184475,1143,0.004121324881552474,2018,2018.csv
7724,Wonderful Town,277233,4487,0.016184941908070107,272746,0.9838150580919299,2008,2008.csv
7725,See You Soon,277126,0,0.0,277126,1.0,2019,2019.csv
7726,Eyes Wide Open,276576,26258,0.09493954645377763,250318,0.9050604535462223,2009,2009.csv
7727,True Grit 2019 Re-release,276418,276418,1.0,0,0.0,2019,2019.csv
7728,Seven Samurai 2002 Re-release,275965,271841,0.9850560759516606,4124,0.014943924048339463,2002,2002.csv
7729,Morning Light,275776,275497,0.998988309352518,279,0.0010116906474820144,2008,2008.csv
7730,Piñero,275171,275171,1.0,0,0.0,2001,2001.csv
7731,Life After Beth,274717,88273,0.3213233982607556,186444,0.6786766017392444,2014,2014.csv
7732,Hey Ram,274675,274675,1.0,0,0.0,2000,2000.csv
7733,Lovely Molly,274480,18464,0.06726901777907315,256016,0.9327309822209269,2012,2012.csv
7734,Swallow,274259,33419,0.1218519720410269,240840,0.8781480279589731,2020,2020.csv
7735,Dirty,274245,274245,1.0,0,0.0,2006,2006.csv
7736,The Rules of the Game,273641,273641,1.0,0,0.0,2006,2006.csv
7737,The King,273601,259291,0.9476975595849431,14310,0.05230244041505696,2018,2018.csv
7738,A Man Apart,273364,213143,0.7797039844310151,60221,0.22029601556898495,2005,2005.csv
7739,P.S.,273023,180503,0.6611274508008482,92520,0.3388725491991517,2004,2004.csv
7740,Slayer: The Repentless Killogy,272874,268727,0.9848025095831776,4147,0.015197490416822416,2019,2019.csv
7741,Chavela,272842,148666,0.5448794540429992,124176,0.45512054595700074,2017,2017.csv
7742,Stander,272791,31651,0.11602655512828502,241140,0.883973444871715,2003,2003.csv
7743,Black Death,272445,22554,0.0827836811099488,249891,0.9172163188900512,2010,2010.csv
7744,One Child Nation,271841,270128,0.993698522297961,1713,0.0063014777020390595,2019,2019.csv
7745,Come Out and Play,271735,2638,0.009707987561410933,269097,0.9902920124385891,2013,2013.csv
7746,The Tale of The Princess Kaguya 2019 Re-release,271681,271681,1.0,0,0.0,2019,2019.csv
7747,Aloft,270971,53086,0.19591026345992746,217885,0.8040897365400725,2015,2015.csv
7748,Around a Small Mountain,270930,33216,0.12259993356217473,237714,0.8774000664378253,2009,2009.csv
7749,Rishtey,270929,119537,0.44121153512543876,151392,0.5587884648745612,2002,2002.csv
7750,Deep in the Woods,270890,56119,0.2071652700358079,214771,0.7928347299641921,2000,2000.csv
7751,Waking the Dead,270745,270745,1.0,0,0.0,2000,2000.csv
7752,Call of the Wild,270210,28682,0.10614707079678769,241528,0.8938529292032124,2009,2009.csv
7753,The Canyons,270185,56825,0.21031885559894148,213360,0.7896811444010585,2013,2013.csv
7754,This Old Cub,270014,270014,1.0,0,0.0,2004,2004.csv
7755,Exposed,269915,0,0.0,269915,1.0,2016,2016.csv
7756,Stalker,269881,269881,1.0,0,0.0,2017,2017.csv
7757,Shirin Farhad Ki Toh Nikal Padi,269845,155758,0.5772128444106802,114087,0.4227871555893198,2012,2012.csv
7758,Fierce People,269755,85410,0.3166206372449074,184345,0.6833793627550926,2006,2006.csv
7759,Boy Culture,269589,220409,0.8175741591830528,49180,0.18242584081694727,2007,2007.csv
7760,The Loneliest Planet,268933,129579,0.4818263284907393,139354,0.5181736715092606,2012,2012.csv
7761,The World Before Your Feet,268644,268644,1.0,0,0.0,2018,2018.csv
7762,Harvard Beats Yale 29-29,268431,268431,1.0,0,0.0,2008,2008.csv
7763,Psycho Beach Party,268117,268117,1.0,0,0.0,2000,2000.csv
7764,Meri Pyaari Bindu,268067,0,0.0,268067,1.0,2017,2017.csv
7765,The Carer,267995,6208,0.023164611280061195,261787,0.9768353887199388,2016,2016.csv
7766,Conan O'Brien Can't Stop,267965,267965,1.0,0,0.0,2011,2011.csv
7767,An American in Paris 2020 Re-release,267824,267824,1.0,0,0.0,2020,2020.csv
7768,Falcon Rising,267476,11774,0.04401890263051638,255702,0.9559810973694837,2014,2014.csv
7769,Gilles' Wife,267402,32799,0.12265802050844796,234603,0.877341979491552,2004,2004.csv
7770,Munger Road,266689,266689,1.0,0,0.0,2011,2011.csv
7771,Luzia: Cirque du Soleil in Cinema,265673,265673,1.0,0,0.0,2019,2019.csv
7772,Félicité,265495,12433,0.04682950714702725,253062,0.9531704928529727,2017,2017.csv
7773,Out of Liberty,265279,265279,1.0,0,0.0,2019,2019.csv
7774,The TV Set,265198,265198,1.0,0,0.0,2007,2007.csv
7775,Asbury Park: Riot Redemption Rock 'n Roll,264983,167684,0.6328104067053358,97299,0.36718959329466416,2019,2019.csv
7776,Doctor Who,264629,264629,1.0,0,0.0,2018,2018.csv
7777,Shoot on Sight,264617,0,0.0,264617,1.0,2008,2008.csv
7778,Riding the Bullet,264505,134711,0.5092947203266479,129794,0.4907052796733521,2004,2004.csv
7779,Little Girl,264498,1350,0.005104008347889209,263148,0.9948959916521108,2009,2009.csv
7780,Beautiful People,264292,264292,1.0,0,0.0,2000,2000.csv
7781,The Secrets,264006,122094,0.46246676211904275,141912,0.5375332378809573,2008,2008.csv
7782,Phil Ochs: There But for Fortune,263723,263723,1.0,0,0.0,2011,2011.csv
7783,The Producers 2018 Re-release,263277,216807,0.8234938866668946,46470,0.17650611333310542,2018,2018.csv
7784,Life and Debt,263107,263107,1.0,0,0.0,2001,2001.csv
7785,My Date with Drew,262770,181041,0.6889713437607032,81729,0.3110286562392967,2005,2005.csv
7786,Raja,262643,13000,0.04949684552796001,249643,0.95050315447204,2003,2003.csv
7787,Grand départ,262412,677,0.0025799125040013413,261735,0.9974200874959986,2013,2013.csv
7788,Augustine,262390,107352,0.40913144555813863,155038,0.5908685544418614,2013,2013.csv
7789,The Final Year,262286,191900,0.73164408317638,70386,0.26835591682362003,2018,2018.csv
7790,Bubble,261966,145626,0.5558965667300336,116340,0.4441034332699663,2006,2006.csv
7791,Minimalism: A Documentary About the Important Things,261865,261865,1.0,0,0.0,2016,2016.csv
7792,Any Day Now,261747,201395,0.7694262016374591,60352,0.23057379836254094,2012,2012.csv
7793,Half Girlfriend,261597,0,0.0,261597,1.0,2017,2017.csv
7794,Circuit,261155,235087,0.9001818843215715,26068,0.09981811567842852,2002,2002.csv
7795,Requiem 2006 Re-release,260877,9600,0.03679895122988995,251277,0.96320104877011,2006,2006.csv
7796,Eating You Alive,260534,260534,1.0,0,0.0,2018,2018.csv
7797,Stone Reader,260523,260523,1.0,0,0.0,2003,2003.csv
7798,Her Smell,260481,255599,0.9812577500854189,4882,0.0187422499145811,2019,2019.csv
7799,Star Raiders: The Adventures of Saber Raine,260234,260234,1.0,0,0.0,2019,2019.csv
7800,The Wind Will Carry Us,259510,259510,1.0,0,0.0,2000,2000.csv
7801,James' Journey to Jerusalem,259026,64967,0.25081265973299977,194059,0.7491873402670002,2004,2004.csv
7802,The Cave,258921,62625,0.24186914155282885,196296,0.7581308584471711,2019,2019.csv
7803,Malevolence,258782,127287,0.4918696045319999,131495,0.5081303954680001,2004,2004.csv
7804,The Unspoken,258760,0,0.0,258760,1.0,2016,2016.csv
7805,Across the Universe 2018 Re-release,258618,258618,1.0,0,0.0,2018,2018.csv
7806,What Time Is It There?,258592,195760,0.7570226457121644,62832,0.24297735428783565,2001,2001.csv
7807,Big 2018 Re-release,258507,258507,1.0,0,0.0,2018,2018.csv
7808,My Kid Could Paint That,258316,231574,0.8964756344941854,26742,0.10352436550581458,2007,2007.csv
7809,The Music Never Stopped,258223,258223,1.0,0,0.0,2011,2011.csv
7810,Mrs. Worthington's Party,257868,257868,1.0,0,0.0,2007,2007.csv
7811,Mayor of the Sunset Strip,257315,257315,1.0,0,0.0,2004,2004.csv
7812,Mysteries of Lisbon,257065,110507,0.42987960243518175,146558,0.5701203975648182,2010,2010.csv
7813,Spiders,257019,0,0.0,257019,1.0,2013,2013.csv
7814,Raja Natwarlal,256978,131105,0.5101798597545315,125873,0.4898201402454685,2014,2014.csv
7815,Helicopter Eela,256952,71971,0.2800951150409415,184981,0.7199048849590585,2018,2018.csv
7816,Alive Inside: A Story of Music and Memory,256682,256682,1.0,0,0.0,2014,2014.csv
7817,Jean-Michel Basquiat: The Radiant Child,256242,256242,1.0,0,0.0,2010,2010.csv
7818,Greendale,255947,255947,1.0,0,0.0,2004,2004.csv
7819,Beaufort,255780,102591,0.4010907811400422,153189,0.5989092188599577,2008,2008.csv
7820,Officer Down,255080,1463,0.005735455543358946,253617,0.994264544456641,2013,2013.csv
7821,Sex with Strangers,254852,254852,1.0,0,0.0,2002,2002.csv
7822,Gerry,254683,254683,1.0,0,0.0,2003,2003.csv
7823,Soul Power,254582,207121,0.8135728370426817,47461,0.18642716295731826,2009,2009.csv
7824,Dean,254536,254536,1.0,0,0.0,2017,2017.csv
7825,The Robber,254489,83451,0.3279159413569938,171038,0.6720840586430061,2010,2010.csv
7826,Maelstrom,254380,254380,1.0,0,0.0,2000,2000.csv
7827,Civil Brand,254293,254293,1.0,0,0.0,2003,2003.csv
7828,The War Tapes,254190,254190,1.0,0,0.0,2006,2006.csv
7829,Fall in Love Like a Star 2015 Re-release,253785,212508,0.8373544535729062,41277,0.1626455464270938,2015,2015.csv
7830,Battle in Heaven,253751,70899,0.27940382500955663,182852,0.7205961749904434,2005,2005.csv
7831,Mistaken for Strangers,253285,138991,0.5487533805791894,114294,0.45124661942081057,2014,2014.csv
7832,Harry Potter and the Chamber of Secrets 2018 Re-release,253220,245501,0.9695166258589369,7719,0.030483374141063106,2002,2002.csv
7833,Battlefield America,252805,172000,0.6803662902236902,80805,0.3196337097763098,2012,2012.csv
7834,Love's Abiding Joy,252726,252726,1.0,0,0.0,2006,2006.csv
7835,Broken Bridges,252539,252539,1.0,0,0.0,2006,2006.csv
7836,When Harry Met Sally... 30th Anniversary,252320,252320,1.0,0,0.0,2019,2019.csv
7837,I Got the Hook Up 2,252293,252293,1.0,0,0.0,2019,2019.csv
7838,Resistance,252287,7464,0.029585353189026782,244823,0.9704146468109732,2020,2020.csv
7839,The Human Centipede (First Sequence),252207,181467,0.7195161117653356,70740,0.28048388823466436,2010,2010.csv
7840,Caterpillar,251922,4157,0.01650113924151126,247765,0.9834988607584887,2010,2010.csv
7841,Canal Street,251917,251917,1.0,0,0.0,2019,2019.csv
7842,Unhinged,251849,0,0.0,251849,1.0,2020,2020.csv
7843,Gook,251541,250130,0.994390576486537,1411,0.005609423513463014,2017,2017.csv
7844,Dominion,251495,251495,1.0,0,0.0,2005,2005.csv
7845,Happenstance,251444,251444,1.0,0,0.0,2001,2001.csv
7846,Drawing Restraint 9,251009,234743,0.9351975427175918,16266,0.0648024572824082,2006,2006.csv
7847,The 13th Alley,250992,250992,1.0,0,0.0,2008,2008.csv
7848,Dedication,250182,92853,0.3711418087632204,157329,0.6288581912367797,2007,2007.csv
7849,Games of Love and Chance 2005 Re-release,249616,8085,0.032389750657009164,241531,0.9676102493429908,2005,2005.csv
7850,Gay Sex in the 70s,249565,249565,1.0,0,0.0,2005,2005.csv
7851,May,249300,150277,0.602795828319294,99023,0.397204171680706,2003,2003.csv
7852,Skins,249204,249204,1.0,0,0.0,2002,2002.csv
7853,Half Moon,248749,2528,0.010162854926049954,246221,0.98983714507395,2007,2007.csv
7854,The Twilight Zone: A 60th Anniversary Celebration,248514,248514,1.0,0,0.0,2019,2019.csv
7855,Band Aid,248370,248370,1.0,0,0.0,2017,2017.csv
7856,The Attacks of 26/11,248346,248346,1.0,0,0.0,2013,2013.csv
7857,Testosterone,248128,185078,0.7458972788238328,63050,0.2541027211761671,2004,2004.csv
7858,Wild Oats,247949,40598,0.16373528427216888,207351,0.8362647157278311,2016,2016.csv
7859,Doctor Who: The End of Time: Part One,247798,247798,1.0,0,0.0,2019,2019.csv
7860,Marcel Proust's Time Regained,247728,247728,1.0,0,0.0,2000,2000.csv
7861,Charlotte Sometimes,247554,150445,0.607725991096892,97109,0.392274008903108,2002,2002.csv
7862,Lilting,247377,27054,0.10936344122533623,220323,0.8906365587746637,2014,2014.csv
7863,The Galapagos Affair: Satan Came to Eden,247159,247159,1.0,0,0.0,2014,2014.csv
7864,Enlighten Up!,246649,246649,1.0,0,0.0,2008,2008.csv
7865,My Dog Tulip,246574,246574,1.0,0,0.0,2010,2010.csv
7866,The Notebook 2013 Re-release,246557,66559,0.2699538037857372,179998,0.7300461962142628,2013,2013.csv
7867,The Animation Show 2005 Re-release,246520,246520,1.0,0,0.0,2005,2005.csv
7868,The Love Witch,246218,228894,0.9296395876824602,17324,0.07036041231753974,2016,2016.csv
7869,Friendsgiving Day #1,246168,246168,1.0,0,0.0,2019,2019.csv
7870,Hot Summer Nights,246133,0,0.0,246133,1.0,2018,2018.csv
7871,Watermarks,246094,246094,1.0,0,0.0,2005,2005.csv
7872,Larger Than Life in 3D,246042,246042,1.0,0,0.0,2009,2009.csv
7873,"Tuesday, After Christmas",245833,27813,0.1131377805258041,218020,0.8868622194741959,2010,2010.csv
7874,Battle for Haditha,245521,10310,0.04199233466791028,235211,0.9580076653320897,2007,2007.csv
7875,American Woman,245416,236637,0.9642280861883495,8779,0.03577191381165042,2019,2019.csv
7876,The Foot Fist Way,245292,234286,0.9551310275100696,11006,0.04486897248993037,2008,2008.csv
7877,The Fireflies Are Gone,245006,245006,1.0,0,0.0,2018,2018.csv
7878,The Waiting Room,244951,244951,1.0,0,0.0,2012,2012.csv
7879,This Is Spinal Tap 2000 Re-release,244557,244557,1.0,0,0.0,2000,2000.csv
7880,Time and Tide,243978,10770,0.044143324398101466,233208,0.9558566756018986,2001,2001.csv
7881,Term Life,243793,21256,0.08718872157937266,222537,0.9128112784206274,2016,2016.csv
7882,The Legend of God's Gun,243768,243768,1.0,0,0.0,2008,2008.csv
7883,My Uncle Rafael,243616,243616,1.0,0,0.0,2012,2012.csv
7884,Edmond,243524,131719,0.5408871404871799,111805,0.4591128595128201,2006,2006.csv
7885,Rangeelay,243246,148418,0.6101559737878526,94828,0.38984402621214737,2013,2013.csv
7886,Do Knot Disturb,243176,213525,0.8780677369477251,29651,0.12193226305227489,2009,2009.csv
7887,Santitos,243000,243000,1.0,0,0.0,2000,2000.csv
7888,Out of Blue,242847,18779,0.07732852372069657,224068,0.9226714762793035,2019,2019.csv
7889,Audition,242759,131296,0.5408491549231954,111463,0.4591508450768046,2001,2001.csv
7890,My Perestroika,242707,242707,1.0,0,0.0,2011,2011.csv
7891,Tevar,242453,236002,0.9733927812813205,6451,0.026607218718679496,2015,2015.csv
7892,The Yes Men Fix the World,241868,194533,0.8042940777614236,47335,0.1957059222385764,2009,2009.csv
7893,Pyare Mohan,241841,150198,0.6210609450010545,91643,0.3789390549989456,2006,2006.csv
7894,Play the Flute,241251,241251,1.0,0,0.0,2019,2019.csv
7895,Iraq in Fragments,240888,204462,0.8487844973597689,36426,0.15121550264023115,2006,2006.csv
7896,Brotherhood,240887,8979,0.03727473877793322,231908,0.9627252612220668,2010,2010.csv
7897,Darshan,240819,66032,0.2741976339076236,174787,0.7258023660923765,2005,2005.csv
7898,Road to Ninja - Naruto the Movie 2014 Re-release,240687,43171,0.17936573225807792,197516,0.820634267741922,2014,2014.csv
7899,Boulevard,240450,126150,0.5246412975670618,114300,0.47535870243293826,2015,2015.csv
7900,Carter High,240214,240214,1.0,0,0.0,2015,2015.csv
7901,ABCD (Any Body Can Dance),240194,222098,0.9246608991065556,18096,0.07533910089344446,2013,2013.csv
7902,Of Horses and Men,239969,11894,0.04956473544499498,228075,0.950435264555005,2013,2013.csv
7903,Dark River,239182,7714,0.03225159083877549,231468,0.9677484091612245,2018,2018.csv
7904,Uncovered: The War on Iraq,238924,238924,1.0,0,0.0,2004,2004.csv
7905,Nina's Tragedies,238831,238831,1.0,0,0.0,2005,2005.csv
7906,311 Enlarged to Show Detail 3,238791,238791,1.0,0,0.0,2019,2019.csv
7907,La bûche,238754,238754,1.0,0,0.0,2000,2000.csv
7908,Crown Heights,238558,238558,1.0,0,0.0,2017,2017.csv
7909,The Independent,238431,238431,1.0,0,0.0,2001,2001.csv
7910,RWBY: Argus Limited,238379,238379,1.0,0,0.0,2018,2018.csv
7911,"Ram Dass, Fierce Grace",238260,238260,1.0,0,0.0,2002,2002.csv
7912,Red Obsession,238223,13199,0.05540606910331916,225024,0.9445939308966809,2013,2013.csv
7913,American Satan,237708,237708,1.0,0,0.0,2017,2017.csv
7914,Tokyo Godfathers 2020 Re-release,237571,237571,1.0,0,0.0,2020,2020.csv
7915,Alien Intrusion: Unmasking a Deception,237411,237411,1.0,0,0.0,2018,2018.csv
7916,Shuddh Desi Romance,237249,0,0.0,237249,1.0,2013,2013.csv
7917,New York Doll,237136,219672,0.9263544969975035,17464,0.07364550300249646,2005,2005.csv
7918,Middle of Nowhere,236806,236806,1.0,0,0.0,2012,2012.csv
7919,Chopper,236185,236185,1.0,0,0.0,2001,2001.csv
7920,The Far Side of the Moon,235926,235926,1.0,0,0.0,2003,2003.csv
7921,Varda by Agnès,235699,160765,0.6820775650299746,74934,0.3179224349700253,2019,2019.csv
7922,India's Most Wanted,235351,176858,0.7514648333765312,58493,0.24853516662346878,2019,2019.csv
7923,The Exorcist Extended Director's Cut,235134,235134,1.0,0,0.0,2010,2010.csv
7924,Diamantino,235041,70088,0.29819478303785296,164953,0.701805216962147,2018,2018.csv
7925,Art and Craft,235037,235037,1.0,0,0.0,2014,2014.csv
7926,Big Fan,234540,234540,1.0,0,0.0,2009,2009.csv
7927,Blind Eyes Opened,234505,234505,1.0,0,0.0,2020,2020.csv
7928,After the Ball,234417,161820,0.6903082967532218,72597,0.3096917032467782,2015,2015.csv
7929,Swimming,234287,234287,1.0,0,0.0,2002,2002.csv
7930,Little Shop of Horrors 2017 Re-release,233865,233865,1.0,0,0.0,2017,2017.csv
7931,Superman 2018 Re-release,233585,233585,1.0,0,0.0,2018,2018.csv
7932,Premier Boxing Champions: PBC on FOX: Spence vs. Porter,232973,232973,1.0,0,0.0,2019,2019.csv
7933,Lost and Found in Armenia,232857,122305,0.5252365185500114,110552,0.47476348144998864,2012,2012.csv
7934,CSNY/Déjà Vu,232260,65025,0.27996641694652546,167235,0.7200335830534745,2008,2008.csv
7935,Down and Derby,231609,231609,1.0,0,0.0,2005,2005.csv
7936,Bishôjo senshi Sailor Moon Super S Special,231434,231434,1.0,0,0.0,2018,2018.csv
7937,The World,231383,64123,0.27712926187317133,167260,0.7228707381268287,2005,2005.csv
7938,A Place at the Table,231378,231378,1.0,0,0.0,2013,2013.csv
7939,The Great Role,231162,11419,0.04939825749906992,219743,0.9506017425009301,2004,2004.csv
7940,Les destinées,230900,230900,1.0,0,0.0,2002,2002.csv
7941,DAZN Boxing: Canelo Alvarez vs. Daniel Jacobs,230703,230703,1.0,0,0.0,2019,2019.csv
7942,(Untitled),230600,230600,1.0,0,0.0,2009,2009.csv
7943,"Life, Above All",230529,134461,0.5832715189845963,96068,0.4167284810154037,2011,2011.csv
7944,Father,230422,199228,0.8646223016899428,31194,0.1353776983100572,2009,2009.csv
7945,Chakravyuh,230136,151778,0.6595143741092224,78358,0.34048562589077763,2012,2012.csv
7946,"Belle and Sebastian, Friends for Life 2018 Re-release",229983,105890,0.4604253357856885,124093,0.5395746642143114,2018,2018.csv
7947,Wrecked,229532,8020,0.03494066186849764,221512,0.9650593381315024,2011,2011.csv
7948,Ophelia,229405,50722,0.22110241712255618,178683,0.7788975828774438,2019,2019.csv
7949,Luv Shuv Tey Chicken Khurana,229136,143507,0.6262961734515746,85629,0.3737038265484254,2012,2012.csv
7950,Miss Conception,228928,2134,0.009321708135308918,226794,0.990678291864691,2008,2008.csv
7951,Dig!,228828,127067,0.5552948065796144,101761,0.4447051934203856,2004,2004.csv
7952,Fast Food Fast Women,228787,17131,0.07487750615201039,211656,0.9251224938479896,2001,2001.csv
7953,The Last Tree,228676,10128,0.04428973744511886,218548,0.9557102625548811,2019,2019.csv
7954,Doctor Who Live Q&A And Screening,228615,228615,1.0,0,0.0,2020,2020.csv
7955,Murder 2,228501,59000,0.2582045592798281,169501,0.7417954407201719,2011,2011.csv
7956,City of Ghosts,228225,128015,0.560915762953226,100210,0.439084237046774,2017,2017.csv
7957,Jeremiah Tower: The Last Magnificent,228153,228153,1.0,0,0.0,2017,2017.csv
7958,InAPPropriate Comedy,228004,228004,1.0,0,0.0,2013,2013.csv
7959,Like Water,227332,0,0.0,227332,1.0,2012,2012.csv
7960,Guiana 1838,227241,227241,1.0,0,0.0,2004,2004.csv
7961,Black Gold,227105,93477,0.41160256269126616,133628,0.5883974373087338,2006,2006.csv
7962,Studio 54,227062,199767,0.879790541790348,27295,0.120209458209652,2018,2018.csv
7963,This So-Called Disaster: Sam Shepard Directs the Late Henry Moss,226658,226658,1.0,0,0.0,2004,2004.csv
7964,Mine 9,226421,226421,1.0,0,0.0,2019,2019.csv
7965,The Agronomist,226189,226189,1.0,0,0.0,2004,2004.csv
7966,Blue Gate Crossing,226067,6242,0.02761128338059071,219825,0.9723887166194093,2003,2003.csv
7967,I Don't Want to Sleep Alone,226026,19292,0.0853530124852893,206734,0.9146469875147107,2007,2007.csv
7968,Rumble: The Indians Who Rocked The World,226006,226006,1.0,0,0.0,2017,2017.csv
7969,The Keeper: The Legend of Omar Khayyam,225863,225863,1.0,0,0.0,2005,2005.csv
7970,The Ballad of Ramblin' Jack,225682,225682,1.0,0,0.0,2000,2000.csv
7971,Dr. Cabbie,225490,225490,1.0,0,0.0,2014,2014.csv
7972,The Beauty Academy of Kabul,225448,225448,1.0,0,0.0,2005,2005.csv
7973,Murderous Maids,225390,225390,1.0,0,0.0,2002,2002.csv
7974,Millennium Actress 2019 Re-release,225250,225250,1.0,0,0.0,2019,2019.csv
7975,Live-In Maid 2007 Re-release,224836,200433,0.8914631108897152,24403,0.10853688911028483,2007,2007.csv
7976,Sixty Six 2008 Re-release,224614,224614,1.0,0,0.0,2008,2008.csv
7977,The Black Waters of Echo's Pond,224409,224409,1.0,0,0.0,2010,2010.csv
7978,Funny Girl 2001 Re-release,224263,223306,0.9957326888519283,957,0.004267311148071684,2001,2001.csv
7979,Experimenter,224145,155575,0.6940819558767762,68570,0.3059180441232238,2015,2015.csv
7980,Unidentified,224099,224099,1.0,0,0.0,2006,2006.csv
7981,Tampopo,224097,224097,1.0,0,0.0,2016,2016.csv
7982,The Trip to Greece,224083,8340,0.037218352128452405,215743,0.9627816478715476,2020,2020.csv
7983,Extra Ordinary,223898,164346,0.7340217420432519,59552,0.2659782579567482,2019,2019.csv
7984,Premier Boxing Champions: PBC on FOX PPV: Pacquiao vs. Thurman,223858,223858,1.0,0,0.0,2019,2019.csv
7985,The Genius Club,223827,0,0.0,223827,1.0,2006,2006.csv
7986,Crystal Fairy & the Magical Cactus,223821,202370,0.9041600207308519,21451,0.09583997926914811,2013,2013.csv
7987,BuyBust,223720,178471,0.7977427141069193,45249,0.20225728589308065,2018,2018.csv
7988,Tim and Eric's Billion Dollar Movie,223580,201436,0.9009571518024868,22144,0.09904284819751319,2012,2012.csv
7989,Love Liza,223426,213137,0.9539489584918497,10289,0.04605104150815035,2002,2002.csv
7990,Take Every Wave: The Life of Laird Hamilton,223301,176076,0.7885141580198924,47225,0.21148584198010756,2017,2017.csv
7991,Surviving My Mother,223000,223000,1.0,0,0.0,2007,2007.csv
7992,Never Surrender: A Galaxy Quest Documentary,222971,222971,1.0,0,0.0,2019,2019.csv
7993,Aida,222927,222927,1.0,0,0.0,2007,2007.csv
7994,Chop Shop,222776,125045,0.5613037311020935,97731,0.4386962688979064,2008,2008.csv
7995,Spirit of the Game,222565,222565,1.0,0,0.0,2016,2016.csv
7996,10.000 Km,222530,12423,0.055826180739675546,210107,0.9441738192603244,2014,2014.csv
7997,Secret Things,222396,105090,0.4725354772567852,117306,0.5274645227432148,2002,2002.csv
7998,Bus 174,222247,217201,0.9772955315482323,5046,0.02270446845176763,2003,2003.csv
7999,World's Greatest Dad,221805,221805,1.0,0,0.0,2009,2009.csv
8000,High School,221590,139034,0.627438061284354,82556,0.372561938715646,2012,2012.csv
8001,Neil Young Journeys,221082,215026,0.9726074488198949,6056,0.02739255118010512,2012,2012.csv
8002,Phantom Boy,221016,34362,0.15547290693886415,186654,0.8445270930611358,2015,2015.csv
8003,Little Pink House,220948,220948,1.0,0,0.0,2018,2018.csv
8004,Chance Pe Dance,220619,168643,0.7644083238524334,51976,0.23559167614756663,2010,2010.csv
8005,Fair,220524,220524,1.0,0,0.0,2000,2000.csv
8006,The Song of Sparrows,220360,116372,0.528099473588673,103988,0.4719005264113269,2008,2008.csv
8007,The Cockettes,220165,220165,1.0,0,0.0,2002,2002.csv
8008,Supermensch: The Legend of Shep Gordon,220065,213064,0.9681866721196011,7001,0.03181332788039897,2014,2014.csv
8009,Lower City,219814,130794,0.5950212452346074,89020,0.4049787547653926,2005,2005.csv
8010,Great Performances at the Met: Puccini: Turandot,219619,172627,0.7860294418971037,46992,0.2139705581028964,2016,2016.csv
8011,Brooklyn Castle,219407,219407,1.0,0,0.0,2012,2012.csv
8012,Fragments of Truth,219342,219342,1.0,0,0.0,2018,2018.csv
8013,Club Life,219229,4444,0.020271040783837905,214785,0.9797289592161621,2015,2015.csv
8014,The House I Live In,219159,210752,0.9616397227583626,8407,0.03836027724163735,2012,2012.csv
8015,California Typewriter,218563,218563,1.0,0,0.0,2017,2017.csv
8016,Ghosts of Cité Soleil,218444,48752,0.22317848052590136,169692,0.7768215194740986,2007,2007.csv
8017,Dark Money,217932,217932,1.0,0,0.0,2018,2018.csv
8018,Getting Grace,217812,217812,1.0,0,0.0,2018,2018.csv
8019,Beautiful Creatures,217679,55835,0.25650154585421653,161844,0.7434984541457834,2001,2001.csv
8020,Jane's Journey,217615,27253,0.12523493325368196,190362,0.874765066746318,2010,2010.csv
8021,Complete Unknown,217473,191761,0.881769231122944,25712,0.118230768877056,2016,2016.csv
8022,Ratcatcher,217244,217244,1.0,0,0.0,2000,2000.csv
8023,Two Men Went to War,217151,150208,0.6917214288674701,66943,0.3082785711325299,2003,2003.csv
8024,The Death of Mr. Lazarescu,216922,80301,0.370183752685297,136621,0.629816247314703,2006,2006.csv
8025,Chris & Don. A Love Story,216110,216110,1.0,0,0.0,2008,2008.csv
8026,Beijing Bicycle,215854,66131,0.306369119868059,149723,0.6936308801319411,2001,2001.csv
8027,The Karate Kid 2019 Re-release,215447,215447,1.0,0,0.0,2019,2019.csv
8028,How the Garcia Girls Spent Their Summer,215303,215303,1.0,0,0.0,2008,2008.csv
8029,The Treasure of the Sierra Madre,215295,215295,1.0,0,0.0,2018,2018.csv
8030,Call + Response,215185,215185,1.0,0,0.0,2008,2008.csv
8031,The Tribe,215034,150564,0.7001869471804458,64470,0.2998130528195541,2015,2015.csv
8032,Risk,214669,200219,0.9326870670660412,14450,0.06731293293395879,2017,2017.csv
8033,2001: A Space Odyssey 2013 Re-release,214618,214618,1.0,0,0.0,2013,2013.csv
8034,Hamlet 2019 Re-release,214578,214578,1.0,0,0.0,2019,2019.csv
8035,The Pervert's Guide to Ideology,214313,67966,0.31713428490105594,146347,0.6828657150989441,2013,2013.csv
8036,Ingrid Bergman: In Her Own Words,214014,138148,0.6455091722971394,75866,0.35449082770286056,2015,2015.csv
8037,Marjorie Prime,213858,180608,0.844523001243816,33250,0.155476998756184,2017,2017.csv
8038,The Château,213598,202272,0.9469751589434358,11326,0.0530248410565642,2002,2002.csv
8039,Thaandavam,213476,213476,1.0,0,0.0,2012,2012.csv
8040,The Wound,213043,30678,0.14399909877348704,182365,0.856000901226513,2017,2017.csv
8041,The Delicate Art of Parking,213008,213008,1.0,0,0.0,2004,2004.csv
8042,The Afflicted,212940,212940,1.0,0,0.0,2011,2011.csv
8043,Once in a Lifetime: The Extraordinary Story of the New York Cosmos,212780,144601,0.6795798477300499,68179,0.3204201522699502,2006,2006.csv
8044,Chocolate City,212662,212662,1.0,0,0.0,2015,2015.csv
8045,Young & Wild,212624,5514,0.025933102566032058,207110,0.9740668974339679,2012,2012.csv
8046,Big Sonia,212471,212471,1.0,0,0.0,2017,2017.csv
8047,Fatima,212228,50105,0.23609043104585634,162123,0.7639095689541436,2016,2016.csv
8048,Donnie Darko 2016 Re-release,212034,207971,0.9808379788147183,4063,0.019162021185281607,2016,2016.csv
8049,Somewhere Between,210975,210975,1.0,0,0.0,2012,2012.csv
8050,Stranded: I've Come from a Plane That Crashed on the Mountains,210754,89473,0.4245376125720034,121281,0.5754623874279966,2008,2008.csv
8051,La soga,210625,210625,1.0,0,0.0,2010,2010.csv
8052,A Glimpse Inside the Mind of Charles Swan III,210565,45350,0.2153729252249899,165215,0.7846270747750101,2013,2013.csv
8053,Tigers Are Not Afraid 2019 Re-release,210138,175559,0.8354462305722906,34579,0.1645537694277094,2019,2019.csv
8054,Beware of Mr. Baker,210123,116476,0.5543229441803135,93647,0.4456770558196866,2012,2012.csv
8055,"Faith, Hope & Love",210091,210091,1.0,0,0.0,2019,2019.csv
8056,Pierrepoint: The Last Hangman 2007 Re-release,209950,23192,0.11046439628482972,186758,0.8895356037151703,2007,2007.csv
8057,House,209765,209765,1.0,0,0.0,2010,2010.csv
8058,The Death of Louis XIV,209715,43635,0.2080680924111294,166080,0.7919319075888707,2016,2016.csv
8059,Believe in Me,209654,209654,1.0,0,0.0,2007,2007.csv
8060,Rob the Mob,209613,208693,0.99561095924394,920,0.004389040756059977,2014,2014.csv
8061,SEED: The Untold Story,209580,207825,0.9916261093615804,1755,0.008373890638419696,2016,2016.csv
8062,The Journals of Knud Rasmussen,209478,209478,1.0,0,0.0,2006,2006.csv
8063,Sleepwalking,208995,170392,0.8152922318715758,38603,0.18470776812842413,2008,2008.csv
8064,Kathy Griffin: A Hell of a Story,208907,208907,1.0,0,0.0,2019,2019.csv
8065,Casablanca 2013 Re-release,208608,208608,1.0,0,0.0,2013,2013.csv
8066,Hatchet,208550,175281,0.8404747063054423,33269,0.15952529369455767,2007,2007.csv
8067,Boys Life 3,208538,208538,1.0,0,0.0,2000,2000.csv
8068,A Man Named Pearl,208392,208392,1.0,0,0.0,2007,2007.csv
8069,Agent Mr. Chan,208351,208351,1.0,0,0.0,2018,2018.csv
8070,The Right Kind of Wrong,208105,2098,0.010081449268398164,206007,0.9899185507316018,2014,2014.csv
8071,The Dating Project,208100,208100,1.0,0,0.0,2018,2018.csv
8072,Batman 2019 Re-release,207901,159419,0.766802468482595,48482,0.2331975315174049,2019,2019.csv
8073,Under the Electric Sky,207584,207584,1.0,0,0.0,2014,2014.csv
8074,Heading Home: The Tale of Team Israel,207533,207533,1.0,0,0.0,2018,2018.csv
8075,Sweetgrass,207473,207473,1.0,0,0.0,2010,2010.csv
8076,Advanced Style,207231,87879,0.4240630021570132,119352,0.5759369978429868,2014,2014.csv
8077,Tamara,206871,206871,1.0,0,0.0,2006,2006.csv
8078,Ek Thi Daayan,206279,112135,0.5436084138472651,94144,0.4563915861527349,2013,2013.csv
8079,The Bridge,205724,179780,0.8738892885613735,25944,0.1261107114386265,2006,2006.csv
8080,The Desert Bride,205350,30110,0.14662770878987094,175240,0.853372291210129,2017,2017.csv
8081,The Tic Code,205003,205003,1.0,0,0.0,2000,2000.csv
8082,The Untold Story of Emmett Louis Till,204956,204956,1.0,0,0.0,2005,2005.csv
8083,Sicilian Ghost Story,204892,15285,0.07460027721921793,189607,0.9253997227807821,2017,2017.csv
8084,The Iron Orchard,204881,204881,1.0,0,0.0,2019,2019.csv
8085,Working Woman,204727,64048,0.3128458874501165,140679,0.6871541125498835,2019,2019.csv
8086,Hesburgh,204709,204709,1.0,0,0.0,2019,2019.csv
8087,Don't Call Me Son,204583,11678,0.05708196673232869,192905,0.9429180332676713,2016,2016.csv
8088,Pop Aye,204464,77976,0.3813678691603412,126488,0.6186321308396588,2017,2017.csv
8089,Touchback,204232,204232,1.0,0,0.0,2012,2012.csv
8090,I Have Never Forgotten You: The Life & Legacy of Simon Wiesenthal,204167,29976,0.14682098478206565,174191,0.8531790152179344,2007,2007.csv
8091,Postmen in the Mountains,203975,203975,1.0,0,0.0,2003,2003.csv
8092,The Home Teachers,203917,203917,1.0,0,0.0,2004,2004.csv
8093,Bulandi,203548,203548,1.0,0,0.0,2000,2000.csv
8094,States of Grace,203144,203144,1.0,0,0.0,2005,2005.csv
8095,Charlie's Country,202966,42937,0.2115477469132761,160029,0.7884522530867238,2014,2014.csv
8096,Keep the Change,202788,202788,1.0,0,0.0,2018,2018.csv
8097,"Filth to Ashes, Flesh to Dust",202531,202531,1.0,0,0.0,2011,2011.csv
8098,The Bolshoi Ballet: Live From Moscow - Coppélia,202217,202217,1.0,0,0.0,2018,2018.csv
8099,Glastonbury,202041,8419,0.04166976009819789,193622,0.9583302399018021,2006,2006.csv
8100,"Hieronymus Bosch, Touched by the Devil",201907,172533,0.8545171787010851,29374,0.14548282129891485,2016,2016.csv
8101,The Bad Batch,201890,180851,0.8957897865174105,21039,0.10421021348258953,2017,2017.csv
8102,Blink of an Eye,201874,201874,1.0,0,0.0,2019,2019.csv
8103,Lightning in a Bottle,201711,201711,1.0,0,0.0,2004,2004.csv
8104,Milarepa,201634,151114,0.7494470178640507,50520,0.2505529821359493,2007,2007.csv
8105,The Vertical Ray of the Sun,201247,110134,0.5472578473219477,91113,0.45274215267805235,2001,2001.csv
8106,The Snow Walker,201149,201149,1.0,0,0.0,2004,2004.csv
8107,Independent Lens: Imelda,200992,200992,1.0,0,0.0,2004,2004.csv
8108,Kikujiro,200920,200920,1.0,0,0.0,2000,2000.csv
8109,Zombi Child,200909,25878,0.12880458316949464,175031,0.8711954168305054,2019,2019.csv
8110,Just Another Love Story 2008 Re-release,200897,45835,0.22815173944857314,155062,0.7718482605514269,2008,2008.csv
8111,Legendary,200393,200393,1.0,0,0.0,2010,2010.csv
8112,Masculin Féminin,200380,200380,1.0,0,0.0,2005,2005.csv
8113,Gemini,200340,200340,1.0,0,0.0,2018,2018.csv
8114,White Girl,200242,200242,1.0,0,0.0,2016,2016.csv
8115,No Place on Earth,200238,200238,1.0,0,0.0,2013,2013.csv
8116,9/11,200229,170000,0.8490278630967543,30229,0.1509721369032458,2017,2017.csv
8117,Or (My Treasure),200175,29194,0.14584238791057824,170981,0.8541576120894218,2004,2004.csv
8118,Listen Up Philip,200126,200126,1.0,0,0.0,2014,2014.csv
8119,Cutie and the Boxer,200036,200036,1.0,0,0.0,2013,2013.csv
8120,What Would Jesus Buy?,200010,200010,1.0,0,0.0,2007,2007.csv
8121,Rebel Without a Cause 2018 Re-release,199963,199963,1.0,0,0.0,2018,2018.csv
8122,The Fallen Idol 2016 Re-release,199619,199619,1.0,0,0.0,2016,2016.csv
8123,October Baby,199442,199442,1.0,0,0.0,2011,2011.csv
8124,Come on My Brother,199227,199227,1.0,0,0.0,2000,2000.csv
8125,Friendsgiving Day #2,198869,198869,1.0,0,0.0,2019,2019.csv
8126,National Theater Live: Cyrano de Bergerac,198352,198352,1.0,0,0.0,2020,2020.csv
8127,Ex Libris: New York Public Library,198239,158192,0.7979862690994204,40047,0.2020137309005796,2017,2017.csv
8128,A Summer's Tale,198126,198126,1.0,0,0.0,2014,2014.csv
8129,The Warrior Queen of Jhansi,198100,177289,0.894946996466431,20811,0.1050530035335689,2019,2019.csv
8130,Whores' Glory,197932,31420,0.1587413859305216,166512,0.8412586140694784,2011,2011.csv
8131,Pusher,197857,0,0.0,197857,1.0,2012,2012.csv
8132,Rocket Singh: Salesman of the Year,197650,0,0.0,197650,1.0,2009,2009.csv
8133,Haven,197312,142483,0.722120296788842,54829,0.27787970321115796,2006,2006.csv
8134,Madeline's Madeline,197309,185576,0.9405348970396687,11733,0.05946510296033126,2018,2018.csv
8135,Sky Blue,197221,74663,0.3785753038469534,122558,0.6214246961530466,2004,2004.csv
8136,Have It All -The Movie,197142,197142,1.0,0,0.0,2018,2018.csv
8137,Harry Potter and the Goblet of Fire 2018 Re-release,197136,188716,0.9572883694505316,8420,0.04271163054946839,2005,2005.csv
8138,Little Joe,196960,23862,0.1211515028432169,173098,0.8788484971567831,2019,2019.csv
8139,Japón,196702,21900,0.111335929477077,174802,0.888664070522923,2003,2003.csv
8140,Máncora,196069,29697,0.15146198532149396,166372,0.848538014678506,2009,2009.csv
8141,Mom,195701,0,0.0,195701,1.0,2017,2017.csv
8142,Boom for Real: The Late Teenage Years of Jean-Michel Basquiat,195517,166616,0.8521816517233796,28901,0.14781834827662044,2018,2018.csv
8143,La traviata,195494,195494,1.0,0,0.0,2008,2008.csv
8144,One Day You'll Understand,195366,145642,0.7454828373411955,49724,0.2545171626588045,2008,2008.csv
8145,The Princess and the Pea,195358,0,0.0,195358,1.0,2005,2005.csv
8146,The Puffy Chair,195254,194523,0.9962561586446372,731,0.0037438413553627582,2006,2006.csv
8147,The Divine Order,195081,76277,0.3910016864789498,118804,0.6089983135210503,2017,2017.csv
8148,Free Angela and All Political Prisoners,195005,194102,0.9953693495038589,903,0.004630650496141125,2013,2013.csv
8149,Herb & Dorothy,194721,194721,1.0,0,0.0,2009,2009.csv
8150,Family,194601,194601,1.0,0,0.0,2019,2019.csv
8151,I Want Someone to Eat Cheese With,194568,194568,1.0,0,0.0,2007,2007.csv
8152,In the Pit,194258,10433,0.05370692584089201,183825,0.946293074159108,2006,2006.csv
8153,A Screaming Man,193981,9862,0.0508400307246586,184119,0.9491599692753414,2010,2010.csv
8154,Alice's House,193531,61822,0.3194423632389643,131709,0.6805576367610356,2007,2007.csv
8155,Drama/Mex,193508,8628,0.04458730388407715,184880,0.9554126961159228,2007,2007.csv
8156,Alila,193385,50961,0.2635209556066913,142424,0.7364790443933087,2003,2003.csv
8157,Fay Grim,193067,126714,0.6563213806605996,66353,0.3436786193394003,2007,2007.csv
8158,Mr. Klein,193028,193028,1.0,0,0.0,2019,2019.csv
8159,Client 9: The Rise and Fall of Eliot Spitzer,192870,189416,0.982091564266086,3454,0.017908435733914034,2010,2010.csv
8160,November,192186,192186,1.0,0,0.0,2005,2005.csv
8161,Claire's Camera,191980,83418,0.4345140118762371,108562,0.5654859881237629,2018,2018.csv
8162,The Princess of Nebraska,191887,0,0.0,191887,1.0,2008,2008.csv
8163,Past Life,191678,180099,0.9395913980738531,11579,0.06040860192614698,2017,2017.csv
8164,Diamond Men,191221,191221,1.0,0,0.0,2001,2001.csv
8165,Chalo Dilli,191185,94300,0.4932395323900934,96885,0.5067604676099067,2011,2011.csv
8166,The Romantics,191019,106524,0.5576618032761139,84495,0.4423381967238861,2010,2010.csv
8167,Digimon Adventure tri. Part 1: Reunion,190581,190581,1.0,0,0.0,2016,2016.csv
8168,One Week,190441,190441,1.0,0,0.0,2001,2001.csv
8169,Code Black,190229,190229,1.0,0,0.0,2014,2014.csv
8170,The Doors: Break On Thru - A Celebration Of Ray Manzarek,190160,190160,1.0,0,0.0,2020,2020.csv
8171,The Divine Plan,190031,190031,1.0,0,0.0,2019,2019.csv
8172,Java Heat,189739,1061,0.0055918920200907565,188678,0.9944081079799092,2013,2013.csv
8173,Munna Michael,189105,99629,0.5268448745405991,89476,0.47315512545940086,2017,2017.csv
8174,Nick Saban: Gamechanger,189000,189000,1.0,0,0.0,2010,2010.csv
8175,Days of Being Wild,188630,146310,0.7756454434607433,42320,0.22435455653925673,2004,2004.csv
8176,Lost Boys of Sudan,188467,188467,1.0,0,0.0,2003,2003.csv
8177,Leap Year,188242,12979,0.06894848121035688,175263,0.9310515187896431,2010,2010.csv
8178,Repo! The Genetic Opera,188126,146750,0.7800622986721665,41376,0.21993770132783347,2008,2008.csv
8179,The Bolshoi Ballet: Live From Moscow - Don Quixote,187946,187946,1.0,0,0.0,2018,2018.csv
8180,Bustin' Down the Door,187827,109427,0.5825946216465151,78400,0.41740537835348485,2008,2008.csv
8181,Music Within,187581,154087,0.8214424701862129,33494,0.1785575298137871,2007,2007.csv
8182,Chapter 27,187488,56215,0.29983252261478066,131273,0.7001674773852193,2008,2008.csv
8183,Owaranai hito: Miyazaki Hayao,187320,187320,1.0,0,0.0,2018,2018.csv
8184,Calle 54,187308,187308,1.0,0,0.0,2000,2000.csv
8185,The Last Days on Mars,187191,24084,0.12866003173229482,163107,0.8713399682677052,2013,2013.csv
8186,Stoned,187160,38922,0.20796110279974353,148238,0.7920388972002564,2005,2005.csv
8187,The Big Tease,187152,187152,1.0,0,0.0,2000,2000.csv
8188,In the Fog,186838,11894,0.06365942688318223,174944,0.9363405731168177,2013,2013.csv
8189,Good for Nothing,186119,0,0.0,186119,1.0,2012,2012.csv
8190,Twiceland,186078,52874,0.28414965767043926,133204,0.7158503423295607,2018,2018.csv
8191,Salt of This Sea 2010 Re-release,186045,11662,0.06268375930554436,174383,0.9373162406944556,2010,2010.csv
8192,In the Basement,186036,3643,0.019582231396073877,182393,0.9804177686039262,2014,2014.csv
8193,Crude,185881,170295,0.9161506555269231,15586,0.08384934447307686,2009,2009.csv
8194,Buñuel in the Labyrinth of the Turtles,185675,36205,0.19499124814864682,149470,0.8050087518513531,2019,2019.csv
8195,National Theatre Live: King Lear,185305,185305,1.0,0,0.0,2018,2018.csv
8196,The Duke of Burgundy,185147,64521,0.3484852576601295,120626,0.6515147423398705,2015,2015.csv
8197,Cobra Kai Premiere Event feat. The Karate Kid,185082,185082,1.0,0,0.0,2018,2018.csv
8198,The Sugar Curtain,185058,582,0.0031449599584994973,184476,0.9968550400415005,2007,2007.csv
8199,Amigo,184705,184705,1.0,0,0.0,2011,2011.csv
8200,To Dust,184495,184495,1.0,0,0.0,2019,2019.csv
8201,Vatel,184301,51080,0.27715530572270364,133221,0.7228446942772964,2000,2000.csv
8202,Score,184025,101382,0.5509142779513653,82643,0.4490857220486347,2017,2017.csv
8203,The River and the Wall,183602,183602,1.0,0,0.0,2019,2019.csv
8204,The Hidden Fortress,183579,183579,1.0,0,0.0,2001,2001.csv
8205,Youssou Ndour: I Bring What I Love,183503,172225,0.9385405143240165,11278,0.0614594856759835,2009,2009.csv
8206,"The Man Nobody Knew: In Search of My Father, CIA Spymaster William Colby",183342,183342,1.0,0,0.0,2011,2011.csv
8207,Lambert & Stamp,183320,183320,1.0,0,0.0,2015,2015.csv
8208,Burnt Money,183132,183132,1.0,0,0.0,2001,2001.csv
8209,Hellbent,183066,183066,1.0,0,0.0,2005,2005.csv
8210,Americanizing Shelley,182831,128024,0.7002313612024219,54807,0.2997686387975781,2007,2007.csv
8211,Whose Streets?,182799,182799,1.0,0,0.0,2017,2017.csv
8212,The Masked Saint,182695,182695,1.0,0,0.0,2016,2016.csv
8213,I Am Not A Witch,182462,50868,0.2787868158849514,131594,0.7212131841150486,2017,2017.csv
8214,Shock and Awe,182415,77980,0.42748677466217144,104435,0.5725132253378286,2018,2018.csv
8215,The Baxter,181872,181872,1.0,0,0.0,2005,2005.csv
8216,Fida,181865,98297,0.5404943227119017,83568,0.4595056772880983,2004,2004.csv
8217,Fulltime Killer,181662,23124,0.12729134326386365,158538,0.8727086567361363,2001,2001.csv
8218,Giant Little Ones,181507,181507,1.0,0,0.0,2019,2019.csv
8219,Bolshoi Ballet: Raymonda domestic,181361,181361,1.0,0,0.0,2019,2019.csv
8220,Raymonda: Bolshoi Ballet,181361,181361,1.0,0,0.0,2019,2019.csv
8221,Rafiki,181316,137968,0.7609256767190982,43348,0.23907432328090186,2019,2019.csv
8222,Winnebago Man,181039,181039,1.0,0,0.0,2010,2010.csv
8223,1001 Grams,181030,10983,0.06066950229243772,170047,0.9393304977075623,2014,2014.csv
8224,"Not Quite Hollywood: The Wild, Untold Story of Ozploitation!",180957,21152,0.11688964781688467,159805,0.8831103521831153,2008,2008.csv
8225,An Honest Liar,180590,180590,1.0,0,0.0,2015,2015.csv
8226,Fukrey,180331,125279,0.694716937187727,55052,0.30528306281227297,2013,2013.csv
8227,Go for It!,180237,180237,1.0,0,0.0,2011,2011.csv
8228,Lost Woods,180117,180117,1.0,0,0.0,2012,2012.csv
8229,Chop Suey,179914,179914,1.0,0,0.0,2001,2001.csv
8230,Lila & Eve,179807,38263,0.21280039153091926,141544,0.7871996084690808,2015,2015.csv
8231,Cherish,179751,179751,1.0,0,0.0,2002,2002.csv
8232,Constantine's Sword,179507,179507,1.0,0,0.0,2008,2008.csv
8233,The Inner Life of Martin Frost,179443,5114,0.02849930061356531,174329,0.9715006993864347,2007,2007.csv
8234,Smiley Face,179381,9397,0.05238570417156778,169984,0.9476142958284323,2007,2007.csv
8235,Protocols of Zion,178875,178875,1.0,0,0.0,2005,2005.csv
8236,Offender,178158,0,0.0,178158,1.0,2012,2012.csv
8237,Walking on Water,178119,102140,0.5734368596275524,75979,0.42656314037244764,2019,2019.csv
8238,Lagaan: Once Upon a Time in India 2002 Re-release,178072,73276,0.41149647333662787,104796,0.5885035266633721,2002,2002.csv
8239,Modest Heroes,178027,178027,1.0,0,0.0,2019,2019.csv
8240,Zaytoun,177753,42330,0.2381394406845454,135423,0.7618605593154546,2013,2013.csv
8241,Monumental: In Search of America's National Treasure,177729,177729,1.0,0,0.0,2012,2012.csv
8242,Awesome; I Fuckin' Shot That!,177683,162538,0.914763933522059,15145,0.08523606647794105,2006,2006.csv
8243,Nostalgia for the Light,177634,163962,0.9230327527387775,13672,0.07696724726122252,2010,2010.csv
8244,Chicago 10,177490,177490,1.0,0,0.0,2008,2008.csv
8245,Bush's Brain,177485,177485,1.0,0,0.0,2004,2004.csv
8246,Tarkovsky At 70,177345,177345,1.0,0,0.0,2002,2002.csv
8247,People Places Things,177338,67046,0.3780689981842583,110292,0.6219310018157417,2015,2015.csv
8248,Anita: Speaking Truth to Power,176979,176979,1.0,0,0.0,2014,2014.csv
8249,Bye Bye Germany,176933,73730,0.4167114105339309,103203,0.5832885894660691,2017,2017.csv
8250,Casino Jack and the United States of Money,176865,176865,1.0,0,0.0,2010,2010.csv
8251,Touch the Sound: A Sound Journey with Evelyn Glennie,176801,176801,1.0,0,0.0,2005,2005.csv
8252,Anchor Baby,176784,15790,0.08931803783147796,160994,0.910681962168522,2010,2010.csv
8253,Vigilante Diaries,176777,1991,0.01126277739751212,174786,0.9887372226024879,2016,2016.csv
8254,An Unreasonable Man,176647,176647,1.0,0,0.0,2007,2007.csv
8255,The Sea,176401,75994,0.430802546470825,100407,0.5691974535291751,2003,2003.csv
8256,"Iyengar: The Man, Yoga, and the Student's Journey",176387,176387,1.0,0,0.0,2019,2019.csv
8257,Better Watch Out,176288,20369,0.1155438827373389,155919,0.884456117262661,2017,2017.csv
8258,Girl on a Bicycle,176272,91401,0.5185225106653354,84871,0.4814774893346646,2013,2013.csv
8259,The Bolshoi Ballet: Live From Moscow - The Flames of Paris,175922,175922,1.0,0,0.0,2018,2018.csv
8260,Afternoon Delight,175755,174496,0.9928366191573497,1259,0.00716338084265028,2013,2013.csv
8261,The Business of Fancydancing,175710,175710,1.0,0,0.0,2002,2002.csv
8262,Butter,175706,105018,0.5976915984656187,70688,0.4023084015343813,2012,2012.csv
8263,A.C.O.D.,175705,175705,1.0,0,0.0,2013,2013.csv
8264,Black Rock,175682,0,0.0,175682,1.0,2013,2013.csv
8265,Champion,175232,175232,1.0,0,0.0,2017,2017.csv
8266,Cleopatra's Second Husband,175058,175058,1.0,0,0.0,2000,2000.csv
8267,Lonesome Jim,174815,154187,0.8820009724565969,20628,0.11799902754340302,2006,2006.csv
8268,Marooned in Iraq,174357,141243,0.8100793200158296,33114,0.18992067998417042,2003,2003.csv
8269,Stateside,174318,174318,1.0,0,0.0,2004,2004.csv
8270,Always at The Carlyle,174251,174251,1.0,0,0.0,2018,2018.csv
8271,SOMM,174197,174197,1.0,0,0.0,2013,2013.csv
8272,Grand Illusion,174065,174065,1.0,0,0.0,2012,2012.csv
8273,American Women,174011,164927,0.9477964036756297,9084,0.0522035963243703,2000,2000.csv
8274,Passport to Love,173828,173828,1.0,0,0.0,2009,2009.csv
8275,Mercy Streets,173599,173599,1.0,0,0.0,2000,2000.csv
8276,The Fallen Idol,173566,141502,0.8152633580309507,32064,0.18473664196904924,2006,2006.csv
8277,Baptists at Our Barbecue,173306,173306,1.0,0,0.0,2004,2004.csv
8278,Neon Bull,173219,26734,0.15433641806037443,146485,0.8456635819396255,2016,2016.csv
8279,Cirkus Columbia,173083,3457,0.019973076500869526,169626,0.9800269234991305,2011,2011.csv
8280,My Name Is Bruce,173066,173066,1.0,0,0.0,2008,2008.csv
8281,Them That Follow,172952,159218,0.9205906841204496,13734,0.0794093158795504,2019,2019.csv
8282,Bellflower,172935,168226,0.9727701159395149,4709,0.027229884060485154,2011,2011.csv
8283,Rodin 2017 Re-release,172619,44261,0.256408622457551,128358,0.743591377542449,2017,2017.csv
8284,Forty Shades of Blue,172569,75828,0.43940684595726925,96741,0.5605931540427307,2005,2005.csv
8285,Afternoon of a Faun: Tanaquil Le Clercq,172450,172450,1.0,0,0.0,2014,2014.csv
8286,All Things Must Pass,172394,172394,1.0,0,0.0,2015,2015.csv
8287,The Great New Wonderful,172055,150142,0.8726395629304583,21913,0.12736043706954173,2006,2006.csv
8288,Escape from Tomorrow,171962,171962,1.0,0,0.0,2013,2013.csv
8289,Little Woods,171912,150010,0.8725976080785518,21902,0.12740239192144817,2019,2019.csv
8290,Copperhead,171740,171740,1.0,0,0.0,2013,2013.csv
8291,Abuse of Weakness,171660,31611,0.1841488989863684,140049,0.8158511010136316,2014,2014.csv
8292,United Passions,171511,607,0.003539131600888573,170904,0.9964608683991114,2014,2014.csv
8293,North Station,171400,171400,1.0,0,0.0,2002,2002.csv
8294,Hollywood Dreams,171255,171255,1.0,0,0.0,2007,2007.csv
8295,The Bolshoi Ballet: Live From Moscow - La Sylphide,171177,171177,1.0,0,0.0,2018,2018.csv
8296,Palau the Movie,171155,134696,0.786982559668137,36459,0.21301744033186293,2019,2019.csv
8297,Cheerful Weather for the Wedding,170922,2651,0.015509998712863177,168271,0.9844900012871368,2012,2012.csv
8298,Uninvited Guest,170832,170832,1.0,0,0.0,2000,2000.csv
8299,Apparition Hill,170457,170457,1.0,0,0.0,2016,2016.csv
8300,Owl and the Sparrow,170324,47071,0.27636152274488623,123253,0.7236384772551138,2008,2008.csv
8301,The Human Centipede II (Full Sequence),170323,141877,0.8329879112040065,28446,0.1670120887959935,2011,2011.csv
8302,Amusement,170255,0,0.0,170255,1.0,2008,2008.csv
8303,Knockout,169503,169503,1.0,0,0.0,2000,2000.csv
8304,The Fits,169236,166425,0.9833900588527263,2811,0.01660994114727363,2016,2016.csv
8305,Viva Riva!,168982,61759,0.3654767963451729,107223,0.6345232036548272,2011,2011.csv
8306,Free the Mind,168916,157201,0.930646001562907,11715,0.06935399843709299,2013,2013.csv
8307,Grizzly Falls,168874,168874,1.0,0,0.0,2000,2000.csv
8308,Britt-Marie Was Here,168862,36549,0.21644301263753835,132313,0.7835569873624617,2019,2019.csv
8309,Girls of the Sun,168771,19712,0.1167973170746159,149059,0.8832026829253841,2018,2018.csv
8310,Valley of Bones,168738,168738,1.0,0,0.0,2017,2017.csv
8311,Hangman's Curse,168406,168406,1.0,0,0.0,2003,2003.csv
8312,Shotgun Stories,168237,46026,0.27357834483496496,122211,0.726421655165035,2007,2007.csv
8313,De Palma,168045,165237,0.9832901901276444,2808,0.016709809872355617,2016,2016.csv
8314,Twentynine Palms,167999,54523,0.32454359847380043,113476,0.6754564015261996,2003,2003.csv
8315,The Clovehitch Killer,167994,8208,0.04885888781742205,159786,0.9511411121825779,2018,2018.csv
8316,The Bolshoi Ballet: Live From Moscow - The Lady of the Camellias,167991,167991,1.0,0,0.0,2018,2018.csv
8317,Perrier's Bounty,167938,828,0.004930390977622694,167110,0.9950696090223773,2010,2010.csv
8318,Beauty and the Dogs,167723,8915,0.05315311555362115,158808,0.9468468844463789,2017,2017.csv
8319,Genius Within: The Inner Life of Glenn Gould,167508,167508,1.0,0,0.0,2010,2010.csv
8320,Ziggy Stardust and the Spiders from Mars,167239,162547,0.9719443431257063,4692,0.028055656874293674,2002,2002.csv
8321,On_Line,167102,167102,1.0,0,0.0,2003,2003.csv
8322,Is Genesis History? 2018 Re-release,166763,166763,1.0,0,0.0,2018,2018.csv
8323,Our Brand Is Crisis,166750,166750,1.0,0,0.0,2006,2006.csv
8324,Holly,166620,166620,1.0,0,0.0,2007,2007.csv
8325,We'll Meet Again,166484,91968,0.5524134451358689,74516,0.44758655486413107,2004,2004.csv
8326,The Day After,166022,24746,0.1490525352061775,141276,0.8509474647938225,2017,2017.csv
8327,Far From the Tree,166018,166018,1.0,0,0.0,2018,2018.csv
8328,Fool for Love,165987,165987,1.0,0,0.0,2010,2010.csv
8329,The Film Critic,165891,7358,0.04435442549625959,158533,0.9556455745037404,2014,2014.csv
8330,Gigantic,165888,102704,0.619116512345679,63184,0.380883487654321,2009,2009.csv
8331,La strada di Levi,165869,22026,0.1327915403119329,143843,0.867208459688067,2007,2007.csv
8332,Bright Ones,165627,165627,1.0,0,0.0,2019,2019.csv
8333,Solomon & Gaenor,165485,165485,1.0,0,0.0,2000,2000.csv
8334,Maybe Baby,165046,20501,0.12421385553118525,144545,0.8757861444688148,2001,2001.csv
8335,Uncle Nino,165000,165000,1.0,0,0.0,2005,2005.csv
8336,Christmas Eve,164839,91302,0.5538859129210927,73537,0.4461140870789073,2015,2015.csv
8337,Nas: Time Is Illmatic,164540,164540,1.0,0,0.0,2014,2014.csv
8338,The Chambermaid,164531,86422,0.525262716448572,78109,0.474737283551428,2019,2019.csv
8339,Red Betsy,164520,164520,1.0,0,0.0,2003,2003.csv
8340,Hybrid,164386,164386,1.0,0,0.0,2002,2002.csv
8341,Eastern Boys,164290,16831,0.10244689268975592,147459,0.8975531073102441,2014,2014.csv
8342,Lost & Found,164026,125173,0.7631290161315889,38853,0.2368709838684111,2018,2018.csv
8343,Palm Springs,164000,164000,1.0,0,0.0,2020,2020.csv
8344,Cruel Peter,163925,0,0.0,163925,1.0,2020,2020.csv
8345,Keep on Keepin' On,163745,163745,1.0,0,0.0,2014,2014.csv
8346,Narco Cultura,163690,145088,0.88635836031523,18602,0.11364163968477,2013,2013.csv
8347,Halston,163446,151991,0.9299156908091969,11455,0.07008430919080308,2019,2019.csv
8348,Stolen Summer,163348,134736,0.8248402184293655,28612,0.17515978157063447,2002,2002.csv
8349,"Police, Adjective",162974,53206,0.3264692527642446,109768,0.6735307472357553,2009,2009.csv
8350,The Fassbinder Series,162885,162885,1.0,0,0.0,2003,2003.csv
8351,Face,162717,108151,0.6646570425954265,54566,0.3353429574045736,2004,2004.csv
8352,Walking Out,162445,101947,0.6275785650527871,60498,0.3724214349472129,2017,2017.csv
8353,The Turin Horse,162088,56391,0.34790360791668723,105697,0.6520963920833127,2011,2011.csv
8354,Torremolinos 73 2005 Re-release,161651,87385,0.5405781591205746,74266,0.45942184087942545,2005,2005.csv
8355,Road to Nowhere,161619,40294,0.24931474640976617,121325,0.7506852535902339,2011,2011.csv
8356,Vanaja,161590,161590,1.0,0,0.0,2007,2007.csv
8357,The Samuel Project,161565,161565,1.0,0,0.0,2018,2018.csv
8358,Mughal-E-Azam,161434,161434,1.0,0,0.0,2005,2005.csv
8359,Come Early Morning,161408,119452,0.7400624504361618,41956,0.25993754956383824,2006,2006.csv
8360,Lu Over the Wall,161253,109857,0.6812710461200722,51396,0.31872895387992783,2018,2018.csv
8361,Tharlo,161229,17091,0.10600450291200715,144138,0.8939954970879929,2016,2016.csv
8362,Spring Fever,161110,10824,0.06718391161318354,150286,0.9328160883868165,2010,2010.csv
8363,Bulgarian Lovers,161027,60712,0.3770299390785396,100315,0.6229700609214603,2003,2003.csv
8364,"Diana Ross: Her Life, Love and Legacy",160968,160968,1.0,0,0.0,2019,2019.csv
8365,Gigantic (A Tale of Two Johns),160621,160621,1.0,0,0.0,2003,2003.csv
8366,Broken Sky,160445,29185,0.18190033968026426,131260,0.8180996603197357,2006,2006.csv
8367,National Theatre Live: The Curious Incident of the Dog in the Night-Time 2018 Re-release,160381,160381,1.0,0,0.0,2018,2018.csv
8368,Cocaine Cowboys,160347,150056,0.9358204394220035,10291,0.06417956057799647,2006,2006.csv
8369,Washington Heights,160291,160291,1.0,0,0.0,2003,2003.csv
8370,Danny Deckchair 2004 Re-release,160276,160276,1.0,0,0.0,2004,2004.csv
8371,Beauty and the Beast 2016 Re-release,160215,160215,1.0,0,0.0,2016,2016.csv
8372,Punks,160083,160083,1.0,0,0.0,2001,2001.csv
8373,Sinbad: The Fifth Voyage,159862,159862,1.0,0,0.0,2014,2014.csv
8374,The Eclipse,159852,133411,0.8345907464404574,26441,0.16540925355954259,2010,2010.csv
8375,Murder 3,159798,0,0.0,159798,1.0,2013,2013.csv
8376,The Model,159743,0,0.0,159743,1.0,2016,2016.csv
8377,Eames: The Architect & The Painter,159715,153088,0.9585073412015152,6627,0.0414926587984848,2011,2011.csv
8378,Mountain Patrol 2006 Re-release,159460,143383,0.8991784773610937,16077,0.10082152263890631,2006,2006.csv
8379,When Will I Be Loved,159429,159429,1.0,0,0.0,2004,2004.csv
8380,Km. 0 - Kilometer Zero,159338,159338,1.0,0,0.0,2003,2003.csv
8381,The Body,159317,68196,0.42805224803379427,91121,0.5719477519662057,2019,2019.csv
8382,The Witness,159305,159305,1.0,0,0.0,2016,2016.csv
8383,Girls Rock!,159294,159294,1.0,0,0.0,2008,2008.csv
8384,We Are What We Are,159047,81381,0.5116789376725119,77666,0.4883210623274881,2013,2013.csv
8385,Teza,158999,30070,0.1891206862936245,128929,0.8108793137063756,2009,2009.csv
8386,Until Forever,158872,35839,0.2255841180321265,123033,0.7744158819678735,2016,2016.csv
8387,The Last Resort,158646,158646,1.0,0,0.0,2018,2018.csv
8388,The Big Picture 2012 Re-release,158411,158411,1.0,0,0.0,2012,2012.csv
8389,Dev,158357,84728,0.535044235493221,73629,0.464955764506779,2004,2004.csv
8390,Burden,158132,139270,0.880719904889586,18862,0.11928009511041408,2020,2020.csv
8391,Mother of George,157937,157937,1.0,0,0.0,2013,2013.csv
8392,The Look of Silence,157857,109089,0.6910621638571619,48768,0.30893783614283815,2015,2015.csv
8393,Altiplano,157796,2961,0.018764734213795025,154835,0.981235265786205,2009,2009.csv
8394,Crazy Horse,157782,157782,1.0,0,0.0,2012,2012.csv
8395,Hell and Back,157768,157768,1.0,0,0.0,2015,2015.csv
8396,Till Human Voices Wake Us,157720,120601,0.7646525488206949,37119,0.23534745117930508,2002,2002.csv
8397,House of Fools,157613,57862,0.3671143877725822,99751,0.6328856122274178,2003,2003.csv
8398,Chasing Madoff,157612,157612,1.0,0,0.0,2011,2011.csv
8399,Eva Hesse,157481,157481,1.0,0,0.0,2016,2016.csv
8400,2005 Academy Award Nominated Short Films,157415,157415,1.0,0,0.0,2006,2006.csv
8401,Eden Log,157350,0,0.0,157350,1.0,2007,2007.csv
8402,Suntan,157267,6643,0.042240266553059444,150624,0.9577597334469405,2016,2016.csv
8403,Derrida,157200,157200,1.0,0,0.0,2002,2002.csv
8404,LUV,156996,156996,1.0,0,0.0,2013,2013.csv
8405,One Day in September,156818,156818,1.0,0,0.0,2000,2000.csv
8406,Marina Abramovic: The Artist Is Present,156695,86637,0.5529021347203166,70058,0.4470978652796835,2012,2012.csv
8407,The Horse Boy,156612,156612,1.0,0,0.0,2009,2009.csv
8408,Jodi No. 1,156415,82834,0.5295783652462999,73581,0.4704216347537001,2001,2001.csv
8409,Hatchet II,156190,52604,0.3367949292528331,103586,0.663205070747167,2010,2010.csv
8410,Deadtime,156072,156072,1.0,0,0.0,2012,2012.csv
8411,Pépé le Moko,155895,155895,1.0,0,0.0,2002,2002.csv
8412,Queen & Country,155881,41297,0.26492645030504036,114584,0.7350735496949596,2015,2015.csv
8413,Il ne faut jurer... de rien! 2006 Re-release,155878,23442,0.15038684099103145,132436,0.8496131590089685,2006,2006.csv
8414,Matando Cabos 2005 Re-release,155874,155874,1.0,0,0.0,2005,2005.csv
8415,El Topo,155820,80302,0.5153510460788089,75518,0.4846489539211911,2006,2006.csv
8416,Money,155732,155732,1.0,0,0.0,2019,2019.csv
8417,Dans l'oeil du chat,155714,155714,1.0,0,0.0,2004,2004.csv
8418,Naqoyqatsi,155640,133058,0.8549087638139296,22582,0.14509123618607042,2002,2002.csv
8419,Duck Season 2005 Re-release,155410,147551,0.9494305385753813,7859,0.05056946142461875,2005,2005.csv
8420,The Forgiveness of Blood,155383,126700,0.8154045165816081,28683,0.18459548341839196,2012,2012.csv
8421,The Gleaners & I,155320,155320,1.0,0,0.0,2001,2001.csv
8422,Western,155215,41072,0.2646136004896434,114143,0.7353863995103566,2018,2018.csv
8423,The Boy and the World 2015 Re-release,155215,129480,0.8341977257352704,25735,0.16580227426472957,2015,2015.csv
8424,Eating Out,155212,155212,1.0,0,0.0,2005,2005.csv
8425,Service,155156,64536,0.4159426641573642,90620,0.5840573358426357,2008,2008.csv
8426,Magic Trip: Ken Kesey's Search for a Kool Place,155005,154521,0.9968775200799974,484,0.0031224799200025807,2011,2011.csv
8427,Pantaleón y las visitadoras,154976,43214,0.2788431757175305,111762,0.7211568242824695,2002,2002.csv
8428,Hansel & Gretel,154642,154642,1.0,0,0.0,2002,2002.csv
8429,The Exterminating Angels,154210,23308,0.15114454315543738,130902,0.8488554568445627,2007,2007.csv
8430,Bad Reputation,154190,148568,0.963538491471561,5622,0.03646150852843894,2018,2018.csv
8431,Eating Animals,153993,149614,0.9715636425032307,4379,0.028436357496769333,2018,2018.csv
8432,Suddenly,153985,44806,0.29097639380459134,109179,0.7090236061954086,2003,2003.csv
8433,Citizen Koch,153908,153908,1.0,0,0.0,2014,2014.csv
8434,The Tag Along: Devil Fish,153895,20726,0.13467624029370676,133169,0.8653237597062933,2018,2018.csv
8435,The Revolution Will Not Be Televised,153859,153859,1.0,0,0.0,2003,2003.csv
8436,The Terrorist,153629,153629,1.0,0,0.0,2000,2000.csv
8437,Contempt 2008 Re-release,153619,153619,1.0,0,0.0,2008,2008.csv
8438,Love Story 50th Anniversary,153504,153504,1.0,0,0.0,2020,2020.csv
8439,Harmonium,153283,17191,0.11215203251502123,136092,0.8878479674849787,2017,2017.csv
8440,Brothers at War,153148,153148,1.0,0,0.0,2009,2009.csv
8441,The Mostly Unfabulous Social Life of Ethan Green,153122,153122,1.0,0,0.0,2006,2006.csv
8442,Backstreet Boys: Show 'Em What You're Made Of,153068,153068,1.0,0,0.0,2015,2015.csv
8443,Quai des Orfèvres,152961,152961,1.0,0,0.0,2002,2002.csv
8444,In the Shadow of Women,152802,50291,0.329125273229408,102511,0.670874726770592,2015,2015.csv
8445,Deceptive Practice: The Mysteries and Mentors of Ricky Jay,152791,152791,1.0,0,0.0,2013,2013.csv
8446,The Big Ugly,152598,152598,1.0,0,0.0,2020,2020.csv
8447,Finding Fela,152346,120980,0.7941133997610702,31366,0.2058866002389298,2014,2014.csv
8448,The Call Up,152294,0,0.0,152294,1.0,2016,2016.csv
8449,Snake & Mongoose,152200,152200,1.0,0,0.0,2013,2013.csv
8450,One Week and a Day,152178,41614,0.2734560843223068,110564,0.7265439156776933,2016,2016.csv
8451,"Buttons, A New Musical Film",151983,151983,1.0,0,0.0,2018,2018.csv
8452,Born to Be Blue,151926,151926,1.0,0,0.0,2016,2016.csv
8453,The Boys & Girl from County Clare,151869,142872,0.9407581534085298,8997,0.05924184659147028,2004,2004.csv
8454,Lupin the 3rd: Castle of Cagliostro 2017 Re-release,151802,142425,0.9382287453393235,9377,0.06177125466067641,2017,2017.csv
8455,ShowBusiness: The Road to Broadway,151792,151792,1.0,0,0.0,2007,2007.csv
8456,Go Tigers!,151779,151779,1.0,0,0.0,2001,2001.csv
8457,Dandelion,151755,0,0.0,151755,1.0,2005,2005.csv
8458,Generation Found,151751,151751,1.0,0,0.0,2016,2016.csv
8459,Garçon stupide,151702,151702,1.0,0,0.0,2005,2005.csv
8460,Red Riding: The Year of Our Lord 1974,151644,151644,1.0,0,0.0,2010,2010.csv
8461,Before You Know It,151507,151507,1.0,0,0.0,2019,2019.csv
8462,Stuck,151449,67505,0.4457276046721999,83944,0.5542723953278001,2008,2008.csv
8463,Jay Myself,151331,151331,1.0,0,0.0,2019,2019.csv
8464,Revenge of the Electric Car,151272,150886,0.9974483050399281,386,0.0025516949600719236,2011,2011.csv
8465,The Cremaster Cycle 2010 Re-release,151239,151239,1.0,0,0.0,2010,2010.csv
8466,Vampire Hunter D: Bloodlust,151086,151086,1.0,0,0.0,2001,2001.csv
8467,All the Best: Fun Begins,150902,120713,0.7999430093703198,30189,0.2000569906296802,2009,2009.csv
8468,Glory 2019 Re-release,150801,150801,1.0,0,0.0,2019,2019.csv
8469,Tasting Menu,150718,18686,0.12397988296023037,132032,0.8760201170397697,2013,2013.csv
8470,My Brother,150487,65797,0.437227135898782,84690,0.5627728641012181,2007,2007.csv
8471,Stoked: The Rise and Fall of Gator,150268,150268,1.0,0,0.0,2003,2003.csv
8472,Godzilla 2014 Re-release,150191,150191,1.0,0,0.0,2014,2014.csv
8473,Kicks,150191,150191,1.0,0,0.0,2016,2016.csv
8474,Nobody Else But You,150173,43040,0.28660278478821094,107133,0.7133972152117891,2011,2011.csv
8475,Invincible,150143,81954,0.5458396328833179,68189,0.4541603671166821,2002,2002.csv
8476,Only the Brave,150000,150000,1.0,0,0.0,2010,2010.csv
8477,The Day I Became a Woman,149971,149971,1.0,0,0.0,2001,2001.csv
8478,Becket,149327,149327,1.0,0,0.0,2007,2007.csv
8479,Piercing,149211,15856,0.10626562384810771,133355,0.8937343761518923,2019,2019.csv
8480,Michael Moore in TrumpLand,149090,149090,1.0,0,0.0,2016,2016.csv
8481,Gun Hill Road,148994,148994,1.0,0,0.0,2011,2011.csv
8482,From Afar,148630,30169,0.2029805557424477,118461,0.7970194442575523,2016,2016.csv
8483,The Kingmaker,148611,122587,0.8248851027178338,26024,0.1751148972821662,2019,2019.csv
8484,Trial by Fire,148504,148504,1.0,0,0.0,2019,2019.csv
8485,War and Peace,148503,148503,1.0,0,0.0,2019,2019.csv
8486,Bartleby,148479,148479,1.0,0,0.0,2002,2002.csv
8487,Tokyo Godfathers,148355,129560,0.8733106400188736,18795,0.12668935998112635,2003,2003.csv
8488,Jonestown: The Life and Death of Peoples Temple,148292,148292,1.0,0,0.0,2006,2006.csv
8489,Harry Potter and the Deathly Hallows: Part 1 2018 Re-release,148263,148263,1.0,0,0.0,2010,2010.csv
8490,Girls Will Be Girls,148047,148047,1.0,0,0.0,2003,2003.csv
8491,Restless Creature: Wendy Whelan,147780,147780,1.0,0,0.0,2017,2017.csv
8492,Night of the Living Dead 2018 Re-release,147423,147423,1.0,0,0.0,2018,2018.csv
8493,The Strange Case of Angelica,147173,50135,0.3406535166097042,97038,0.6593464833902958,2010,2010.csv
8494,Driven,147172,0,0.0,147172,1.0,2019,2019.csv
8495,Songs My Brothers Taught Me,146937,34793,0.23678855563949175,112144,0.7632114443605083,2015,2015.csv
8496,Postal,146741,0,0.0,146741,1.0,2007,2007.csv
8497,Ayurveda: Art of Being,146713,32267,0.21993279395827228,114446,0.7800672060417277,2001,2001.csv
8498,American Promise,146702,146702,1.0,0,0.0,2013,2013.csv
8499,Watermark,146572,84464,0.576262860573643,62108,0.423737139426357,2014,2014.csv
8500,Dirty Deeds,146490,146490,1.0,0,0.0,2005,2005.csv
8501,Touched with Fire,146487,146487,1.0,0,0.0,2016,2016.csv
8502,5 Broken Cameras,146475,109983,0.7508653353814644,36492,0.2491346646185356,2012,2012.csv
8503,Biggie and Tupac,146419,94874,0.6479623546124479,51545,0.35203764538755217,2002,2002.csv
8504,Hannah,146325,11700,0.07995899538698104,134625,0.920041004613019,2018,2018.csv
8505,Starlet,146222,88212,0.6032744730615092,58010,0.3967255269384908,2012,2012.csv
8506,Company Man,146193,146193,1.0,0,0.0,2001,2001.csv
8507,Deadly Renovations,146146,146146,1.0,0,0.0,2012,2012.csv
8508,The Punk Singer,146000,122742,0.8406986301369863,23258,0.1593013698630137,2013,2013.csv
8509,Citizen K,145941,120411,0.8250662939132938,25530,0.17493370608670628,2019,2019.csv
8510,Framing John DeLorean,145625,145625,1.0,0,0.0,2019,2019.csv
8511,Daytime Drinking,145587,4970,0.03413766339027523,140617,0.9658623366097248,2009,2009.csv
8512,The Last Dalai Lama?,145524,145524,1.0,0,0.0,2017,2017.csv
8513,A Soap,145135,4164,0.028690529507010714,140971,0.9713094704929893,2006,2006.csv
8514,Deterrence,145071,145071,1.0,0,0.0,2000,2000.csv
8515,Krisha,144822,144822,1.0,0,0.0,2016,2016.csv
8516,Mr. Smith Goes to Washington 2018 Re-release,144738,144738,1.0,0,0.0,2018,2018.csv
8517,Sky Kids,144680,144680,1.0,0,0.0,2008,2008.csv
8518,Irving Berlin's Holiday Inn The Broadway Musical,144550,144550,1.0,0,0.0,2017,2017.csv
8519,Last Year at Marienbad,144492,144492,1.0,0,0.0,2008,2008.csv
8520,The Price of Everything,144446,87400,0.6050704069340792,57046,0.39492959306592085,2018,2018.csv
8521,Yellow Day 2015 Re-release,144163,144163,1.0,0,0.0,2015,2015.csv
8522,From Beneath,144123,144123,1.0,0,0.0,2012,2012.csv
8523,Cold Weather,144056,141358,0.9812711723218748,2698,0.018728827678125174,2011,2011.csv
8524,Dahmer,144008,144008,1.0,0,0.0,2002,2002.csv
8525,Thunder Soul,143986,143986,1.0,0,0.0,2011,2011.csv
8526,Cop Car,143658,134552,0.9366133455846525,9106,0.06338665441534756,2015,2015.csv
8527,Undertow,143597,143597,1.0,0,0.0,2004,2004.csv
8528,Wendy,143518,143518,1.0,0,0.0,2020,2020.csv
8529,Dirty Girl,143485,55125,0.38418650033104507,88360,0.6158134996689549,2011,2011.csv
8530,10th & Wolf,143451,54702,0.38132881611142483,88749,0.6186711838885752,2006,2006.csv
8531,X,143355,143355,1.0,0,0.0,2000,2000.csv
8532,Doctor Who: Logopolis,143248,143248,1.0,0,0.0,2019,2019.csv
8533,Alps,143234,16057,0.1121032715695994,127177,0.8878967284304006,2012,2012.csv
8534,Survival of the Dead,143191,101740,0.7105195158913619,41451,0.28948048410863814,2010,2010.csv
8535,Kids for Cash,143178,143178,1.0,0,0.0,2014,2014.csv
8536,Clash,143121,18215,0.12726993243479293,124906,0.8727300675652071,2016,2016.csv
8537,The Lost Skeleton of Cadavra,143121,143121,1.0,0,0.0,2004,2004.csv
8538,Disguising,143108,0,0.0,143108,1.0,2018,2018.csv
8539,Summer Palace,143027,63045,0.4407908996203514,79982,0.5592091003796485,2007,2007.csv
8540,Shelter,142666,142666,1.0,0,0.0,2008,2008.csv
8541,Flow: For Love of Water,142569,142569,1.0,0,0.0,2008,2008.csv
8542,Not Forgotten,142055,53744,0.3783323360670163,88311,0.6216676639329837,2009,2009.csv
8543,Dragon 2012 Re-release,142029,11137,0.0784135634271874,130892,0.9215864365728126,2012,2012.csv
8544,John Dies at the End,141951,141951,1.0,0,0.0,2013,2013.csv
8545,Citadel,141886,13377,0.09427991486122662,128509,0.9057200851387733,2012,2012.csv
8546,In Between Days,141616,23465,0.16569455428765112,118151,0.8343054457123489,2006,2006.csv
8547,May in the Summer,141605,22004,0.15538999329119735,119601,0.8446100067088027,2014,2014.csv
8548,Best F(r)iends Volume Two,141524,141524,1.0,0,0.0,2018,2018.csv
8549,Music from the Inside Out,141504,141504,1.0,0,0.0,2005,2005.csv
8550,The Booksellers,141215,25694,0.18194950961300146,115521,0.8180504903869985,2020,2020.csv
8551,Branagh Theatre Live: The Winter's Tale,141143,141143,1.0,0,0.0,2019,2019.csv
8552,Zu Warriors,141084,0,0.0,141084,1.0,2003,2003.csv
8553,Metropolis Giorgio Moroder Presents,140907,27362,0.19418481693599324,113545,0.8058151830640068,2011,2011.csv
8554,Canelo vs. Kovalev,140820,140820,1.0,0,0.0,2019,2019.csv
8555,Opal Dream,140666,14443,0.10267584206560221,126223,0.8973241579343978,2006,2006.csv
8556,The Cordillera of Dreams,140465,20943,0.14909763998149006,119522,0.8509023600185099,2019,2019.csv
8557,Incitement,140306,140306,1.0,0,0.0,2020,2020.csv
8558,Gore Vidal: The United States of Amnesia,140164,140164,1.0,0,0.0,2014,2014.csv
8559,Beautiful Boy,140123,77247,0.5512799469037917,62876,0.4487200530962083,2011,2011.csv
8560,Baghead,140106,140106,1.0,0,0.0,2008,2008.csv
8561,We Summon the Darkness,140105,60794,0.43391741907854825,79311,0.5660825809214518,2020,2020.csv
8562,The Weathered Underground,140091,140091,1.0,0,0.0,2010,2010.csv
8563,Liv & Ingmar,140041,10347,0.07388550495926192,129694,0.9261144950407381,2012,2012.csv
8564,Gremlins 2020 Re-release,140000,140000,1.0,0,0.0,2020,2020.csv
8565,The Wizard of Oz 2002 Re-release,139905,139905,1.0,0,0.0,2002,2002.csv
8566,Coherence,139745,102617,0.7343160757093277,37128,0.2656839242906723,2014,2014.csv
8567,Tigerland,139692,139692,1.0,0,0.0,2000,2000.csv
8568,Hunky Dory,139653,20296,0.14533164343050275,119357,0.8546683565694972,2012,2012.csv
8569,Archive,139593,139593,1.0,0,0.0,2020,2020.csv
8570,Support the Girls,139550,129124,0.9252884270870656,10426,0.07471157291293443,2018,2018.csv
8571,Flowers,139421,61568,0.44159775069752766,77853,0.5584022493024724,2014,2014.csv
8572,Wilder vs. Ortiz,139207,139207,1.0,0,0.0,2019,2019.csv
8573,Rock on 2,139173,98868,0.710396413097368,40305,0.289603586902632,2016,2016.csv
8574,Kamikaze Girls 2005 Re-release,139139,34424,0.24740726899000282,104715,0.7525927310099972,2005,2005.csv
8575,The Salon,139084,139084,1.0,0,0.0,2007,2007.csv
8576,The Polar Express 2014 IMAX Release,139055,139055,1.0,0,0.0,2014,2014.csv
8577,What the Bleep!?: Down the Rabbit Hole,138913,138913,1.0,0,0.0,2006,2006.csv
8578,Who Will Write Our History,138868,138039,0.9940303021574445,829,0.0059696978425555205,2019,2019.csv
8579,Head Full of Honey,138844,12350,0.0889487482354297,126494,0.9110512517645704,2018,2018.csv
8580,The List,138814,138814,1.0,0,0.0,2007,2007.csv
8581,Good Ol' Freda,138811,138811,1.0,0,0.0,2013,2013.csv
8582,Lies and Alibis,138704,0,0.0,138704,1.0,2006,2006.csv
8583,Zero Motivation,138609,116044,0.8372039333665202,22565,0.16279606663347979,2014,2014.csv
8584,The Brawler,138515,75929,0.548164458722882,62586,0.451835541277118,2018,2018.csv
8585,Beauty and the Beast 2002 Re-release,138503,138503,1.0,0,0.0,2002,2002.csv
8586,Fear and Trembling 2004 Re-release,138436,126684,0.915108786731775,11752,0.08489121326822503,2004,2004.csv
8587,Psycho-Pass: The Movie,138366,138366,1.0,0,0.0,2016,2016.csv
8588,Brooklyn Lobster,138267,138267,1.0,0,0.0,2005,2005.csv
8589,Most Wanted,138000,138000,1.0,0,0.0,2020,2020.csv
8590,War Dance,137977,115210,0.8349942381701299,22767,0.1650057618298702,2007,2007.csv
8591,Lynryd Skynyrd: Last of the Street Survivors Farewell Tour,137888,137888,1.0,0,0.0,2019,2019.csv
8592,Love Ranch,137885,137885,1.0,0,0.0,2010,2010.csv
8593,Harry Potter and the Order of the Phoenix 2018 Re-release,137694,132522,0.9624384504771449,5172,0.03756154952285503,2007,2007.csv
8594,Super Sucker,137628,137628,1.0,0,0.0,2003,2003.csv
8595,The Hottest State,137341,31216,0.22728828245025157,106125,0.7727117175497484,2007,2007.csv
8596,Time of Favor,137340,137340,1.0,0,0.0,2002,2002.csv
8597,Beneath Us,137260,137260,1.0,0,0.0,2020,2020.csv
8598,Is the Man Who Is Tall Happy?,137042,137042,1.0,0,0.0,2013,2013.csv
8599,Slaughter Creek,136815,136815,1.0,0,0.0,2012,2012.csv
8600,Road,136700,136700,1.0,0,0.0,2002,2002.csv
8601,Harry Potter and the Half-Blood Prince 2018 Re-release,136081,130081,0.9559086132524012,6000,0.044091386747598854,2009,2009.csv
8602,Swiri,135892,98452,0.7244870926912548,37440,0.27551290730874517,2001,2001.csv
8603,I Will Follow,135809,135809,1.0,0,0.0,2011,2011.csv
8604,Mantra: Sounds Into Silence,135684,115013,0.8476533710680699,20671,0.15234662893193007,2018,2018.csv
8605,Sonchiriya,135413,86765,0.6407435032087022,48648,0.35925649679129773,2019,2019.csv
8606,La Sapienza,135392,135392,1.0,0,0.0,2015,2015.csv
8607,The Kind Words,135382,135382,1.0,0,0.0,2016,2016.csv
8608,The Ninth Day,135311,72888,0.5386701746347303,62423,0.4613298253652696,2005,2005.csv
8609,The Cherry Orchard,135280,135280,1.0,0,0.0,2002,2002.csv
8610,The Other Dream Team,135228,135228,1.0,0,0.0,2012,2012.csv
8611,The Other Story,135191,135191,1.0,0,0.0,2019,2019.csv
8612,The Bolshoi Ballet: Live From Moscow - A Hero of Our Time,135168,104837,0.7756051728219697,30331,0.2243948271780303,2017,2017.csv
8613,My Neighbor Totoro 2015 Re-release,134877,0,0.0,134877,1.0,2015,2015.csv
8614,Another Day of Life,134801,3190,0.023664512874533573,131611,0.9763354871254665,2018,2018.csv
8615,Led Zeppelin: Celebration Day,134753,0,0.0,134753,1.0,2012,2012.csv
8616,Concert for George,134600,134600,1.0,0,0.0,2003,2003.csv
8617,Attenberg,134503,24036,0.17870233377694178,110467,0.8212976662230582,2010,2010.csv
8618,The Devil Came on Horseback,134495,132782,0.9872634670433845,1713,0.012736532956615488,2007,2007.csv
8619,The Times of Bill Cunningham,134288,134288,1.0,0,0.0,2020,2020.csv
8620,Made in Abyss: Journey's Dawn,134194,134047,0.9989045709942322,147,0.001095429005767769,2019,2019.csv
8621,Ism,134165,134165,1.0,0,0.0,2016,2016.csv
8622,Redwood Highway,134049,134049,1.0,0,0.0,2014,2014.csv
8623,Lunacy,133982,48324,0.36067531459449775,85658,0.6393246854055022,2005,2005.csv
8624,Be Natural: The Untold Story of Alice Guy-Blaché,133951,115685,0.8636367029734754,18266,0.13636329702652464,2019,2019.csv
8625,The Great Museum,133905,18020,0.13457301818453382,115885,0.8654269818154662,2014,2014.csv
8626,Pure Country 2: The Gift,133771,133771,1.0,0,0.0,2010,2010.csv
8627,Don't Think I've Forgotten: Cambodia's Lost Rock and Roll,133443,133443,1.0,0,0.0,2015,2015.csv
8628,Under the Shadow,133324,31900,0.23926674867240708,101424,0.760733251327593,2016,2016.csv
8629,The Jewish Cardinal,133232,133232,1.0,0,0.0,2014,2014.csv
8630,A Shot at Glory,133122,133122,1.0,0,0.0,2002,2002.csv
8631,"Hare Krishna! The Mantra, the Movement and the Swami Who Started It",133006,133006,1.0,0,0.0,2017,2017.csv
8632,Crying Ladies,132920,132920,1.0,0,0.0,2004,2004.csv
8633,Tonight You're Mine,132787,6255,0.04710551484708594,126532,0.9528944851529141,2011,2011.csv
8634,Hukkle,132745,53715,0.40464800934121814,79030,0.5953519906587819,2003,2003.csv
8635,Stolen,132596,132596,1.0,0,0.0,2006,2006.csv
8636,1+1=11,132498,132498,1.0,0,0.0,2003,2003.csv
8637,Dawson City: Frozen Time,132369,132369,1.0,0,0.0,2016,2016.csv
8638,Sonny,132221,30005,0.22693066910702536,102216,0.7730693308929747,2002,2002.csv
8639,Kumaré,132160,132160,1.0,0,0.0,2012,2012.csv
8640,My Brother the Devil,132056,44906,0.34005270491306716,87150,0.6599472950869328,2012,2012.csv
8641,How to Survive a Plague,132055,132055,1.0,0,0.0,2012,2012.csv
8642,A Ballerina's Tale,131995,131995,1.0,0,0.0,2015,2015.csv
8643,Mugamoodi,131965,101000,0.7653544500435722,30965,0.23464554995642783,2012,2012.csv
8644,Hounddog,131961,131961,1.0,0,0.0,2008,2008.csv
8645,Touchez Pas au Grisbi,131548,131548,1.0,0,0.0,2003,2003.csv
8646,Ballerina,131460,114507,0.8710406207211319,16953,0.1289593792788681,2008,2008.csv
8647,Robot Stories,131451,131451,1.0,0,0.0,2004,2004.csv
8648,Proud American,131357,131357,1.0,0,0.0,2008,2008.csv
8649,Unknown White Male,131256,126836,0.9663253489364295,4420,0.03367465106357043,2006,2006.csv
8650,28 Hotel Rooms,131208,18869,0.1438098286689836,112339,0.8561901713310164,2012,2012.csv
8651,Rudy 2018 Re-release,131200,131200,1.0,0,0.0,2018,2018.csv
8652,Son frère,131195,22834,0.1740462670071268,108361,0.8259537329928732,2003,2003.csv
8653,The Wind,130974,28252,0.21570693420068104,102722,0.7842930657993189,2019,2019.csv
8654,Mister America,130897,130897,1.0,0,0.0,2019,2019.csv
8655,The Nines,130880,63165,0.4826176650366748,67715,0.5173823349633252,2007,2007.csv
8656,The Image Book,130802,94153,0.7198131527040871,36649,0.2801868472959129,2018,2018.csv
8657,The Earrings of Madame De...,130561,130561,1.0,0,0.0,2007,2007.csv
8658,Until the Light Takes Us,130441,130441,1.0,0,0.0,2009,2009.csv
8659,Karla,130416,0,0.0,130416,1.0,2006,2006.csv
8660,Saheb Biwi Aur Gangster 3,130403,0,0.0,130403,1.0,2018,2018.csv
8661,October,130335,32127,0.24649556911036943,98208,0.7535044308896306,2010,2010.csv
8662,Five Seasons: The Gardens of Piet Oudolf,130319,119223,0.9148550863649967,11096,0.08514491363500334,2018,2018.csv
8663,Requiem for the American Dream,130152,130152,1.0,0,0.0,2016,2016.csv
8664,Be Here to Love Me: A Film About Townes Van Zandt,129988,129988,1.0,0,0.0,2005,2005.csv
8665,Section 375,129916,0,0.0,129916,1.0,2019,2019.csv
8666,The Fairy,129818,38399,0.2957910305196506,91419,0.7042089694803494,2011,2011.csv
8667,Great Performances at the Met: Puccini: Madama Butterfly,129730,129730,1.0,0,0.0,2018,2018.csv
8668,Game 6,129664,129664,1.0,0,0.0,2006,2006.csv
8669,Great Performances at the Met: Tchaikovsky: Eugene Onegin 2018 Re-release,129498,129498,1.0,0,0.0,2018,2018.csv
8670,Great Performances at the Met: Verdi: Il Trovatore,129393,129393,1.0,0,0.0,2018,2018.csv
8671,Whatever the Heart Says,129319,129319,1.0,0,0.0,2005,2005.csv
8672,Maryam,129265,129265,1.0,0,0.0,2002,2002.csv
8673,I Called Him Morgan,128986,128986,1.0,0,0.0,2017,2017.csv
8674,The Golden Era 2014 Re-release,128926,102931,0.7983727099266246,25995,0.20162729007337543,2014,2014.csv
8675,Yossi,128668,117047,0.9096822830851494,11621,0.09031771691485062,2012,2012.csv
8676,Love After Love,128602,121098,0.9416494300244164,7504,0.058350569975583584,2018,2018.csv
8677,The Adventurer: The Curse of the Midas Box,128471,6399,0.04980890629013552,122072,0.9501910937098644,2014,2014.csv
8678,Where Hands Touch,128269,67743,0.5281322844958641,60526,0.47186771550413587,2018,2018.csv
8679,Stonewall Uprising,128203,128203,1.0,0,0.0,2010,2010.csv
8680,Love Comes Lately,127958,78079,0.6101924068835086,49879,0.3898075931164913,2008,2008.csv
8681,Computer Chess,127852,102041,0.7981181365954385,25811,0.20188186340456152,2013,2013.csv
8682,Steve Jobs: The Lost Interview,127541,105710,0.8288315130036615,21831,0.17116848699633844,2011,2011.csv
8683,American Chai,127518,127518,1.0,0,0.0,2002,2002.csv
8684,The Wendell Baker Story 2007 Re-release,127414,127414,1.0,0,0.0,2007,2007.csv
8685,Benda Bilili!,127362,13420,0.10536894835194172,113942,0.8946310516480583,2010,2010.csv
8686,Sleepless in Seattle 2018 Re-release,127281,127281,1.0,0,0.0,2018,2018.csv
8687,A Band Called Death,127257,127257,1.0,0,0.0,2013,2013.csv
8688,Friends and Family,127212,127212,1.0,0,0.0,2003,2003.csv
8689,Burma VJ: Reporting from a Closed Country,127063,51672,0.40666441056798597,75391,0.593335589432014,2009,2009.csv
8690,O Fantasma,126783,126783,1.0,0,0.0,2002,2002.csv
8691,Chimes at Midnight,126724,126724,1.0,0,0.0,2016,2016.csv
8692,Silent Night,126594,14567,0.11506864464350601,112027,0.884931355356494,2012,2012.csv
8693,Escape Fire: The Fight to Rescue American Healthcare,126238,126238,1.0,0,0.0,2012,2012.csv
8694,The Arbor,126182,21620,0.17133981074955223,104562,0.8286601892504478,2010,2010.csv
8695,Baran,125900,125900,1.0,0,0.0,2001,2001.csv
8696,The Great Buster,125807,118344,0.9406789765275382,7463,0.059321023472461785,2018,2018.csv
8697,Europa Report,125687,125687,1.0,0,0.0,2013,2013.csv
8698,Paris Is Burning 2019 Re-release,125677,125677,1.0,0,0.0,2019,2019.csv
8699,Green Card Fever,125596,125596,1.0,0,0.0,2003,2003.csv
8700,This Changes Everything,125348,64988,0.5184606056738041,60360,0.48153939432619586,2019,2019.csv
8701,The B-Side: Elsa Dorfman's Portrait Photography,125227,125227,1.0,0,0.0,2017,2017.csv
8702,Manda Bala (Send a Bullet),125025,122905,0.9830433913217357,2120,0.016956608678264345,2007,2007.csv
8703,Spinning Plates,124856,112449,0.9006295252130454,12407,0.09937047478695457,2013,2013.csv
8704,Mary Magdalene 2019 Re-release,124741,124741,1.0,0,0.0,2019,2019.csv
8705,Every Secret Thing,124733,103536,0.8300610103180394,21197,0.16993898968196067,2015,2015.csv
8706,Hymn: Sarah Brightman In Concert,124707,113274,0.9083211046693449,11433,0.09167889533065506,2018,2018.csv
8707,Ran 2010 Re-release,124673,124673,1.0,0,0.0,2010,2010.csv
8708,A Tuba to Cuba,124592,121772,0.9773661230255554,2820,0.022633876974444588,2019,2019.csv
8709,'85: The Greatest Team in Football History,124573,124573,1.0,0,0.0,2018,2018.csv
8710,Final: The Rapture,124561,124561,1.0,0,0.0,2013,2013.csv
8711,Vidal Sassoon: The Movie,124532,85974,0.6903767706292359,38558,0.30962322937076414,2011,2011.csv
8712,Hope Gap,124411,104732,0.8418226684135647,19679,0.1581773315864353,2020,2020.csv
8713,Singin' in the Rain 2002 Re-release,124382,120420,0.9681465163769677,3962,0.031853483623032273,2002,2002.csv
8714,The First Saturday in May,124294,124294,1.0,0,0.0,2008,2008.csv
8715,Post Tenebras Lux,124279,39185,0.31529864257034573,85094,0.6847013574296542,2012,2012.csv
8716,The Square,124244,124244,1.0,0,0.0,2013,2013.csv
8717,Treeless Mountain,124023,60336,0.48649040903703344,63687,0.5135095909629666,2009,2009.csv
8718,Marguerite & Julien,123918,0,0.0,123918,1.0,2015,2015.csv
8719,Knights of Badassdom,123854,123854,1.0,0,0.0,2014,2014.csv
8720,Wings of Desire 2018 Re-release,123830,123830,1.0,0,0.0,2018,2018.csv
8721,The Magic of Belle Isle,123821,102388,0.8269033524200257,21433,0.1730966475799743,2012,2012.csv
8722,Were the World Mine,123789,123789,1.0,0,0.0,2008,2008.csv
8723,Puncture,123700,68945,0.5573565076798707,54755,0.44264349232012934,2011,2011.csv
8724,Appropriate Behavior,123699,46912,0.37924316283882653,76787,0.6207568371611735,2015,2015.csv
8725,"War Eagle, Arkansas",123670,123670,1.0,0,0.0,2009,2009.csv
8726,Sigur Rós: Inni,123482,123482,1.0,0,0.0,2011,2011.csv
8727,Momma's Man,123385,100435,0.8139968391619727,22950,0.18600316083802731,2008,2008.csv
8728,Flannel Pajamas,123301,123301,1.0,0,0.0,2006,2006.csv
8729,Easy Rider 2019 Re-release,123276,123276,1.0,0,0.0,2019,2019.csv
8730,The Last Mountain,122961,122961,1.0,0,0.0,2011,2011.csv
8731,Ashby,122919,4631,0.03767521701282959,118288,0.9623247829871704,2015,2015.csv
8732,Secret Ballot,122875,114909,0.9351698880976602,7966,0.06483011190233978,2002,2002.csv
8733,Blood Fest,122833,82774,0.6738742845977872,40059,0.32612571540221275,2018,2018.csv
8734,"14 Days, 12 Nights",122806,122530,0.9977525528068661,276,0.002247447193133886,2020,2020.csv
8735,Do I Sound Gay?,122595,119388,0.9738406949712468,3207,0.026159305028753212,2015,2015.csv
8736,Street Dreams,122575,122575,1.0,0,0.0,2009,2009.csv
8737,Downtown 81 2019 Re-release,122390,122390,1.0,0,0.0,2019,2019.csv
8738,Film socialisme 2010 Re-release,122264,42925,0.3510845383759733,79339,0.6489154616240267,2010,2010.csv
8739,Tragedy Girls,122211,61899,0.506492868890689,60312,0.49350713110931094,2017,2017.csv
8740,Dancing at the Blue Iguana,122121,67913,0.5561123803440849,54208,0.44388761965591506,2001,2001.csv
8741,Before I Forget,122071,27611,0.22618803810896937,94460,0.7738119618910306,2007,2007.csv
8742,Howard Zinn: You Can't Be Neutral on a Moving Train,122011,122011,1.0,0,0.0,2004,2004.csv
8743,The Ones Below,121827,12488,0.10250601262445927,109339,0.8974939873755408,2016,2016.csv
8744,Tremors,121813,23911,0.19629267812138276,97902,0.8037073218786173,2019,2019.csv
8745,Yu-Gi-Oh!: The Movie - Pyramid of Light 2018 Re-release,121688,121688,1.0,0,0.0,2018,2018.csv
8746,Fidel,121304,121304,1.0,0,0.0,2002,2002.csv
8747,Mutual Appreciation,121292,103509,0.8533868680539525,17783,0.14661313194604755,2006,2006.csv
8748,All the Queen's Men,121258,23662,0.19513764040310744,97596,0.8048623595968926,2001,2001.csv
8749,Letters to Elena,121254,8511,0.07019149883715177,112743,0.9298085011628482,2012,2012.csv
8750,Afflicted,121179,121179,1.0,0,0.0,2014,2014.csv
8751,In Jackson Heights,121094,121094,1.0,0,0.0,2015,2015.csv
8752,Michael,121034,15715,0.12983954921757523,105319,0.8701604507824248,2011,2011.csv
8753,The Girl Without Hands,121020,21787,0.1800280945298298,99233,0.8199719054701702,2016,2016.csv
8754,Miss Sharon Jones!,120880,120880,1.0,0,0.0,2016,2016.csv
8755,Better Living Through Chemistry,120823,75143,0.6219262888688412,45680,0.3780737111311588,2014,2014.csv
8756,I Am a Sex Addict,120790,115694,0.9578110770759168,5096,0.04218892292408312,2006,2006.csv
8757,David & Layla,120750,120750,1.0,0,0.0,2007,2007.csv
8758,Hockney 2016 Re-release,120745,120745,1.0,0,0.0,2016,2016.csv
8759,Examined Life,120712,120712,1.0,0,0.0,2009,2009.csv
8760,Cowgirls 'n Angels,120680,120680,1.0,0,0.0,2012,2012.csv
8761,Lagerfeld Confidential,120643,67500,0.5595020017738286,53143,0.4404979982261714,2007,2007.csv
8762,Sons of Provo,120488,120488,1.0,0,0.0,2005,2005.csv
8763,Spark: A Burning Man Story,120459,120459,1.0,0,0.0,2013,2013.csv
8764,I Vitelloni 2003 Re-release,120343,116428,0.9674679873361973,3915,0.03253201266380263,2003,2003.csv
8765,Foodfight!,120141,0,0.0,120141,1.0,2012,2012.csv
8766,Blank City,119929,116037,0.9675474655838038,3892,0.03245253441619625,2011,2011.csv
8767,Avant qu'on explose,119894,119894,1.0,0,0.0,2019,2019.csv
8768,The Pearl Button,119753,42166,0.35210808915016745,77587,0.6478919108498326,2015,2015.csv
8769,Mongolian Ping Pong,119732,71223,0.5948535061637658,48509,0.40514649383623424,2006,2006.csv
8770,Amy's Orgasm,119664,119664,1.0,0,0.0,2002,2002.csv
8771,The Komediant,119506,119506,1.0,0,0.0,2002,2002.csv
8772,Digging for Fire,119364,119364,1.0,0,0.0,2015,2015.csv
8773,Valley of the Heart's Delight,119290,119290,1.0,0,0.0,2010,2010.csv
8774,Celine: Through the Eyes of the World,119274,0,0.0,119274,1.0,2010,2010.csv
8775,Jimmy Carter Man from Plains,119263,108807,0.9123282157919891,10456,0.08767178420801086,2007,2007.csv
8776,Fellini: I'm a Born Liar,119217,106686,0.89488915171494,12531,0.10511084828506001,2003,2003.csv
8777,12 and Holding,119195,96464,0.8092956919333865,22731,0.19070430806661354,2006,2006.csv
8778,Remember the Goal,119100,119100,1.0,0,0.0,2016,2016.csv
8779,Home Movie,119052,119052,1.0,0,0.0,2002,2002.csv
8780,Until Forever 2016 Re-release,118795,105358,0.8868891788374932,13437,0.11311082116250684,2016,2016.csv
8781,Neither Heaven Nor Earth,118663,12810,0.10795277382166303,105853,0.892047226178337,2015,2015.csv
8782,The Burnt Orange Heresy,118559,39893,0.3364822577788274,78666,0.6635177422211725,2020,2020.csv
8783,Gentlemen Broncos,118492,113682,0.9594065422138204,4810,0.040593457786179656,2009,2009.csv
8784,The Levelling,118451,3040,0.025664620813669787,115411,0.9743353791863302,2017,2017.csv
8785,See What I'm Saying: The Deaf Entertainers Documentary,118206,118206,1.0,0,0.0,2010,2010.csv
8786,Styx 2018 Re-release,118188,70794,0.5989948218093207,47394,0.40100517819067927,2018,2018.csv
8787,Victor,117755,117755,1.0,0,0.0,2016,2016.csv
8788,The Decoy Bride,117754,759,0.006445640912410619,116995,0.9935543590875894,2011,2011.csv
8789,Freakonomics,117678,101270,0.8605686704396743,16408,0.13943132956032564,2010,2010.csv
8790,Running Free,117608,117608,1.0,0,0.0,2000,2000.csv
8791,Spring Forward,117471,117471,1.0,0,0.0,2000,2000.csv
8792,Bisbee '17,117470,117470,1.0,0,0.0,2018,2018.csv
8793,George Takei's Allegiance 2018 Re-release,117162,117162,1.0,0,0.0,2018,2018.csv
8794,Jauja 2014 Re-release,117117,60231,0.5142805912036681,56886,0.48571940879633185,2014,2014.csv
8795,Sir! No Sir!,116944,116944,1.0,0,0.0,2006,2006.csv
8796,Come to Daddy,116930,96713,0.827101684768665,20217,0.17289831523133498,2020,2020.csv
8797,"Love, Sex and Eating the Bones",116869,116869,1.0,0,0.0,2004,2004.csv
8798,Skin,116863,0,0.0,116863,1.0,2019,2019.csv
8799,Gimme the Loot,116783,104442,0.8943253726997936,12341,0.10567462730020637,2013,2013.csv
8800,A Case of You,116559,4187,0.035921722046345625,112372,0.9640782779536544,2013,2013.csv
8801,The Undefeated,116381,116381,1.0,0,0.0,2011,2011.csv
8802,Touching Home,116353,116353,1.0,0,0.0,2010,2010.csv
8803,No Impact Man: The Documentary,116349,100028,0.8597237621294553,16321,0.14027623787054466,2009,2009.csv
8804,The Art of Flight,116134,0,0.0,116134,1.0,2012,2012.csv
8805,The Grand,115879,115879,1.0,0,0.0,2008,2008.csv
8806,Mob Psycho 100,115766,115766,1.0,0,0.0,2019,2019.csv
8807,I Am Divine,115739,81497,0.7041446703358418,34242,0.2958553296641582,2013,2013.csv
8808,Headshot,115511,1373,0.011886313857554691,114138,0.9881136861424453,2011,2011.csv
8809,Loggerheads,115314,115314,1.0,0,0.0,2005,2005.csv
8810,Caged No More,114959,114959,1.0,0,0.0,2016,2016.csv
8811,Sound and Fury,114882,114882,1.0,0,0.0,2000,2000.csv
8812,Berlin,114860,33231,0.28931742991467874,81629,0.7106825700853212,2008,2008.csv
8813,Nostalgia,114603,114603,1.0,0,0.0,2018,2018.csv
8814,Taboo,114425,114425,1.0,0,0.0,2000,2000.csv
8815,Sympathy for the Devil,114301,51150,0.44750264652102784,63151,0.5524973534789722,2019,2019.csv
8816,John McEnroe: In the Realm of Perfection,114289,90964,0.795912117526621,23325,0.2040878824733789,2018,2018.csv
8817,Kippur,114283,114283,1.0,0,0.0,2000,2000.csv
8818,After Innocence,114264,114264,1.0,0,0.0,2005,2005.csv
8819,Akira 2001 Re-release,114009,114009,1.0,0,0.0,2001,2001.csv
8820,Ain't in It for My Health: A Film About Levon Helm,113966,113966,1.0,0,0.0,2013,2013.csv
8821,Bodied,113956,113956,1.0,0,0.0,2018,2018.csv
8822,The Woman Who Loves Giraffes,113858,113858,1.0,0,0.0,2019,2019.csv
8823,35 and Ticking,113794,113794,1.0,0,0.0,2011,2011.csv
8824,Oh My God,113792,38244,0.3360868953880765,75548,0.6639131046119235,2008,2008.csv
8825,Winter Passing,113783,107492,0.9447105455120712,6291,0.055289454487928776,2006,2006.csv
8826,Seaside,113724,15290,0.13444831346065914,98434,0.8655516865393409,2002,2002.csv
8827,Games People Play: New York,113622,113622,1.0,0,0.0,2004,2004.csv
8828,The Goonies 2013 Re-release,113538,113538,1.0,0,0.0,2013,2013.csv
8829,"We Love You, Sally Carmichael!",113435,113435,1.0,0,0.0,2017,2017.csv
8830,Darfur Now,113398,109107,0.9621598264519656,4291,0.03784017354803436,2007,2007.csv
8831,Abacus: Small Enough to Jail,113278,113278,1.0,0,0.0,2017,2017.csv
8832,God the Father,113276,113276,1.0,0,0.0,2014,2014.csv
8833,Absurdistan,113269,39683,0.3503429888142387,73586,0.6496570111857614,2008,2008.csv
8834,Burn 2012 Re-release,113173,113173,1.0,0,0.0,2012,2012.csv
8835,Road Hard,113169,113169,1.0,0,0.0,2015,2015.csv
8836,Police Story,113164,113164,1.0,0,0.0,2019,2019.csv
8837,Food of Love,113164,43922,0.38812696617298786,69242,0.6118730338270121,2002,2002.csv
8838,Rosie,112937,6839,0.06055588513950255,106098,0.9394441148604974,2019,2019.csv
8839,Afghan Star,112909,102115,0.9044008892116661,10794,0.09559911078833397,2009,2009.csv
8840,Filmworker,112828,102609,0.9094285106533839,10219,0.09057148934661609,2018,2018.csv
8841,Monster Beach Party,112791,112791,1.0,0,0.0,2009,2009.csv
8842,Follow Me: The Yoni Netanyahu Story,112679,112679,1.0,0,0.0,2012,2012.csv
8843,A Boy. A Girl. A Dream.,112552,112552,1.0,0,0.0,2018,2018.csv
8844,The Recall,112357,22943,0.20419733527951084,89414,0.7958026647204891,2017,2017.csv
8845,Killing Kasztner,112313,112313,1.0,0,0.0,2009,2009.csv
8846,"Hale County This Morning, This Evening",112282,112282,1.0,0,0.0,2018,2018.csv
8847,The Dawn Wall,112191,112191,1.0,0,0.0,2018,2018.csv
8848,Penton: The John Penton Story,112159,112159,1.0,0,0.0,2014,2014.csv
8849,How Viktor 'The Garlic' Took Alexey 'The Stud' to the Nursing Home,112071,12954,0.11558744010493348,99117,0.8844125598950665,2017,2017.csv
8850,Marwencol,112036,112036,1.0,0,0.0,2010,2010.csv
8851,A Chance in the World,112007,112007,1.0,0,0.0,2018,2018.csv
8852,Even Money,111974,64458,0.5756514905245861,47516,0.4243485094754139,2007,2007.csv
8853,Una noche,111903,100887,0.9015575989919842,11016,0.09844240100801586,2013,2013.csv
8854,The Producers,111866,111866,1.0,0,0.0,2002,2002.csv
8855,Hometown Legend,111806,111806,1.0,0,0.0,2002,2002.csv
8856,Saint John of Las Vegas,111731,102645,0.9186796860316295,9086,0.08132031396837046,2010,2010.csv
8857,Arranged,111731,23571,0.21096204276342287,88160,0.7890379572365771,2007,2007.csv
8858,1915,111682,111682,1.0,0,0.0,2015,2015.csv
8859,Medicine for Melancholy,111551,111551,1.0,0,0.0,2009,2009.csv
8860,Thomas in Love,111523,44256,0.3968329402903437,67267,0.6031670597096563,2001,2001.csv
8861,Let's Bring Our Heroes Home,111423,111423,1.0,0,0.0,2004,2004.csv
8862,Rich Hill,111376,111376,1.0,0,0.0,2014,2014.csv
8863,Love the Hard Way,111350,44391,0.39866187696452626,66959,0.6013381230354737,2003,2003.csv
8864,Elevator to the Gallows 2016 Re-release,111267,111267,1.0,0,0.0,2016,2016.csv
8865,"Wild Horse, Wild Ride",111205,111205,1.0,0,0.0,2012,2012.csv
8866,A Paris Education,111197,21598,0.19423185877316834,89599,0.8057681412268317,2018,2018.csv
8867,Strangerland,111107,17472,0.15725381839128047,93635,0.8427461816087195,2015,2015.csv
8868,The Obama Effect,110904,110904,1.0,0,0.0,2012,2012.csv
8869,Puccini for Beginners,110864,89464,0.8069707028431231,21400,0.1930292971568769,2007,2007.csv
8870,The Overnighters,110763,110763,1.0,0,0.0,2014,2014.csv
8871,Duran Duran: Unstaged,110746,110746,1.0,0,0.0,2014,2014.csv
8872,Word Wars,110617,110617,1.0,0,0.0,2004,2004.csv
8873,In the Face of Evil: Reagan's War in Word and Deed,110577,110577,1.0,0,0.0,2004,2004.csv
8874,The Perfect Family,110313,110313,1.0,0,0.0,2012,2012.csv
8875,The Trouble with Terkel,110289,110289,1.0,0,0.0,2017,2017.csv
8876,Roar,110048,110048,1.0,0,0.0,2015,2015.csv
8877,Diva,110014,110014,1.0,0,0.0,2007,2007.csv
8878,Best Worst Movie,109895,109895,1.0,0,0.0,2010,2010.csv
8879,The Fifth Element 2017 Re-release,109786,0,0.0,109786,1.0,2017,2017.csv
8880,Babylon,109749,109749,1.0,0,0.0,2019,2019.csv
8881,Zero Days,109649,109649,1.0,0,0.0,2016,2016.csv
8882,Anohana the Movie: The Flower We Saw That Day (Ano hi mita hana no namae wo bokutachi wa mada shiran,109630,109630,1.0,0,0.0,2014,2014.csv
8883,Cameraperson,109464,102033,0.9321146678360008,7431,0.06788533216399913,2016,2016.csv
8884,Wedding Party 2,109459,11140,0.10177326670260098,98319,0.898226733297399,2017,2017.csv
8885,Blood Done Sign My Name,109383,109383,1.0,0,0.0,2010,2010.csv
8886,Trumbo,109057,109057,1.0,0,0.0,2008,2008.csv
8887,The Lure,108846,101657,0.9339525568234018,7189,0.06604744317659814,2017,2017.csv
8888,Adult Beginners,108808,108808,1.0,0,0.0,2015,2015.csv
8889,Sworn Virgin,108681,4636,0.042656950156881146,104045,0.9573430498431188,2015,2015.csv
8890,Monsieur N. 2004 Re-release,108631,37757,0.34757113531128314,70874,0.6524288646887169,2004,2004.csv
8891,Red Sorghum,108371,0,0.0,108371,1.0,2018,2018.csv
8892,Violet & Daisy,108139,17186,0.15892508715634507,90953,0.8410749128436549,2013,2013.csv
8893,Bettie Page Reveals All,108118,108118,1.0,0,0.0,2013,2013.csv
8894,Downtown 81,108058,108058,1.0,0,0.0,2001,2001.csv
8895,"Love, Cecil",107940,106057,0.9825551232166018,1883,0.017444876783398185,2017,2017.csv
8896,Kidnapping of Michel Houellebecq,107641,11546,0.10726396075844706,96095,0.892736039241553,2014,2014.csv
8897,Bonjour Monsieur Shlomi,107585,107585,1.0,0,0.0,2004,2004.csv
8898,Sleep Dealer,107559,80136,0.7450422558781692,27423,0.2549577441218308,2008,2008.csv
8899,Revenge of the Green Dragons,107412,0,0.0,107412,1.0,2014,2014.csv
8900,"No Date, No Signature",107368,36444,0.3394307428656583,70924,0.6605692571343417,2018,2018.csv
8901,Cockneys vs Zombies,107348,0,0.0,107348,1.0,2012,2012.csv
8902,Marebito,107259,13983,0.1303666825161525,93276,0.8696333174838475,2005,2005.csv
8903,A Slipping-Down Life,107099,107099,1.0,0,0.0,2004,2004.csv
8904,National Theatre Live: Julius Caesar,107057,107057,1.0,0,0.0,2018,2018.csv
8905,Carlos Castaneda: Enigma of a Sorcerer,107040,107040,1.0,0,0.0,2004,2004.csv
8906,Jeruzalem,107024,11287,0.10546232620720586,95737,0.8945376737927941,2016,2016.csv
8907,Best Worst Thing That Ever Could Have Happened...,106986,106986,1.0,0,0.0,2016,2016.csv
8908,The Tales of Hoffmann,106860,91930,0.8602844843720756,14930,0.1397155156279244,2015,2015.csv
8909,Ivory Tower,106771,106771,1.0,0,0.0,2014,2014.csv
8910,Vita Activa: The Spirit of Hannah Arendt,106768,82143,0.7693597332534092,24625,0.23064026674659074,2016,2016.csv
8911,Kurt Cobain About a Son,106724,87016,0.8153367564933848,19708,0.1846632435066152,2007,2007.csv
8912,The Alphabet Killer,106596,29784,0.2794101091973432,76812,0.7205898908026568,2008,2008.csv
8913,The Way We Get By,106542,106542,1.0,0,0.0,2009,2009.csv
8914,Dekalog 2016 Re-release,106494,106494,1.0,0,0.0,2016,2016.csv
8915,Wrong,106425,46021,0.4324265914963589,60404,0.567573408503641,2012,2012.csv
8916,The Charmer,106379,26167,0.24597899961458558,80212,0.7540210003854144,2018,2018.csv
8917,Six Dance Lessons in Six Weeks,106323,106323,1.0,0,0.0,2014,2014.csv
8918,The Bachelors,106212,0,0.0,106212,1.0,2017,2017.csv
8919,Almost Peaceful 2004 Re-release,106184,106184,1.0,0,0.0,2004,2004.csv
8920,The Skeptic,106128,6671,0.06285805819387909,99457,0.9371419418061209,2009,2009.csv
8921,The Brink,106057,106057,1.0,0,0.0,2019,2019.csv
8922,Big Star: Nothing Can Hurt Me,105998,105998,1.0,0,0.0,2013,2013.csv
8923,The Million Dollar Hotel,105983,59989,0.566024739816763,45994,0.43397526018323695,2000,2000.csv
8924,A Jihad for Love,105651,105651,1.0,0,0.0,2008,2008.csv
8925,King Corn,105422,105422,1.0,0,0.0,2007,2007.csv
8926,Tortilla Heaven,105401,105401,1.0,0,0.0,2007,2007.csv
8927,Never Heard,105271,105271,1.0,0,0.0,2018,2018.csv
8928,Captain Sabertooth 2006 Re-release,105152,105152,1.0,0,0.0,2006,2006.csv
8929,Guerrilla: The Taking of Patty Hearst,105054,105054,1.0,0,0.0,2004,2004.csv
8930,Cold Case Hammarskjöld,104965,104965,1.0,0,0.0,2019,2019.csv
8931,The Girl,104883,104883,1.0,0,0.0,2001,2001.csv
8932,Another Gay Sequel: Gays Gone Wild!,104828,104828,1.0,0,0.0,2008,2008.csv
8933,A Ciambra,104808,41934,0.4001030455690405,62874,0.5998969544309595,2017,2017.csv
8934,Dictator,104734,104734,1.0,0,0.0,2016,2016.csv
8935,Mr. Untouchable,104678,104678,1.0,0,0.0,2007,2007.csv
8936,Band Baaja Baaraat,104532,43820,0.4192017755328512,60712,0.5807982244671488,2010,2010.csv
8937,Alien Trespass,104526,104526,1.0,0,0.0,2009,2009.csv
8938,Results,104507,104507,1.0,0,0.0,2015,2015.csv
8939,Big Bad Love,104294,104294,1.0,0,0.0,2002,2002.csv
8940,Human Traffic,104257,104257,1.0,0,0.0,2000,2000.csv
8941,XX/XY,104130,104130,1.0,0,0.0,2003,2003.csv
8942,2 or 3 Things I Know About Her,104038,104038,1.0,0,0.0,2006,2006.csv
8943,Demon,104038,104038,1.0,0,0.0,2016,2016.csv
8944,Lola,103951,103951,1.0,0,0.0,2001,2001.csv
8945,World Traveler,103863,103863,1.0,0,0.0,2002,2002.csv
8946,The Investigator,103739,103739,1.0,0,0.0,2013,2013.csv
8947,The Real Dirt on Farmer John,103714,65429,0.6308598646277263,38285,0.36914013537227375,2006,2006.csv
8948,30 Years to Life,103540,103540,1.0,0,0.0,2002,2002.csv
8949,Stevie,103401,103401,1.0,0,0.0,2003,2003.csv
8950,Rolling,103318,103318,1.0,0,0.0,2009,2009.csv
8951,Stevie Nicks: In Your Dreams,103028,103028,1.0,0,0.0,2013,2013.csv
8952,Al Franken: God Spoke,102990,102990,1.0,0,0.0,2006,2006.csv
8953,Puerto Ricans in Paris,102890,102890,1.0,0,0.0,2016,2016.csv
8954,Brake,102819,4876,0.047423141637246036,97943,0.952576858362754,2012,2012.csv
8955,Islander,102737,102737,1.0,0,0.0,2007,2007.csv
8956,Mini's First Time,102676,49034,0.4775604815146675,53642,0.5224395184853325,2006,2006.csv
8957,Pure,102471,102471,1.0,0,0.0,2005,2005.csv
8958,The Gracefield Incident,102256,0,0.0,102256,1.0,2017,2017.csv
8959,Tanna,102225,46654,0.45638542430912205,55571,0.543614575690878,2016,2016.csv
8960,Return with Honor: A Missionary Homecoming,102171,102171,1.0,0,0.0,2007,2007.csv
8961,Civic Duty,102070,95953,0.9400705398256098,6117,0.059929460174390124,2007,2007.csv
8962,Andrei Rublev 2018 Re-release,102021,102021,1.0,0,0.0,2018,2018.csv
8963,Becoming Traviata,102015,62652,0.6141449786796059,39363,0.38585502132039406,2013,2013.csv
8964,Lucky Grandma,102000,102000,1.0,0,0.0,2020,2020.csv
8965,Tower,101987,101987,1.0,0,0.0,2016,2016.csv
8966,In the Family,101934,101934,1.0,0,0.0,2011,2011.csv
8967,Québec sur ordonnance,101896,101896,1.0,0,0.0,2007,2007.csv
8968,Hotel by the River,101879,28354,0.2783105448620422,73525,0.7216894551379578,2019,2019.csv
8969,Cracks,101860,29683,0.29140977812684077,72177,0.7085902218731592,2009,2009.csv
8970,Kill Me Three Times,101807,24296,0.23864763719587062,77511,0.7613523628041294,2015,2015.csv
8971,Magnus,101739,8944,0.08791122381780832,92795,0.9120887761821916,2016,2016.csv
8972,Those Who Remained,101737,0,0.0,101737,1.0,2019,2019.csv
8973,Rubber,101729,100370,0.9866409774990416,1359,0.01335902250095843,2011,2011.csv
8974,Kickboxer: Retaliation,101690,4537,0.044615989772839024,97153,0.955384010227161,2018,2018.csv
8975,QT8: The First Eight,101616,51896,0.5107069752794835,49720,0.48929302472051645,2019,2019.csv
8976,A Lego Brickumentary,101531,101531,1.0,0,0.0,2015,2015.csv
8977,Blazing Saddles 2013 Re-release,101481,101481,1.0,0,0.0,2013,2013.csv
8978,Man from Reno,101438,101438,1.0,0,0.0,2015,2015.csv
8979,James White,101368,101368,1.0,0,0.0,2015,2015.csv
8980,Emerald Cowboy,101358,101358,1.0,0,0.0,2003,2003.csv
8981,Korengal,101310,101310,1.0,0,0.0,2014,2014.csv
8982,The House of the Devil,101215,101215,1.0,0,0.0,2009,2009.csv
8983,Feed the Fish,101170,101170,1.0,0,0.0,2010,2010.csv
8984,Beyond Sight: The Derek Rabelo Story,101074,101074,1.0,0,0.0,2014,2014.csv
8985,First Cow,101068,101068,1.0,0,0.0,2020,2020.csv
8986,Dum,101000,101000,1.0,0,0.0,2003,2003.csv
8987,Khauff,100975,100975,1.0,0,0.0,2000,2000.csv
8988,The Good Guy,100688,100688,1.0,0,0.0,2010,2010.csv
8989,A Woman Is a Woman,100665,100665,1.0,0,0.0,2003,2003.csv
8990,Self Medicated,100610,100610,1.0,0,0.0,2007,2007.csv
8991,Sade,100544,100544,1.0,0,0.0,2002,2002.csv
8992,The Man Who Fell to Earth,100468,100072,0.996058446470518,396,0.003941553529482024,2011,2011.csv
8993,Roman Polanski: Wanted and Desired,100458,59192,0.5892213661430648,41266,0.41077863385693525,2008,2008.csv
8994,The United States of Autism,100403,100403,1.0,0,0.0,2013,2013.csv
8995,One Track Heart: The Story of Krishna Das,100401,100401,1.0,0,0.0,2013,2013.csv
8996,All About Nina,100335,100335,1.0,0,0.0,2018,2018.csv
8997,8: The Mormon Proposition,100280,100280,1.0,0,0.0,2010,2010.csv
8998,Rejoice and Shout,100237,100237,1.0,0,0.0,2011,2011.csv
8999,Bhutto,100202,100202,1.0,0,0.0,2010,2010.csv
9000,Being Cyrus,100184,100184,1.0,0,0.0,2006,2006.csv
9001,Fighter,99938,99938,1.0,0,0.0,2001,2001.csv
9002,Yves Saint Laurent: His Life and Times,99819,99819,1.0,0,0.0,2004,2004.csv
9003,White Lion,99635,0,0.0,99635,1.0,2010,2010.csv
9004,Heavy Water,99503,55446,0.5572294302684341,44057,0.44277056973156587,2019,2019.csv
9005,Meow Wolf: Origin Story,99488,99488,1.0,0,0.0,2018,2018.csv
9006,Kings of the Evening,99270,99270,1.0,0,0.0,2010,2010.csv
9007,Carnage,99049,60158,0.6073559551333179,38891,0.39264404486668214,2002,2002.csv
9008,Cemetery of Splendor,98932,51950,0.5251081550964298,46982,0.4748918449035701,2015,2015.csv
9009,Absolute Wilson,98730,66217,0.6706877342246531,32513,0.3293122657753469,2006,2006.csv
9010,Handcart,98666,98666,1.0,0,0.0,2002,2002.csv
9011,Under Our Skin,98548,98548,1.0,0,0.0,2009,2009.csv
9012,High Strung Free Dance 2019 Re-release,98481,83891,0.8518495953534184,14590,0.14815040464658158,2019,2019.csv
9013,Aida's Secrets,98468,98468,1.0,0,0.0,2017,2017.csv
9014,Reign of Judges: Title of Liberty - Concept Short,98408,93224,0.9473213559873181,5184,0.052678644012681894,2018,2018.csv
9015,Purple Noon,98311,0,0.0,98311,1.0,2008,2008.csv
9016,Blind,98280,12522,0.1274114774114774,85758,0.8725885225885226,2017,2017.csv
9017,Charlie Says,98240,40685,0.41413884364820847,57555,0.5858611563517915,2019,2019.csv
9018,The Red Balloon / White Mane,97959,69139,0.7057952816994865,28820,0.2942047183005135,2007,2007.csv
9019,National Theatre Live: Macbeth,97857,97857,1.0,0,0.0,2018,2018.csv
9020,Red Doors,97848,97848,1.0,0,0.0,2006,2006.csv
9021,"Tim Timmerman, Hope of America",97727,97727,1.0,0,0.0,2017,2017.csv
9022,The Here After,97699,0,0.0,97699,1.0,2015,2015.csv
9023,On Guard,97552,97552,1.0,0,0.0,2002,2002.csv
9024,The Last Winter,97522,33190,0.3403334632185558,64332,0.6596665367814442,2007,2007.csv
9025,D.E.B.S.,97446,97446,1.0,0,0.0,2005,2005.csv
9026,Aileen: Life and Death of a Serial Killer,97362,97362,1.0,0,0.0,2004,2004.csv
9027,Everybody's Famous!,97353,81734,0.8395632389345988,15619,0.16043676106540117,2001,2001.csv
9028,In Bloom,97236,56092,0.5768645357686454,41144,0.4231354642313546,2013,2013.csv
9029,Difret,97205,49667,0.5109510827632323,47538,0.48904891723676763,2015,2015.csv
9030,Prassthanam,97204,19984,0.20558824739722645,77220,0.7944117526027735,2019,2019.csv
9031,A Field in England,97195,32846,0.3379391944030043,64349,0.6620608055969958,2013,2013.csv
9032,Little Monsters,97111,0,0.0,97111,1.0,2019,2019.csv
9033,Kisses 2010 Re-release,96933,81680,0.8426438880463826,15253,0.15735611195361746,2010,2010.csv
9034,A Little Help,96868,96868,1.0,0,0.0,2011,2011.csv
9035,Leviathan,96778,76202,0.7873896960052904,20576,0.21261030399470954,2013,2013.csv
9036,Singin' in the Rain 2013 Re-release,96763,96763,1.0,0,0.0,2013,2013.csv
9037,Hardflip,96734,96734,1.0,0,0.0,2012,2012.csv
9038,Sunshine Superman,96715,88097,0.9108928294473453,8618,0.08910717055265471,2015,2015.csv
9039,Godspeed: The Race Across America,96690,96690,1.0,0,0.0,2018,2018.csv
9040,Kabluey,96663,83506,0.8638879405770564,13157,0.13611205942294363,2008,2008.csv
9041,Paragraph 175,96630,96630,1.0,0,0.0,2000,2000.csv
9042,A Poem Is a Naked Person,96592,96592,1.0,0,0.0,2015,2015.csv
9043,Dina,96524,90503,0.9376217313828685,6021,0.06237826861713149,2017,2017.csv
9044,Louise Bourgeois,96443,95865,0.9940068226828283,578,0.005993177317171801,2008,2008.csv
9045,Hiroshima Mon Amour 2014 Re-release,96439,96439,1.0,0,0.0,2014,2014.csv
9046,Greetings from the Shore,96314,96314,1.0,0,0.0,2008,2008.csv
9047,Autumn Spring 2003 Re-release,96269,96269,1.0,0,0.0,2003,2003.csv
9048,Saint Judy,96212,78935,0.8204278052633767,17277,0.17957219473662328,2019,2019.csv
9049,My Reincarnation,96115,92822,0.9657389585392498,3293,0.034261041460750145,2011,2011.csv
9050,The Holy Mountain,95858,61001,0.6363683782261261,34857,0.36363162177387387,2007,2007.csv
9051,A Bigger Splash 2019 Re-release,95826,95826,1.0,0,0.0,2019,2019.csv
9052,Saand Ki Aankh,95724,0,0.0,95724,1.0,2019,2019.csv
9053,Ardor,95549,18565,0.19429821348208773,76984,0.8057017865179122,2014,2014.csv
9054,The Lovers & the Despot,95521,55511,0.5811392259293768,40010,0.4188607740706232,2016,2016.csv
9055,Kehtaa Hai Dil Baar Baar,95415,95415,1.0,0,0.0,2002,2002.csv
9056,Classe Tous Risques,95413,95413,1.0,0,0.0,2005,2005.csv
9057,Code Unknown,95242,95242,1.0,0,0.0,2001,2001.csv
9058,The Final Wish,95215,25183,0.26448563776715855,70032,0.7355143622328415,2019,2019.csv
9059,Made in U.S.A,95209,95209,1.0,0,0.0,2009,2009.csv
9060,The Night Eats the World,95208,0,0.0,95208,1.0,2018,2018.csv
9061,Queen of Earth,95183,91218,0.958343401657859,3965,0.04165659834214093,2015,2015.csv
9062,The Pool,95102,95102,1.0,0,0.0,2008,2008.csv
9063,Saala Khadoos,94787,76931,0.8116197368837499,17856,0.1883802631162501,2016,2016.csv
9064,Bicycle Thieves 2008 Re-release,94685,36818,0.38884723028990864,57867,0.6111527697100914,2008,2008.csv
9065,The Hebrew Hammer,94615,82157,0.8683295460550653,12458,0.13167045394493473,2003,2003.csv
9066,Jin-Roh: The Wolf Brigade,94591,94591,1.0,0,0.0,2001,2001.csv
9067,The Fight Within,94326,94326,1.0,0,0.0,2016,2016.csv
9068,Papi Chulo,94321,84703,0.8980290709386033,9618,0.10197092906139672,2019,2019.csv
9069,Keep Watching,94178,94178,1.0,0,0.0,2017,2017.csv
9070,Escaflowne: The Movie,94060,94060,1.0,0,0.0,2002,2002.csv
9071,Blue Caprice,93995,93995,1.0,0,0.0,2013,2013.csv
9072,Let the Corpses Tan,93409,93409,1.0,0,0.0,2018,2018.csv
9073,Flavors,93370,93370,1.0,0,0.0,2004,2004.csv
9074,First Lady,93298,93298,1.0,0,0.0,2020,2020.csv
9075,Will You Still Love Me Tomorrow?,93046,6694,0.07194290995851514,86352,0.9280570900414848,2013,2013.csv
9076,Celsius 41.11: The Temperature at Which the Brain... Begins to Die,93000,93000,1.0,0,0.0,2004,2004.csv
9077,Vamps,92748,3361,0.03623797817742701,89387,0.963762021822573,2012,2012.csv
9078,Haiku Tunnel,92723,92723,1.0,0,0.0,2001,2001.csv
9079,The First Time,92654,22836,0.24646534418373733,69818,0.7535346558162627,2012,2012.csv
9080,Miss Juneteenth,92349,92349,1.0,0,0.0,2020,2020.csv
9081,American: The Bill Hicks Story,92234,92234,1.0,0,0.0,2011,2011.csv
9082,Somersault 2006 Re-release,92214,92214,1.0,0,0.0,2006,2006.csv
9083,Into the Forest,92166,9995,0.10844563070980621,82171,0.8915543692901938,2016,2016.csv
9084,Beowulf & Grendel,92076,68820,0.7474260393587906,23256,0.25257396064120946,2006,2006.csv
9085,Nancy,92000,80115,0.8708152173913043,11885,0.12918478260869565,2018,2018.csv
9086,My Führer 2009 Re-release,91995,2465,0.02679493450731018,89530,0.9732050654926898,2009,2009.csv
9087,Generation War,91595,91595,1.0,0,0.0,2014,2014.csv
9088,Legends from the Sky,91462,91462,1.0,0,0.0,2015,2015.csv
9089,Other People,91441,91441,1.0,0,0.0,2016,2016.csv
9090,Evil Bong 3: The Wrath of Bong,91260,91260,1.0,0,0.0,2011,2011.csv
9091,Morris from America,91151,91151,1.0,0,0.0,2016,2016.csv
9092,A Kind of Murder,91149,2915,0.03198060318818638,88234,0.9680193968118136,2016,2016.csv
9093,Mapplethorpe,91002,91002,1.0,0,0.0,2019,2019.csv
9094,BANDSTAND: The Broadway Musical on Screen 2018 Re-release,91000,91000,1.0,0,0.0,2018,2018.csv
9095,Undead 2005 Re-release,90928,41196,0.45306176315326413,49732,0.5469382368467359,2005,2005.csv
9096,Because of Grácia,90878,90878,1.0,0,0.0,2017,2017.csv
9097,Ek Khiladi Ek Haseena,90869,90869,1.0,0,0.0,2005,2005.csv
9098,Porto,90849,15126,0.16649605389162236,75723,0.8335039461083776,2017,2017.csv
9099,Heroic Antics,90785,63649,0.7010959960345872,27136,0.2989040039654128,2014,2014.csv
9100,Beasts of No Nation,90777,90777,1.0,0,0.0,2015,2015.csv
9101,Yuri!!! On Ice,90751,81878,0.902226972705535,8873,0.09777302729446508,2018,2018.csv
9102,Loopers: The Caddie's Long Walk,90679,90679,1.0,0,0.0,2019,2019.csv
9103,Moonwalkers,90646,0,0.0,90646,1.0,2016,2016.csv
9104,The Good Neighbor,90573,0,0.0,90573,1.0,2016,2016.csv
9105,Irresistible,90557,0,0.0,90557,1.0,2020,2020.csv
9106,Fireworks Wednesday 2016 Re-release,90519,90519,1.0,0,0.0,2016,2016.csv
9107,Minding the Gap,90328,11998,0.1328270303781773,78330,0.8671729696218227,2018,2018.csv
9108,The Unforeseen,90287,90287,1.0,0,0.0,2008,2008.csv
9109,Adrift in Manhattan,90272,2099,0.023251949663239985,88173,0.97674805033676,2007,2007.csv
9110,Dark Horse,90136,90136,1.0,0,0.0,2015,2015.csv
9111,King's Faith,90106,90106,1.0,0,0.0,2013,2013.csv
9112,Pray the Devil Back to Hell,90066,90066,1.0,0,0.0,2008,2008.csv
9113,Running for Grace,89988,89988,1.0,0,0.0,2018,2018.csv
9114,Pump,89787,89787,1.0,0,0.0,2014,2014.csv
9115,Eulogy,89781,75076,0.8362125616778606,14705,0.16378743832213943,2004,2004.csv
9116,The Principle,89543,89543,1.0,0,0.0,2014,2014.csv
9117,Throw Down Your Heart,89521,89521,1.0,0,0.0,2009,2009.csv
9118,Oy Vey! My Son Is Gay!!,89507,89507,1.0,0,0.0,2010,2010.csv
9119,Mystery Team,89442,89442,1.0,0,0.0,2009,2009.csv
9120,Somebody Up There Likes Me,89435,89435,1.0,0,0.0,2013,2013.csv
9121,Cat on a Hot Tin Roof,89332,89332,1.0,0,0.0,2018,2018.csv
9122,Salvation Boulevard,89182,28468,0.31921239712049515,60714,0.6807876028795048,2011,2011.csv
9123,Night of the Living Dead,89029,89029,1.0,0,0.0,2017,2017.csv
9124,This Is Not a Film,88758,77016,0.8677076995876428,11742,0.1322923004123572,2012,2012.csv
9125,Never Rarely Sometimes Always,88716,16565,0.18671941927048108,72151,0.8132805807295189,2020,2020.csv
9126,Anthony Kaun Hai?,88420,55418,0.6267586518887129,33002,0.37324134811128706,2006,2006.csv
9127,The Lumber Baron,88336,88336,1.0,0,0.0,2019,2019.csv
9128,Crazy on the Outside,88335,88335,1.0,0,0.0,2010,2010.csv
9129,Jewtopia,88327,46437,0.5257395813284726,41890,0.4742604186715274,2013,2013.csv
9130,Pete Seeger: The Power of Song,88312,88312,1.0,0,0.0,2007,2007.csv
9131,Money for Nothing: Inside the Federal Reserve,88045,88045,1.0,0,0.0,2013,2013.csv
9132,Jim Allison: Breakthrough,87984,87984,1.0,0,0.0,2019,2019.csv
9133,Little Chenier,87939,87939,1.0,0,0.0,2008,2008.csv
9134,Seeing Other People,87923,87923,1.0,0,0.0,2004,2004.csv
9135,Hyena Road,87768,1430,0.01629295415185489,86338,0.9837070458481451,2015,2015.csv
9136,The Cartel,87763,87763,1.0,0,0.0,2010,2010.csv
9137,Ocean Waves,87738,87738,1.0,0,0.0,2016,2016.csv
9138,Glory,87728,18415,0.2099101769104505,69313,0.7900898230895496,2017,2017.csv
9139,Exporting Raymond,87727,87727,1.0,0,0.0,2011,2011.csv
9140,Author: The JT LeRoy Story,87686,85999,0.9807608968364391,1687,0.019239103163560888,2016,2016.csv
9141,Goldstone 2018 Re-release,87639,87639,1.0,0,0.0,2018,2018.csv
9142,Woman on the Beach 2008 Re-release,87635,23686,0.27028013921378446,63949,0.7297198607862155,2008,2008.csv
9143,Pulse 2005 Re-release,87420,51420,0.5881949210706932,36000,0.4118050789293068,2005,2005.csv
9144,America: Freedom to Fascism,87400,87400,1.0,0,0.0,2006,2006.csv
9145,Borstal Boy,87400,87400,1.0,0,0.0,2002,2002.csv
9146,First Morning,87264,87264,1.0,0,0.0,2005,2005.csv
9147,To Fall in Love,87000,87000,1.0,0,0.0,2000,2000.csv
9148,The Zodiac,86872,45148,0.5197071553550051,41724,0.48029284464499494,2006,2006.csv
9149,War Photographer,86863,61040,0.7027157708115078,25823,0.29728422918849223,2002,2002.csv
9150,ECCO,86858,86858,1.0,0,0.0,2019,2019.csv
9151,Singularity,86822,4176,0.04809840823754348,82646,0.9519015917624565,2017,2017.csv
9152,Vault,86741,29491,0.3399891631408446,57250,0.6600108368591554,2019,2019.csv
9153,Gueros,86736,60114,0.6930686220254566,26622,0.30693137797454345,2015,2015.csv
9154,School Life,86616,37381,0.4315715341276439,49235,0.5684284658723562,2017,2017.csv
9155,Beuys,86451,65410,0.7566135730066743,21041,0.2433864269933257,2018,2018.csv
9156,"My Love, Don't Cross That River 2016 Re-release",86446,86446,1.0,0,0.0,2016,2016.csv
9157,Prey for Rock & Roll,86277,58040,0.6727169465790419,28237,0.3272830534209581,2003,2003.csv
9158,Crazy Wisdom: The Life & Times of Chogyam Trungpa Rinpoche,86202,86202,1.0,0,0.0,2011,2011.csv
9159,Rapt 2011 Re-release,86028,45759,0.5319082159296973,40269,0.4680917840703027,2011,2011.csv
9160,Bay of Angels,85840,85840,1.0,0,0.0,2001,2001.csv
9161,Tab Hunter Confidential,85812,85812,1.0,0,0.0,2015,2015.csv
9162,Color of the Cross,85802,85802,1.0,0,0.0,2006,2006.csv
9163,Where's the Party Yaar?,85739,85739,1.0,0,0.0,2003,2003.csv
9164,Jackals,85410,0,0.0,85410,1.0,2017,2017.csv
9165,Deal,85076,61626,0.72436409798298,23450,0.2756359020170201,2008,2008.csv
9166,The Good Old Naughty Days,85006,60862,0.7159729901418723,24144,0.2840270098581277,2002,2002.csv
9167,Skid Row Marathon,84997,84997,1.0,0,0.0,2019,2019.csv
9168,Three... Extremes 2005 Re-release,84976,77532,0.9123987949538693,7444,0.08760120504613067,2005,2005.csv
9169,Waking Sleeping Beauty,84918,80741,0.9508113709696413,4177,0.0491886290303587,2010,2010.csv
9170,Ran 2016 Re-release,84789,66097,0.779546875184281,18692,0.22045312481571902,2016,2016.csv
9171,Decoys,84733,84733,1.0,0,0.0,2004,2004.csv
9172,Live Nude Girls Unite!,84706,84706,1.0,0,0.0,2000,2000.csv
9173,51 Birch Street,84689,84689,1.0,0,0.0,2006,2006.csv
9174,Wretches & Jabberers,84610,84610,1.0,0,0.0,2011,2011.csv
9175,Visitors,84577,84577,1.0,0,0.0,2014,2014.csv
9176,Mozart and the Whale,84447,36006,0.4263739386834346,48441,0.5736260613165655,2006,2006.csv
9177,Woodstock,84440,84440,1.0,0,0.0,2019,2019.csv
9178,Brothers of the Head,84425,45082,0.5339887474089429,39343,0.46601125259105713,2006,2006.csv
9179,Heaven Knows What,84417,80734,0.9563713470035656,3683,0.04362865299643437,2015,2015.csv
9180,The Diabolical,84259,0,0.0,84259,1.0,2015,2015.csv
9181,Chapter & Verse,84147,84147,1.0,0,0.0,2017,2017.csv
9182,"Me & You, Us, Forever",84093,84093,1.0,0,0.0,2008,2008.csv
9183,Los Sures,83992,83992,1.0,0,0.0,2016,2016.csv
9184,The Disappearance of My Mother,83930,24951,0.29728345049445964,58979,0.7027165495055403,2019,2019.csv
9185,"Nico, 1988",83558,73304,0.8772828454486704,10254,0.12271715455132962,2018,2018.csv
9186,He Was a Quiet Man,83440,2431,0.02913470757430489,81009,0.9708652924256951,2007,2007.csv
9187,Barely Legal,83439,26511,0.3177291194765038,56928,0.6822708805234962,2005,2005.csv
9188,Save Me,83397,83397,1.0,0,0.0,2008,2008.csv
9189,ABCD,83372,83372,1.0,0,0.0,2001,2001.csv
9190,The Treatment,83354,83354,1.0,0,0.0,2007,2007.csv
9191,Z,83305,83305,1.0,0,0.0,2009,2009.csv
9192,Maria Stuarda at La Scala,83214,83214,1.0,0,0.0,2008,2008.csv
9193,The Look,83137,19988,0.2404224352574666,63149,0.7595775647425335,2011,2011.csv
9194,The Kindness of Strangers,83042,2705,0.032573878278461504,80337,0.9674261217215385,2019,2019.csv
9195,Hateship Loveship,83008,54030,0.6509011179645335,28978,0.34909888203546646,2014,2014.csv
9196,Le Doulos,82772,82772,1.0,0,0.0,2007,2007.csv
9197,Alien Abduction,82725,12897,0.15590208522212148,69828,0.8440979147778785,2014,2014.csv
9198,Doctor Who: The Woman Who Fell to Earth,82698,82698,1.0,0,0.0,2018,2018.csv
9199,12 O'Clock Boys,82614,82614,1.0,0,0.0,2014,2014.csv
9200,Praying with Lior,82553,82553,1.0,0,0.0,2008,2008.csv
9201,Funny Ha Ha,82528,77070,0.9338648701046918,5458,0.06613512989530826,2005,2005.csv
9202,V/H/S Viral,82409,2756,0.033442949192442575,79653,0.9665570508075574,2014,2014.csv
9203,The Treasure,82392,50203,0.6093188659093116,32189,0.39068113409068844,2016,2016.csv
9204,Better Living Through Circuitry,82378,82378,1.0,0,0.0,2000,2000.csv
9205,Humboldt County,82357,82357,1.0,0,0.0,2008,2008.csv
9206,Water & Power,82312,82312,1.0,0,0.0,2014,2014.csv
9207,Prey,82258,0,0.0,82258,1.0,2019,2019.csv
9208,Careful What You Wish For,82230,0,0.0,82230,1.0,2015,2015.csv
9209,The Whale,81881,81881,1.0,0,0.0,2011,2011.csv
9210,Bhavesh Joshi Superhero,81792,57376,0.7014866979655712,24416,0.2985133020344288,2018,2018.csv
9211,Best Man in Grass Creek,81760,81760,1.0,0,0.0,2001,2001.csv
9212,King Cobra,81757,81757,1.0,0,0.0,2016,2016.csv
9213,Inkubus,81600,81600,1.0,0,0.0,2011,2011.csv
9214,'R Xmas,81476,850,0.010432520005891305,80626,0.9895674799941087,2001,2001.csv
9215,Anything But Love,81451,81451,1.0,0,0.0,2003,2003.csv
9216,A State of Mind,81450,41468,0.509122160834868,39982,0.490877839165132,2005,2005.csv
9217,Hating Breitbart,81432,81432,1.0,0,0.0,2012,2012.csv
9218,The Girl in the Book,81379,8245,0.10131606434092333,73134,0.8986839356590767,2015,2015.csv
9219,The Future of Food,81280,81280,1.0,0,0.0,2005,2005.csv
9220,Patti Smith: Dream of Life,81113,30918,0.3811719453108626,50195,0.6188280546891374,2008,2008.csv
9221,Yomeddine,81030,11308,0.139553251882019,69722,0.8604467481179809,2018,2018.csv
9222,The Island President,80996,76398,0.9432317645315818,4598,0.05676823546841819,2012,2012.csv
9223,Burning Bush,80943,16731,0.2067010118231348,64212,0.7932989881768652,2013,2013.csv
9224,Woman Walks Ahead,80912,57528,0.7109946608661262,23384,0.28900533913387383,2018,2018.csv
9225,Brother to Brother,80906,80906,1.0,0,0.0,2004,2004.csv
9226,The Big Blue 2000 Director's Cut,80882,80882,1.0,0,0.0,2000,2000.csv
9227,Taur Mittran Di,80879,69510,0.8594319909988996,11369,0.14056800900110042,2012,2012.csv
9228,Chrystal,80858,80858,1.0,0,0.0,2005,2005.csv
9229,Kind Hearts and Coronets 2019 Re-release,80795,35948,0.444928522804629,44847,0.555071477195371,2019,2019.csv
9230,Nasty Baby,80772,79800,0.98796612687565,972,0.012033873124350022,2015,2015.csv
9231,Trace Amounts,80735,80735,1.0,0,0.0,2015,2015.csv
9232,Batman Returns 2019 Re-release,80699,70642,0.8753763987162171,10057,0.12462360128378294,2019,2019.csv
9233,Ms. Purple,80657,80657,1.0,0,0.0,2019,2019.csv
9234,Enemies of the People,80654,73171,0.9072209685818434,7483,0.09277903141815658,2010,2010.csv
9235,Winnie Mandela,80634,80634,1.0,0,0.0,2013,2013.csv
9236,Always Kabhi Kabhi,80546,21381,0.26545079830159163,59165,0.7345492016984083,2011,2011.csv
9237,Il trittico dell'amore,80374,80374,1.0,0,0.0,2008,2008.csv
9238,Ginger Snaps 2: Unleashed,80372,80372,1.0,0,0.0,2004,2004.csv
9239,Free Radicals,80371,1443,0.017954237224869666,78928,0.9820457627751303,2003,2003.csv
9240,Songs from the Second Floor,80334,80334,1.0,0,0.0,2001,2001.csv
9241,The Mysteries of Pittsburgh,80283,80283,1.0,0,0.0,2009,2009.csv
9242,Armstrong,80169,19740,0.24622983946413202,60429,0.753770160535868,2019,2019.csv
9243,For the Love of Spock,80141,80141,1.0,0,0.0,2016,2016.csv
9244,Mannat,80119,53589,0.6688675595052359,26530,0.33113244049476404,2006,2006.csv
9245,Inhale,80112,4115,0.051365588176552825,75997,0.9486344118234472,2010,2010.csv
9246,Ramaiya Vastavaiya,80108,80108,1.0,0,0.0,2013,2013.csv
9247,Jack Paradise (Les nuits de Montréal),79974,79974,1.0,0,0.0,2004,2004.csv
9248,Searching for the Wrong-Eyed Jesus,79916,79916,1.0,0,0.0,2005,2005.csv
9249,En el séptimo día,79887,79887,1.0,0,0.0,2018,2018.csv
9250,Air Guitar Nation,79770,71471,0.8959633947599348,8299,0.1040366052400652,2007,2007.csv
9251,Made-Up,79766,79766,1.0,0,0.0,2003,2003.csv
9252,"Sobibór, October 14, 1943, 4 p.m.",79728,41040,0.5147501505117399,38688,0.4852498494882601,2001,2001.csv
9253,Ballast,79710,77556,0.9729770417764396,2154,0.027022958223560406,2008,2008.csv
9254,Aurangzeb,79665,0,0.0,79665,1.0,2013,2013.csv
9255,Harvest of Empire,79627,79627,1.0,0,0.0,2012,2012.csv
9256,Camp X-Ray,79624,13302,0.16706018285943935,66322,0.8329398171405606,2014,2014.csv
9257,End of the Century,79607,66309,0.832954388433178,13298,0.16704561156682202,2019,2019.csv
9258,Suits on the Loose,79470,79470,1.0,0,0.0,2006,2006.csv
9259,Cover,79436,79436,1.0,0,0.0,2008,2008.csv
9260,Jayne Mansfield's Car,79178,14836,0.18737528101240244,64342,0.8126247189875976,2013,2013.csv
9261,Concussion,78957,42606,0.5396101675595577,36351,0.4603898324404423,2013,2013.csv
9262,Fort McCoy,78948,78948,1.0,0,0.0,2014,2014.csv
9263,Radiant City,78944,78944,1.0,0,0.0,2007,2007.csv
9264,Christ Stopped at Eboli,78736,78736,1.0,0,0.0,2019,2019.csv
9265,The Boxcar Children - Surprise Island,78676,78676,1.0,0,0.0,2018,2018.csv
9266,Blackbird,78400,78400,1.0,0,0.0,2015,2015.csv
9267,Harold and Lillian: A Hollywood Love Story,78301,78301,1.0,0,0.0,2017,2017.csv
9268,Colliding Dreams,78288,78288,1.0,0,0.0,2016,2016.csv
9269,Anesthesia,78270,32163,0.41092372556535073,46107,0.5890762744346493,2016,2016.csv
9270,Un traductor,78075,13509,0.17302593659942364,64566,0.8269740634005763,2018,2018.csv
9271,Jodi Breakers,78024,52618,0.6743822413616323,25406,0.32561775863836767,2012,2012.csv
9272,Ping Pong Playa,77907,77907,1.0,0,0.0,2008,2008.csv
9273,Bright Leaves,77888,77888,1.0,0,0.0,2004,2004.csv
9274,Baraka 2002 Re-release,77873,77873,1.0,0,0.0,2002,2002.csv
9275,Table No. 21,77621,46720,0.6018989706393888,30901,0.39810102936061115,2013,2013.csv
9276,Chevalier,77590,25696,0.3311766980280964,51894,0.6688233019719036,2015,2015.csv
9277,The Princess Blade,77567,77567,1.0,0,0.0,2003,2003.csv
9278,Circo,77466,77466,1.0,0,0.0,2011,2011.csv
9279,The Art of the Steal,77450,64065,0.8271788250484183,13385,0.17282117495158167,2014,2014.csv
9280,Finding Amanda,77410,57297,0.7401756878956207,20113,0.2598243121043793,2008,2008.csv
9281,Breaking Upwards,77389,77389,1.0,0,0.0,2010,2010.csv
9282,The Sun 2009 Re-release,77303,77303,1.0,0,0.0,2009,2009.csv
9283,To Catch a Dollar: Muhammad Yunus Banks on America,77142,77142,1.0,0,0.0,2011,2011.csv
9284,Parchi,77110,69431,0.9004149915704838,7679,0.09958500842951627,2018,2018.csv
9285,The Missing Picture,76933,52164,0.6780445322553391,24769,0.32195546774466094,2014,2014.csv
9286,Fast Colour,76916,76916,1.0,0,0.0,2019,2019.csv
9287,How the West Was Won 2003 Re-release,76729,76729,1.0,0,0.0,2003,2003.csv
9288,Eisenstein in Guanajuato 2015 Re-release,76713,34282,0.4468864468864469,42431,0.5531135531135531,2015,2015.csv
9289,Mademoiselle C,76621,48668,0.6351783453622375,27953,0.3648216546377625,2013,2013.csv
9290,Blue Moon,76544,76544,1.0,0,0.0,2000,2000.csv
9291,The New Rijksmuseum - The Film,76460,40578,0.5307088673816375,35882,0.4692911326183625,2015,2015.csv
9292,Steal This Movie,76424,76424,1.0,0,0.0,2000,2000.csv
9293,Swimming Upstream 2004 Re-release,76287,54965,0.7205028379671503,21322,0.27949716203284963,2004,2004.csv
9294,Night Catches Us,76185,76185,1.0,0,0.0,2010,2010.csv
9295,America the Beautiful,76173,76173,1.0,0,0.0,2008,2008.csv
9296,Don't Blink,76134,76134,1.0,0,0.0,2016,2016.csv
9297,93Queen,76056,76056,1.0,0,0.0,2018,2018.csv
9298,Greener Grass,76045,51456,0.6766519823788546,24589,0.3233480176211454,2019,2019.csv
9299,Whitey: United States of America v. James J. Bulger,75881,75881,1.0,0,0.0,2014,2014.csv
9300,Wish You Were Here 2013 Re-release,75870,46347,0.6108738631870304,29523,0.38912613681296954,2013,2013.csv
9301,Into the White 2013 Re-release,75747,704,0.009294097456004858,75043,0.9907059025439952,2013,2013.csv
9302,Touch Me Not,75507,13782,0.18252612340577695,61725,0.8174738765942231,2018,2018.csv
9303,The Riot Act,75506,75506,1.0,0,0.0,2018,2018.csv
9304,Swim Little Fish Swim,75504,3877,0.05134827293918203,71627,0.948651727060818,2014,2014.csv
9305,Hum To Mohabbat Karega,75446,75446,1.0,0,0.0,2000,2000.csv
9306,Tears of the Black Tiger 2007 Re-release,75234,75234,1.0,0,0.0,2007,2007.csv
9307,Restaurant,75232,75232,1.0,0,0.0,2000,2000.csv
9308,An Everlasting Piece,75228,75228,1.0,0,0.0,2000,2000.csv
9309,Widespread Panic: The Earth Will Swallow You,75204,75204,1.0,0,0.0,2002,2002.csv
9310,Bill Nye: Science Guy,74909,74909,1.0,0,0.0,2017,2017.csv
9311,Where Is Kyra?,74821,59717,0.7981315406102565,15104,0.20186845938974352,2018,2018.csv
9312,August Evening,74759,74759,1.0,0,0.0,2008,2008.csv
9313,The Ornithologist,74714,50511,0.6760580346387558,24203,0.3239419653612442,2016,2016.csv
9314,Above and Beyond: NASA's Journey to Tomorrow,74711,74711,1.0,0,0.0,2018,2018.csv
9315,Batkid Begins: The Wish Heard Around the World,74709,74709,1.0,0,0.0,2015,2015.csv
9316,The Monster,74700,12544,0.16792503346720214,62156,0.8320749665327979,2016,2016.csv
9317,The War Within,74655,74655,1.0,0,0.0,2005,2005.csv
9318,We Come as Friends,74633,50921,0.6822853161470127,23712,0.3177146838529873,2014,2014.csv
9319,The Nomi Song,74631,74631,1.0,0,0.0,2005,2005.csv
9320,Hadewijch,74586,5006,0.0671171533531762,69580,0.9328828466468237,2010,2010.csv
9321,Stations of the Cross,74509,1505,0.02019890214604947,73004,0.9798010978539505,2014,2014.csv
9322,Shoot Down,74421,74421,1.0,0,0.0,2008,2008.csv
9323,Reset,74341,5454,0.07336463055379938,68887,0.9266353694462006,2016,2016.csv
9324,Set Me Free,74052,74052,1.0,0,0.0,2000,2000.csv
9325,The Boy Downstairs,73988,13638,0.1843271881926799,60350,0.8156728118073201,2018,2018.csv
9326,The Keeping Room,73922,27166,0.3674954681962068,46756,0.6325045318037932,2015,2015.csv
9327,After Auschwitz,73885,73885,1.0,0,0.0,2018,2018.csv
9328,Love N' Dancing,73848,47812,0.6474379807171488,26036,0.35256201928285125,2009,2009.csv
9329,War Pigs,73701,0,0.0,73701,1.0,2015,2015.csv
9330,Wait for Your Laugh,73585,73585,1.0,0,0.0,2017,2017.csv
9331,Prodigal Sons,73544,73544,1.0,0,0.0,2010,2010.csv
9332,On the Ice,73492,73492,1.0,0,0.0,2012,2012.csv
9333,A Four Letter Word,73445,72568,0.9880590918374293,877,0.01194090816257063,2008,2008.csv
9334,Primal Rage: The Legend of Konga,73383,21497,0.2929425071201777,51886,0.7070574928798223,2018,2018.csv
9335,Father and Son,73351,39291,0.5356573189186241,34060,0.46434268108137583,2004,2004.csv
9336,Vengeance: A Love Story,73270,4526,0.06177152995769073,68744,0.9382284700423092,2017,2017.csv
9337,Te Ata,73236,73236,1.0,0,0.0,2017,2017.csv
9338,Antonio Lopez 1970: Sex Fashion & Disco,73122,43169,0.5903695194332759,29953,0.40963048056672413,2018,2018.csv
9339,Buster's Mal Heart,73121,73121,1.0,0,0.0,2017,2017.csv
9340,Headshot,73010,0,0.0,73010,1.0,2017,2017.csv
9341,5B,72968,72968,1.0,0,0.0,2019,2019.csv
9342,Come Away Home,72810,72810,1.0,0,0.0,2005,2005.csv
9343,Do Not Resist,72791,72791,1.0,0,0.0,2016,2016.csv
9344,The Seagull's Laughter,72527,72527,1.0,0,0.0,2004,2004.csv
9345,Unconscious,72275,68501,0.9477827741265998,3774,0.052217225873400205,2006,2006.csv
9346,Eye of the Dolphin,72260,72210,0.999308054248547,50,0.0006919457514530861,2007,2007.csv
9347,Dorian Blues,72234,72234,1.0,0,0.0,2005,2005.csv
9348,Loving Jezebel,72190,72190,1.0,0,0.0,2000,2000.csv
9349,The Green Wave,72152,0,0.0,72152,1.0,2011,2011.csv
9350,Partisan,72151,0,0.0,72151,1.0,2015,2015.csv
9351,After Tiller,72125,72125,1.0,0,0.0,2013,2013.csv
9352,Hollywood Buddha,72115,72115,1.0,0,0.0,2004,2004.csv
9353,Veil of Tears,72078,72078,1.0,0,0.0,2014,2014.csv
9354,Naked in Ashes,72073,72073,1.0,0,0.0,2005,2005.csv
9355,The Invisible War,71968,71968,1.0,0,0.0,2012,2012.csv
9356,The Chambermaid Lynn,71918,315,0.004379988320031147,71603,0.9956200116799688,2015,2015.csv
9357,Raiders!: The Story of the Greatest Fan Film Ever Made,71916,71916,1.0,0,0.0,2016,2016.csv
9358,Come and See 2020 Re-release,71909,71909,1.0,0,0.0,2020,2020.csv
9359,An Oversimplification of Her Beauty,71906,71906,1.0,0,0.0,2013,2013.csv
9360,Umberto D.,71816,71816,1.0,0,0.0,2002,2002.csv
9361,As I Lay Dying,71759,16697,0.23268161484970526,55062,0.7673183851502947,2013,2013.csv
9362,New Suit,71743,71743,1.0,0,0.0,2003,2003.csv
9363,Runaway Slave,71737,71737,1.0,0,0.0,2012,2012.csv
9364,Flamenco Flamenco 2014 Re-release,71732,71732,1.0,0,0.0,2014,2014.csv
9365,"Je t'aime, je t'aime 2014 Re-release",71717,71717,1.0,0,0.0,2014,2014.csv
9366,Body of War,71716,71716,1.0,0,0.0,2008,2008.csv
9367,The Dummy,71646,71646,1.0,0,0.0,2003,2003.csv
9368,Herman U.S.A.,71509,71509,1.0,0,0.0,2001,2001.csv
9369,The Congressman,71451,71451,1.0,0,0.0,2016,2016.csv
9370,The Sicilian Girl 2010 Re-release,71239,71239,1.0,0,0.0,2010,2010.csv
9371,My Journey Through French Cinema,71174,52214,0.7336105881361171,18960,0.2663894118638829,2016,2016.csv
9372,Free Trip to Egypt 2019 Re-release,71087,71087,1.0,0,0.0,2019,2019.csv
9373,Boricua's Bond,71046,71046,1.0,0,0.0,2000,2000.csv
9374,Rosencrantz and Guildenstern Are Undead,71007,71007,1.0,0,0.0,2010,2010.csv
9375,Freaks of Nature,70958,70958,1.0,0,0.0,2015,2015.csv
9376,Norman Lear: Just Another Version of You,70950,70950,1.0,0,0.0,2016,2016.csv
9377,Todo el poder,70920,70920,1.0,0,0.0,2003,2003.csv
9378,The Better Angels,70918,70918,1.0,0,0.0,2014,2014.csv
9379,4:44 Last Day on Earth,70851,17801,0.2512455716927072,53050,0.7487544283072928,2012,2012.csv
9380,Big Man Japan 2008 Re-release,70681,40796,0.5771848162872625,29885,0.4228151837127375,2008,2008.csv
9381,How to Build a Girl,70632,70632,1.0,0,0.0,2020,2020.csv
9382,Seasons of Gray,70605,70605,1.0,0,0.0,2013,2013.csv
9383,Fireflies in the Garden 2011 Re-release,70600,70600,1.0,0,0.0,2011,2011.csv
9384,Snipes,70569,70569,1.0,0,0.0,2002,2002.csv
9385,Go for Sisters,70495,70495,1.0,0,0.0,2013,2013.csv
9386,The Fog 2018 Re-release,70421,70421,1.0,0,0.0,2018,2018.csv
9387,Over Your Cities Grass Will Grow,70256,51301,0.7302009792757914,18955,0.2697990207242086,2010,2010.csv
9388,Crips and Bloods: Made in America,70219,70219,1.0,0,0.0,2009,2009.csv
9389,Cavite,70071,70071,1.0,0,0.0,2006,2006.csv
9390,Wastelander,70045,70045,1.0,0,0.0,2018,2018.csv
9391,The Business of Being Born,69991,69991,1.0,0,0.0,2008,2008.csv
9392,Nick Mason's Saucerful of Secrets: Live at the Roundhouse,69967,32444,0.4637043177497963,37523,0.5362956822502036,2020,2020.csv
9393,Manic,69958,69958,1.0,0,0.0,2003,2003.csv
9394,Take Out,69816,69816,1.0,0,0.0,2008,2008.csv
9395,Turn It Around: The Story of East Bay Punk,69787,69787,1.0,0,0.0,2017,2017.csv
9396,Zoo,69770,69770,1.0,0,0.0,2007,2007.csv
9397,Mga munting tinig,69739,69739,1.0,0,0.0,2003,2003.csv
9398,Assassination of a High School President,69564,0,0.0,69564,1.0,2010,2010.csv
9399,Dopamine,69544,69544,1.0,0,0.0,2003,2003.csv
9400,Chef Flynn,69542,68407,0.9836789278421674,1135,0.016321072157832676,2018,2018.csv
9401,Back to the Jurassic,69423,4351,0.0626737536551287,65072,0.9373262463448713,2015,2015.csv
9402,An Inconsistent Truth,69394,69394,1.0,0,0.0,2012,2012.csv
9403,Dark Matter,69379,30591,0.44092592859510804,38788,0.559074071404892,2008,2008.csv
9404,BBC2 Play of the Week: Langrishe Go Down,69338,69338,1.0,0,0.0,2002,2002.csv
9405,Siddharth,69310,60537,0.8734237483768575,8773,0.1265762516231424,2014,2014.csv
9406,Rocky Handsome,69289,0,0.0,69289,1.0,2016,2016.csv
9407,Girls Can't Swim,69250,69250,1.0,0,0.0,2002,2002.csv
9408,White on Rice,69171,69171,1.0,0,0.0,2009,2009.csv
9409,Behind the Mask: The Rise of Leslie Vernon,69136,69136,1.0,0,0.0,2007,2007.csv
9410,Bajatey Raho,69085,55397,0.8018672649634508,13688,0.19813273503654918,2013,2013.csv
9411,The White Sheik 2019 re-release,68940,50850,0.737597911227154,18090,0.26240208877284593,2019,2019.csv
9412,The Pinochet Case,68934,35701,0.5179011808396438,33233,0.4820988191603563,2001,2001.csv
9413,My Entire High School Sinking Into the Sea,68883,68883,1.0,0,0.0,2017,2017.csv
9414,Klown 2012 Re-release,68795,68795,1.0,0,0.0,2012,2012.csv
9415,Strange Powers: Stephin Merritt and the Magnetic Fields,68719,68719,1.0,0,0.0,2010,2010.csv
9416,Bundy,68716,6073,0.08837825251760871,62643,0.9116217474823913,2002,2002.csv
9417,Noma: My Perfect Storm,68622,21130,0.30791874326017893,47492,0.692081256739821,2015,2015.csv
9418,Take Me to the River,68598,68598,1.0,0,0.0,2014,2014.csv
9419,Mastizaade,68583,43403,0.6328536226178499,25180,0.3671463773821501,2016,2016.csv
9420,Wildflower,68577,18062,0.2633827668168628,50515,0.7366172331831372,2016,2016.csv
9421,Cowboys and Angels,68568,33941,0.49499766654999416,34627,0.5050023334500058,2004,2004.csv
9422,Outside In,68492,68492,1.0,0,0.0,2018,2018.csv
9423,Alive and Kicking,68485,68485,1.0,0,0.0,2017,2017.csv
9424,Last Year at Marienbad 2019 Re-release,68402,63425,0.9272389696207713,4977,0.07276103037922868,2019,2019.csv
9425,Budrus,68353,68353,1.0,0,0.0,2010,2010.csv
9426,2012: Time for Change,68339,68339,1.0,0,0.0,2010,2010.csv
9427,The Eyes of Orson Welles,68328,10253,0.15005561409670998,58075,0.84994438590329,2018,2018.csv
9428,10x10,68260,2263,0.033152651626135364,65997,0.9668473483738647,2018,2018.csv
9429,Shake Hands with the Devil: The Journey of Roméo Dallaire,68249,68249,1.0,0,0.0,2005,2005.csv
9430,Maidentrip,68243,68243,1.0,0,0.0,2013,2013.csv
9431,Le Amiche,68167,68167,1.0,0,0.0,2010,2010.csv
9432,¡He matado a mi marido!,68017,45777,0.6730229207404032,22240,0.32697707925959685,2019,2019.csv
9433,I Am Big Bird: The Caroll Spinney Story,67845,67845,1.0,0,0.0,2015,2015.csv
9434,The Messenger,67816,67816,1.0,0,0.0,2015,2015.csv
9435,Summer in the Forest,67743,45542,0.6722761023279158,22201,0.3277238976720842,2017,2017.csv
9436,Sanam Teri Kasam,67736,22121,0.32657670957836304,45615,0.673423290421637,2016,2016.csv
9437,Happy Valley,67665,67665,1.0,0,0.0,2008,2008.csv
9438,What Alice Found,67436,67436,1.0,0,0.0,2003,2003.csv
9439,Beyond the Gates,67433,67433,1.0,0,0.0,2004,2004.csv
9440,The Greasy Strangler,67427,45878,0.6804099248075697,21549,0.3195900751924303,2016,2016.csv
9441,For No Good Reason,67421,67421,1.0,0,0.0,2014,2014.csv
9442,Making the Five Heartbeats,67415,67415,1.0,0,0.0,2018,2018.csv
9443,Being Frank,67343,67343,1.0,0,0.0,2019,2019.csv
9444,The Doctor from India,67136,67136,1.0,0,0.0,2018,2018.csv
9445,Close to Home,67110,20931,0.31189092534644614,46179,0.6881090746535539,2006,2006.csv
9446,The Sun Behind the Clouds: Tibet's Struggle for Freedom,67095,67095,1.0,0,0.0,2010,2010.csv
9447,The Autobiography of Nicolae Ceausescu,67093,34023,0.5071020821844305,33070,0.4928979178155694,2010,2010.csv
9448,Turbo Kid,67069,67069,1.0,0,0.0,2015,2015.csv
9449,Side by Side,67054,58825,0.8772780147343932,8229,0.12272198526560682,2012,2012.csv
9450,Allah Made Me Funny: Live in Concert,66903,66903,1.0,0,0.0,2008,2008.csv
9451,"3100, Run and Become",66789,65524,0.9810597553489347,1265,0.018940244651065294,2018,2018.csv
9452,Max Rose,66680,66680,1.0,0,0.0,2016,2016.csv
9453,Pandora's Promise,66680,66680,1.0,0,0.0,2013,2013.csv
9454,Diggers,66517,66517,1.0,0,0.0,2007,2007.csv
9455,Vodka Lemon,66361,66361,1.0,0,0.0,2004,2004.csv
9456,The Town Is Quiet,66303,66303,1.0,0,0.0,2001,2001.csv
9457,King Georges,66175,66175,1.0,0,0.0,2016,2016.csv
9458,Dancing Across Borders,66166,66166,1.0,0,0.0,2010,2010.csv
9459,Out in the Dark,66017,26966,0.4084705454655619,39051,0.5915294545344381,2013,2013.csv
9460,The Talent Given Us,65827,65827,1.0,0,0.0,2005,2005.csv
9461,Titanic Town,65793,65793,1.0,0,0.0,2000,2000.csv
9462,D-Day,65536,0,0.0,65536,1.0,2013,2013.csv
9463,Architects of Denial,65424,65424,1.0,0,0.0,2017,2017.csv
9464,Blind Shaft,65383,33272,0.5088784546441736,32111,0.4911215453558264,2003,2003.csv
9465,Mail Order Wife,65369,62387,0.9543820465358197,2982,0.045617953464180266,2005,2005.csv
9466,Sing Your Song,65310,47718,0.730638493339458,17592,0.26936150666054204,2012,2012.csv
9467,Mad About Mambo,65283,65283,1.0,0,0.0,2000,2000.csv
9468,Spooky House,65238,65238,1.0,0,0.0,2002,2002.csv
9469,You've Been Trumped,65220,29273,0.44883471327813557,35947,0.5511652867218645,2012,2012.csv
9470,One 2004 Re-release,65172,65172,1.0,0,0.0,2004,2004.csv
9471,An Adolescent 2005 Re-release,65171,65171,1.0,0,0.0,2005,2005.csv
9472,Through a Lens Darkly: Black Photographers and the Emergence of a People,65169,65169,1.0,0,0.0,2014,2014.csv
9473,The Lesson,65142,9045,0.13885051119093672,56097,0.8611494888090633,2015,2015.csv
9474,Gaudi Afternoon,65115,5858,0.08996391000537511,59257,0.9100360899946249,2002,2002.csv
9475,Aberdeen,65090,65090,1.0,0,0.0,2001,2001.csv
9476,Racing Dreams,65082,65082,1.0,0,0.0,2010,2010.csv
9477,The Wild Child,65051,65051,1.0,0,0.0,2008,2008.csv
9478,Last Resort,65041,37283,0.5732230439261389,27758,0.4267769560738611,2001,2001.csv
9479,Expired,65003,29796,0.4583788440533514,35207,0.5416211559466486,2008,2008.csv
9480,Toys in the Attic 2012 Re-release,64918,64918,1.0,0,0.0,2012,2012.csv
9481,Manolo: the Boy Who Made Shoes for Lizards,64889,60056,0.9255189631524604,4833,0.07448103684753965,2017,2017.csv
9482,Searching for Ingmar Bergman,64742,36686,0.5666491612863366,28056,0.4333508387136635,2018,2018.csv
9483,Bloodline,64698,64698,1.0,0,0.0,2008,2008.csv
9484,The Jesus Rolls,64648,18169,0.2810450439302067,46479,0.7189549560697933,2019,2019.csv
9485,Monsieur Verdoux,64636,64636,1.0,0,0.0,2008,2008.csv
9486,"Monrovia, Indiana",64596,63944,0.9899064957582513,652,0.010093504241748714,2018,2018.csv
9487,Battle of the Brides,64572,64572,1.0,0,0.0,2011,2011.csv
9488,Let the Fire Burn,64489,64489,1.0,0,0.0,2013,2013.csv
9489,Syndromes and a Century,64453,16675,0.25871565326672147,47778,0.7412843467332785,2007,2007.csv
9490,Trilogy: The Weeping Meadow,64424,24966,0.38752638768160935,39458,0.6124736123183907,2005,2005.csv
9491,Badmaa$h Company,64398,0,0.0,64398,1.0,2010,2010.csv
9492,Just a Kiss,64389,64389,1.0,0,0.0,2002,2002.csv
9493,D' Lucky Ones!,64352,64352,1.0,0,0.0,2006,2006.csv
9494,Rock School,64310,64310,1.0,0,0.0,2005,2005.csv
9495,Paulette 2015 Re-release,64125,29494,0.4599454191033138,34631,0.5400545808966861,2015,2015.csv
9496,Beautiful Losers,64064,56386,0.8801510989010989,7678,0.1198489010989011,2008,2008.csv
9497,Girl Asleep,64056,60289,0.9411920819283127,3767,0.058807918071687275,2016,2016.csv
9498,Making Waves: The Art of Cinematic Sound,63998,53144,0.8304009500296884,10854,0.16959904997031158,2019,2019.csv
9499,Jealousy,63946,63946,1.0,0,0.0,2014,2014.csv
9500,Only the Strong Survive,63778,57581,0.9028348333281069,6197,0.09716516667189314,2003,2003.csv
9501,Her Majesty,63652,63652,1.0,0,0.0,2004,2004.csv
9502,The Details,63595,63595,1.0,0,0.0,2012,2012.csv
9503,A Plumm Summer,63521,63521,1.0,0,0.0,2008,2008.csv
9504,A Liar's Autobiography: The Untrue Story of Monty Python's Graham Chapman,63469,5102,0.08038570010556334,58367,0.9196142998944367,2012,2012.csv
9505,All About Eve 2000 Re-release,63463,63463,1.0,0,0.0,2000,2000.csv
9506,I Smile Back,63373,58738,0.9268615972101684,4635,0.07313840278983164,2015,2015.csv
9507,Nijinsky: The Diaries of Vaslav Nijinsky,63364,55968,0.8832775708604255,7396,0.11672242913957452,2002,2002.csv
9508,Trapped,63241,63241,1.0,0,0.0,2016,2016.csv
9509,Skills Like This,63163,63163,1.0,0,0.0,2009,2009.csv
9510,The Last of the Unjust,63136,40563,0.6424702230106437,22573,0.3575297769893563,2013,2013.csv
9511,No Tears for the Dead,63063,63063,1.0,0,0.0,2014,2014.csv
9512,Creative Control,63014,63014,1.0,0,0.0,2016,2016.csv
9513,"Love, Antosha",62900,50168,0.7975834658187599,12732,0.20241653418124006,2019,2019.csv
9514,The Mudge Boy,62852,62852,1.0,0,0.0,2004,2004.csv
9515,Mala Noche,62743,25386,0.40460290390959947,37357,0.5953970960904005,2007,2007.csv
9516,The Gardener,62734,62734,1.0,0,0.0,2018,2018.csv
9517,The Swan,62716,2367,0.0377415651508387,60349,0.9622584348491613,2018,2018.csv
9518,Cool It,62713,62713,1.0,0,0.0,2010,2010.csv
9519,No Such Thing,62703,62703,1.0,0,0.0,2002,2002.csv
9520,A Year Without Love,62676,24381,0.38900057438253877,38295,0.6109994256174612,2005,2005.csv
9521,Drunk Stoned Brilliant Dead,62660,62660,1.0,0,0.0,2015,2015.csv
9522,The Order of Myths,62645,62645,1.0,0,0.0,2008,2008.csv
9523,The Providence Effect,62500,62500,1.0,0,0.0,2009,2009.csv
9524,The Tiger Hunter,62398,62398,1.0,0,0.0,2017,2017.csv
9525,Vajra Sky Over Tibet,62356,62356,1.0,0,0.0,2006,2006.csv
9526,Mifune: The Last Samurai,62279,62279,1.0,0,0.0,2016,2016.csv
9527,Public Speaking,62173,62173,1.0,0,0.0,2011,2011.csv
9528,Poster Boy,62062,62062,1.0,0,0.0,2006,2006.csv
9529,Proteus,62031,62031,1.0,0,0.0,2004,2004.csv
9530,Trigun: Badlands Rumble 2011 Re-release,62027,62027,1.0,0,0.0,2011,2011.csv
9531,Kites The Remix,61997,41783,0.6739519654176815,20214,0.3260480345823185,2010,2010.csv
9532,"I, Me aur Main",61863,0,0.0,61863,1.0,2013,2013.csv
9533,Dark Star: HR Gigers Welt,61845,61845,1.0,0,0.0,2015,2015.csv
9534,In a Valley of Violence,61797,61797,1.0,0,0.0,2016,2016.csv
9535,If a Tree Falls: A Story of the Earth Liberation Front,61794,61794,1.0,0,0.0,2011,2011.csv
9536,River Runs Red,61789,9893,0.1601094045865769,51896,0.8398905954134231,2018,2018.csv
9537,Amour Fou,61693,13702,0.22209975199779552,47991,0.7779002480022045,2014,2014.csv
9538,Quill: The Life of a Guide Dog 2012 Re-release,61674,15674,0.2541427505918215,46000,0.7458572494081784,2012,2012.csv
9539,Vivere,61658,3625,0.05879204644977132,58033,0.9412079535502287,2007,2007.csv
9540,Backwards,61465,61465,1.0,0,0.0,2012,2012.csv
9541,Donald Cried,61406,61406,1.0,0,0.0,2017,2017.csv
9542,Here and Now,61271,13892,0.22673042711886537,47379,0.7732695728811346,2018,2018.csv
9543,Never Goin' Back,61271,61271,1.0,0,0.0,2018,2018.csv
9544,The Seasons In Quincy: Four Portraits of John Berger,61267,28456,0.46445884407592997,32811,0.53554115592407,2016,2016.csv
9545,The Outcasts,61250,1455,0.023755102040816326,59795,0.9762448979591837,2017,2017.csv
9546,The Untamed,61249,27593,0.45050531437247954,33656,0.5494946856275205,2017,2017.csv
9547,Judy Berlin,61236,61236,1.0,0,0.0,2000,2000.csv
9548,The Elephant King,61122,22251,0.36404240698930007,38871,0.6359575930106999,2008,2008.csv
9549,The Mountain,61035,61035,1.0,0,0.0,2019,2019.csv
9550,The Bodyguard 2012 Re-release,61020,61020,1.0,0,0.0,2012,2012.csv
9551,Independent Lens: Don't Stop Believin': Everyman's Journey,61018,61018,1.0,0,0.0,2013,2013.csv
9552,The Sacrifice 2017 Re-release,61018,61018,1.0,0,0.0,2017,2017.csv
9553,Love U... Mr. Kalakaar!,60956,48557,0.7965909836603452,12399,0.20340901633965483,2011,2011.csv
9554,Brighton Rock,60950,49466,0.811583264971288,11484,0.18841673502871206,2009,2009.csv
9555,Chelsea Walls,60902,60902,1.0,0,0.0,2002,2002.csv
9556,The Wicker Man 2013 Re-release,60891,60891,1.0,0,0.0,2013,2013.csv
9557,It's a Disaster,60818,60818,1.0,0,0.0,2013,2013.csv
9558,You I Love,60815,60815,1.0,0,0.0,2004,2004.csv
9559,A Kid Like Jake,60784,58403,0.9608285075019742,2381,0.039171492498025796,2018,2018.csv
9560,Apprentice,60752,2578,0.042434816960758494,58174,0.9575651830392415,2016,2016.csv
9561,Aurora Borealis,60729,60729,1.0,0,0.0,2006,2006.csv
9562,Pyaar Ke Side Effects,60714,30230,0.4979082254504727,30484,0.5020917745495272,2006,2006.csv
9563,How to Live Forever,60630,60630,1.0,0,0.0,2011,2011.csv
9564,Viper Club,60607,60607,1.0,0,0.0,2018,2018.csv
9565,Too Late,60438,60438,1.0,0,0.0,2016,2016.csv
9566,The Slammin' Salmon,60421,41587,0.6882871849191506,18834,0.31171281508084936,2009,2009.csv
9567,Limelight,60335,60335,1.0,0,0.0,2011,2011.csv
9568,Boogie Man: The Lee Atwater Story,60332,60332,1.0,0,0.0,2008,2008.csv
9569,Crime After Crime,60291,60291,1.0,0,0.0,2011,2011.csv
9570,Edvard Munch,60244,43539,0.7227109753668415,16705,0.27728902463315847,2005,2005.csv
9571,Ikiru,60239,60239,1.0,0,0.0,2002,2002.csv
9572,Wetlands 2014 Re-release,60230,59478,0.9875145276440312,752,0.012485472355968787,2014,2014.csv
9573,Presenting Princess Shaw,60197,60197,1.0,0,0.0,2016,2016.csv
9574,Just One Drop,60078,60078,1.0,0,0.0,2017,2017.csv
9575,Gregory Crewdson: Brief Encounters,60064,60064,1.0,0,0.0,2012,2012.csv
9576,Decoding Annie Parker,60048,48390,0.8058553157474021,11658,0.19414468425259793,2014,2014.csv
9577,Down and Out with the Dolls,60000,60000,1.0,0,0.0,2003,2003.csv
9578,The Force,59912,59912,1.0,0,0.0,2017,2017.csv
9579,John Fogerty: 50 Year Trip - Live at Red Rocks,59795,59795,1.0,0,0.0,2019,2019.csv
9580,Frontera,59696,59696,1.0,0,0.0,2014,2014.csv
9581,The Extraordinary Voyage,59424,52986,0.8916599353796446,6438,0.1083400646203554,2012,2012.csv
9582,Cheap Thrills,59424,59424,1.0,0,0.0,2014,2014.csv
9583,Sweet Dreams,59403,59403,1.0,0,0.0,2013,2013.csv
9584,Bomb City,59329,59329,1.0,0,0.0,2018,2018.csv
9585,Bang! The Bert Berns Story,59299,59299,1.0,0,0.0,2017,2017.csv
9586,The Young Unknowns,59166,59166,1.0,0,0.0,2003,2003.csv
9587,Digimon Adventure tri. Part 4: Loss,59114,59114,1.0,0,0.0,2018,2018.csv
9588,The Trials of Muhammad Ali,59081,59081,1.0,0,0.0,2013,2013.csv
9589,Screen Door Jesus,59000,59000,1.0,0,0.0,2005,2005.csv
9590,The One I Wrote for You,58872,58872,1.0,0,0.0,2014,2014.csv
9591,Maxed Out,58829,58829,1.0,0,0.0,2007,2007.csv
9592,What We Do Is Secret,58776,58776,1.0,0,0.0,2008,2008.csv
9593,Sagrada: The Mystery of Creation 2014 Re-release,58755,58755,1.0,0,0.0,2014,2014.csv
9594,The Conformist 2014 Re-release,58657,58657,1.0,0,0.0,2014,2014.csv
9595,Horn from the Heart: The Paul Butterfield Story,58597,58597,1.0,0,0.0,2018,2018.csv
9596,Putty Hill,58585,49918,0.852061107792097,8667,0.14793889220790304,2011,2011.csv
9597,Eyes Without a Face,58565,58565,1.0,0,0.0,2003,2003.csv
9598,Home Delivery,58499,58499,1.0,0,0.0,2005,2005.csv
9599,Four Seasons Lodge,58334,58334,1.0,0,0.0,2009,2009.csv
9600,Gozu,58202,58202,1.0,0,0.0,2004,2004.csv
9601,Orlando 2010 Re-release,58198,58198,1.0,0,0.0,2010,2010.csv
9602,Cynthia,58177,58177,1.0,0,0.0,2018,2018.csv
9603,Faust,58132,58132,1.0,0,0.0,2013,2013.csv
9604,In Search of Greatness,58090,58090,1.0,0,0.0,2018,2018.csv
9605,Voices of Iraq,57999,57999,1.0,0,0.0,2004,2004.csv
9606,The Boom,57962,57962,1.0,0,0.0,2017,2017.csv
9607,The End of Poverty?,57805,57805,1.0,0,0.0,2009,2009.csv
9608,Springtime in a Small Town,57751,43017,0.7448702186975117,14734,0.25512978130248826,2003,2003.csv
9609,Rififi 2015 Re-release,57749,57749,1.0,0,0.0,2015,2015.csv
9610,Command and Control,57635,57635,1.0,0,0.0,2016,2016.csv
9611,Battleship Potemkin,57620,51198,0.888545643873655,6422,0.11145435612634502,2011,2011.csv
9612,Playback,57587,264,0.00458436799972216,57323,0.9954156320002778,2012,2012.csv
9613,Sold,57527,57527,1.0,0,0.0,2016,2016.csv
9614,Pandora's Box,57472,53485,0.930627087973274,3987,0.06937291202672606,2006,2006.csv
9615,Court,57416,22898,0.39880869444057404,34518,0.6011913055594259,2015,2015.csv
9616,Ramen Heads,57345,57345,1.0,0,0.0,2018,2018.csv
9617,Run & Jump,57189,20061,0.3507842417248072,37128,0.6492157582751927,2014,2014.csv
9618,Mickey and the Bear,57188,57188,1.0,0,0.0,2019,2019.csv
9619,Kuch Khatti Kuch Meethi,57188,57188,1.0,0,0.0,2001,2001.csv
9620,Così ridevano,57009,57009,1.0,0,0.0,2001,2001.csv
9621,Wall,56866,14541,0.2557063974958675,42325,0.7442936025041326,2004,2004.csv
9622,My Joy,56857,6298,0.11076912253548375,50559,0.8892308774645162,2011,2011.csv
9623,The Battle of Algiers 2016 Re-release,56853,56853,1.0,0,0.0,2016,2016.csv
9624,Electric Shadows,56809,7129,0.12549067929377386,49680,0.8745093207062261,2005,2005.csv
9625,Eleven Men Out 2007 Re-release,56733,1000,0.017626425537165317,55733,0.9823735744628347,2007,2007.csv
9626,Harvard Man,56653,56653,1.0,0,0.0,2002,2002.csv
9627,Farmageddon,56573,56573,1.0,0,0.0,2011,2011.csv
9628,The Two of Us,56558,56558,1.0,0,0.0,2005,2005.csv
9629,Muran,56493,30116,0.5330925955428106,26377,0.46690740445718937,2011,2011.csv
9630,Beyond the Black Rainbow,56491,56491,1.0,0,0.0,2012,2012.csv
9631,Big Men,56286,56286,1.0,0,0.0,2014,2014.csv
9632,Saving Brinton,56218,56218,1.0,0,0.0,2017,2017.csv
9633,Divan,56214,56214,1.0,0,0.0,2004,2004.csv
9634,Wedding Doll,56196,56196,1.0,0,0.0,2016,2016.csv
9635,Notebook,56166,0,0.0,56166,1.0,2019,2019.csv
9636,False Confessions,56165,29245,0.5206979435591561,26920,0.47930205644084395,2017,2017.csv
9637,Kart Racer,56146,56146,1.0,0,0.0,2003,2003.csv
9638,Évolution,55985,24770,0.4424399392694472,31215,0.5575600607305529,2016,2016.csv
9639,Man Push Cart,55903,36608,0.6548485769994454,19295,0.3451514230005545,2006,2006.csv
9640,Unknown Pleasures,55901,11254,0.20132019105203844,44647,0.7986798089479615,2003,2003.csv
9641,Vitalina Varela,55862,14941,0.2674626758798468,40921,0.7325373241201533,2019,2019.csv
9642,Terms and Conditions May Apply,55824,55824,1.0,0,0.0,2013,2013.csv
9643,Hellion,55708,55708,1.0,0,0.0,2014,2014.csv
9644,XX,55668,30911,0.5552741251706546,24757,0.4447258748293454,2017,2017.csv
9645,Recorder: The Marion Stokes Project,55632,55632,1.0,0,0.0,2019,2019.csv
9646,Holidays,55621,0,0.0,55621,1.0,2016,2016.csv
9647,As Good as Dead,55618,1981,0.03561796540688266,53637,0.9643820345931173,2010,2010.csv
9648,Finding Joe,55518,55518,1.0,0,0.0,2011,2011.csv
9649,The Boys: The Sherman Brothers' Story,55513,55513,1.0,0,0.0,2009,2009.csv
9650,Entertainment,55506,55506,1.0,0,0.0,2015,2015.csv
9651,The Other Side of the Street,55459,55459,1.0,0,0.0,2005,2005.csv
9652,Naam Shabana,55429,0,0.0,55429,1.0,2017,2017.csv
9653,That Man: Peter Berlin,55398,55398,1.0,0,0.0,2006,2006.csv
9654,Into Eternity,55366,55366,1.0,0,0.0,2011,2011.csv
9655,Dracula: Pages from a Virgin's Diary,55365,55365,1.0,0,0.0,2003,2003.csv
9656,C.O.G.,55301,55301,1.0,0,0.0,2013,2013.csv
9657,Natural Selection,55282,55282,1.0,0,0.0,2012,2012.csv
9658,The Tracker 2004 Re-release,55188,55188,1.0,0,0.0,2004,2004.csv
9659,Mamma Mia! 2018 Re-release,55168,39601,0.7178255510440835,15567,0.2821744489559165,2018,2018.csv
9660,American Dream: Detroit,55092,55092,1.0,0,0.0,2018,2018.csv
9661,The Lovely Month of May,55038,55038,1.0,0,0.0,2013,2013.csv
9662,Twenty Two 2017 Re-release,55001,46796,0.8508208941655606,8205,0.14917910583443938,2017,2017.csv
9663,Zombeavers,54985,14947,0.27183777393834685,40038,0.7281622260616532,2014,2014.csv
9664,Ciao America,54965,54965,1.0,0,0.0,2002,2002.csv
9665,The Amateurs 2007 Re-release,54945,16334,0.2972790972790973,38611,0.7027209027209027,2007,2007.csv
9666,DAZN Boxing: Canelo Alvarez vs. Rocky Fielding,54916,54916,1.0,0,0.0,2018,2018.csv
9667,Extreme Movie,54822,0,0.0,54822,1.0,2008,2008.csv
9668,Snowmen,54805,54805,1.0,0,0.0,2011,2011.csv
9669,Once in the Life,54780,54780,1.0,0,0.0,2000,2000.csv
9670,Orphans,54754,54754,1.0,0,0.0,2000,2000.csv
9671,The Nature of Existence,54645,54645,1.0,0,0.0,2010,2010.csv
9672,In a Dream,54640,54640,1.0,0,0.0,2009,2009.csv
9673,What Our Fathers Did: A Nazi Legacy,54603,40119,0.734739849458821,14484,0.2652601505411791,2015,2015.csv
9674,Grand Champion,54579,54579,1.0,0,0.0,2004,2004.csv
9675,The Lottery,54543,54543,1.0,0,0.0,2010,2010.csv
9676,The Harimaya Bridge,54473,54473,1.0,0,0.0,2010,2010.csv
9677,A Simple Wedding,54415,54415,1.0,0,0.0,2020,2020.csv
9678,Schizo,54357,54357,1.0,0,0.0,2005,2005.csv
9679,Digimon Adventure tri. Part 6: Future,54324,54324,1.0,0,0.0,2018,2018.csv
9680,Harlan: In the Shadow of Jew Suess,54305,54305,1.0,0,0.0,2010,2010.csv
9681,The Search for General Tso,54275,54275,1.0,0,0.0,2015,2015.csv
9682,Wagner & Me 2012 Re-release,54215,37745,0.6962095361062437,16470,0.30379046389375636,2012,2012.csv
9683,Line of Duty,54204,54204,1.0,0,0.0,2013,2013.csv
9684,Give Me Your Hand,54147,3601,0.06650414612074537,50546,0.9334958538792546,2009,2009.csv
9685,Jungle,54125,54125,1.0,0,0.0,2000,2000.csv
9686,Last Passenger,54110,14806,0.2736277952319349,39304,0.7263722047680651,2014,2014.csv
9687,Broken Hill,54058,54058,1.0,0,0.0,2009,2009.csv
9688,Low Down,54051,54051,1.0,0,0.0,2014,2014.csv
9689,Kal Kissne Dekha,54048,24625,0.4556135287152161,29423,0.5443864712847839,2009,2009.csv
9690,A Beautiful Soul,54008,54008,1.0,0,0.0,2012,2012.csv
9691,L.A. Twister,54000,54000,1.0,0,0.0,2004,2004.csv
9692,Surviving Progress,53953,53953,1.0,0,0.0,2012,2012.csv
9693,The Assassin's Code,53940,11218,0.20797182054134222,42722,0.7920281794586578,2018,2018.csv
9694,The Last Man on the Moon,53881,52482,0.9740353742506634,1399,0.0259646257493365,2016,2016.csv
9695,The Summer of Sangaile,53843,4480,0.0832048734283008,49363,0.9167951265716991,2015,2015.csv
9696,At Middleton,53837,53837,1.0,0,0.0,2014,2014.csv
9697,Easy,53825,21589,0.40109614491407336,32236,0.5989038550859266,2004,2004.csv
9698,Rising from Ashes,53804,38602,0.7174559512303917,15202,0.2825440487696082,2013,2013.csv
9699,The Heir Apparent: Largo Winch 2011 Re-release,53793,10352,0.1924413957206328,43441,0.8075586042793672,2011,2011.csv
9700,Down by Love,53780,675,0.012551134250650799,53105,0.9874488657493492,2016,2016.csv
9701,Bart Got a Room,53760,53760,1.0,0,0.0,2009,2009.csv
9702,The Legend of Hallowaiian,53738,451,0.00839257136476981,53287,0.9916074286352302,2018,2018.csv
9703,The Other F Word,53714,53714,1.0,0,0.0,2011,2011.csv
9704,Leonie 2013 Re-release,53692,53692,1.0,0,0.0,2013,2013.csv
9705,Kalamazoo?,53609,53609,1.0,0,0.0,2006,2006.csv
9706,Grass,53503,8084,0.15109433115900042,45419,0.8489056688409996,2018,2018.csv
9707,Plagues and Pleasures on the Salton Sea,53471,53471,1.0,0,0.0,2006,2006.csv
9708,God of Vampires,53345,53345,1.0,0,0.0,2010,2010.csv
9709,Ugly Me 2008 Re-release,53250,53250,1.0,0,0.0,2008,2008.csv
9710,Finishing the Game,53219,52868,0.9934046111351209,351,0.006595388864879085,2007,2007.csv
9711,Boys Life 4: Four Play,53169,53169,1.0,0,0.0,2003,2003.csv
9712,The Killing of John Lennon,53117,6975,0.13131389197432083,46142,0.8686861080256791,2007,2007.csv
9713,The Great Silence,53074,53074,1.0,0,0.0,2018,2018.csv
9714,Waiting for Happiness,53048,7406,0.1396094103453476,45642,0.8603905896546524,2003,2003.csv
9715,Love Thy Nature,52947,41149,0.7771733998149093,11798,0.22282660018509076,2015,2015.csv
9716,Ping Pong Summer,52909,52909,1.0,0,0.0,2014,2014.csv
9717,Mia and the Migoo 2010 Re-release,52873,17000,0.3215251640723999,35873,0.6784748359276,2010,2010.csv
9718,Billy the Kid,52823,52823,1.0,0,0.0,2007,2007.csv
9719,To Be Takei,52823,52823,1.0,0,0.0,2014,2014.csv
9720,Occupy Unmasked,52768,52768,1.0,0,0.0,2012,2012.csv
9721,!Women Art Revolution,52681,52681,1.0,0,0.0,2011,2011.csv
9722,Close to You,52654,52654,1.0,0,0.0,2006,2006.csv
9723,Pierrot le Fou,52640,52640,1.0,0,0.0,2007,2007.csv
9724,La forza del destino,52577,52577,1.0,0,0.0,2008,2008.csv
9725,Salvation Army,52511,3929,0.07482241816000457,48582,0.9251775818399954,2014,2014.csv
9726,Cropsey,52476,52476,1.0,0,0.0,2010,2010.csv
9727,Visual Acoustics,52467,52467,1.0,0,0.0,2009,2009.csv
9728,Hush!,52462,21278,0.4055888071365941,31184,0.5944111928634059,2002,2002.csv
9729,Going Attractions: The Definitive Story of the American Drive-in Movie,52458,52458,1.0,0,0.0,2013,2013.csv
9730,Lost in Love,52453,52453,1.0,0,0.0,2009,2009.csv
9731,A Tale of Winter,52431,23268,0.4437832579962236,29163,0.5562167420037764,2014,2014.csv
9732,Trucker,52429,52429,1.0,0,0.0,2009,2009.csv
9733,Breath Made Visible: Anna Halprin,52387,52387,1.0,0,0.0,2010,2010.csv
9734,Birdboy: The Forgotten Children,52366,38786,0.7406714280258183,13580,0.25932857197418174,2017,2017.csv
9735,Here and There,52307,27156,0.5191656948400788,25151,0.48083430515992126,2010,2010.csv
9736,The Human Experience,52296,52296,1.0,0,0.0,2010,2010.csv
9737,In My Skin,52231,31046,0.5943979628955984,21185,0.4056020371044016,2002,2002.csv
9738,Dare Not Walk Alone,52166,52166,1.0,0,0.0,2008,2008.csv
9739,"Surfer, Dude",52132,52132,1.0,0,0.0,2008,2008.csv
9740,Screamers,52034,52034,1.0,0,0.0,2006,2006.csv
9741,Henri-Georges Clouzot's Inferno,52003,25489,0.4901447993384997,26514,0.5098552006615003,2010,2010.csv
9742,Herod's Law,52000,52000,1.0,0,0.0,2003,2003.csv
9743,Hiding and Seeking: Faith and Tolerance After the Holocaust,51936,51936,1.0,0,0.0,2004,2004.csv
9744,American Dharma,51891,51891,1.0,0,0.0,2019,2019.csv
9745,Quay,51858,51858,1.0,0,0.0,2015,2015.csv
9746,The Snowman Trek,51743,51743,1.0,0,0.0,2018,2018.csv
9747,The Strange Case of Dr. Jekyll and Mr. Hyde,51721,24216,0.4682044044005336,27505,0.5317955955994663,2006,2006.csv
9748,Wanda 2018 Re-release,51713,51713,1.0,0,0.0,2018,2018.csv
9749,Midnight Family,51712,42310,0.8181853341584159,9402,0.18181466584158415,2019,2019.csv
9750,Moonlight,51570,51570,1.0,0,0.0,2006,2006.csv
9751,The Fire and the Rain,51549,51549,1.0,0,0.0,2002,2002.csv
9752,The Motel,51540,51540,1.0,0,0.0,2006,2006.csv
9753,The Willow Tree,51499,25752,0.5000485446319346,25747,0.4999514553680654,2007,2007.csv
9754,Tickling Giants,51499,51499,1.0,0,0.0,2017,2017.csv
9755,The Yes Men Are Revolting,51331,50190,0.9777717168962226,1141,0.022228283103777443,2015,2015.csv
9756,Venus and Serena,51271,51271,1.0,0,0.0,2013,2013.csv
9757,Amu,51251,51251,1.0,0,0.0,2007,2007.csv
9758,God's Sandbox,51246,51246,1.0,0,0.0,2005,2005.csv
9759,God Loves Uganda,51229,51229,1.0,0,0.0,2013,2013.csv
9760,Miss Fisher and the Crypt of Tears (special screenings),51158,51032,0.9975370421048516,126,0.002462957895148364,2020,2020.csv
9761,A Matter of Taste,51148,10720,0.2095878626730273,40428,0.7904121373269727,2001,2001.csv
9762,An Invisible Sign,51138,1279,0.02501075521138879,49859,0.9749892447886112,2011,2011.csv
9763,Da wan,51059,820,0.01605985232769933,50239,0.9839401476723006,2002,2002.csv
9764,Wasabi Tuna 2005 Re-release,51036,51036,1.0,0,0.0,2005,2005.csv
9765,The Unknowns,51035,51035,1.0,0,0.0,2016,2016.csv
9766,The Good Doctor,51017,5206,0.10204441656702667,45811,0.8979555834329733,2012,2012.csv
9767,Gunnin' for That #1 Spot,50950,50804,0.9971344455348381,146,0.0028655544651619235,2008,2008.csv
9768,As I Open My Eyes,50721,30989,0.6109698152638946,19732,0.38903018473610534,2016,2016.csv
9769,Long Night's Journey Into Day,50715,50715,1.0,0,0.0,2000,2000.csv
9770,Asambhav,50611,19504,0.38537076920037144,31107,0.6146292307996285,2004,2004.csv
9771,Keep Quiet,50451,50451,1.0,0,0.0,2017,2017.csv
9772,American Casino,50437,50437,1.0,0,0.0,2009,2009.csv
9773,Clinton Road,50400,50400,1.0,0,0.0,2019,2019.csv
9774,Wake in Fright 2012 Re-release,50394,50394,1.0,0,0.0,2012,2012.csv
9775,Shirley,50354,0,0.0,50354,1.0,2020,2020.csv
9776,Midnight Traveler,50336,41265,0.8197910044500953,9071,0.18020899554990463,2019,2019.csv
9777,The Fitzgerald Family Christmas,50292,50292,1.0,0,0.0,2012,2012.csv
9778,The Royal Wedding: Prince Harry and Meghan Markle,50264,50264,1.0,0,0.0,2018,2018.csv
9779,The Retrieval,50257,50257,1.0,0,0.0,2014,2014.csv
9780,The Warrior 2005 Re-release,50257,50257,1.0,0,0.0,2005,2005.csv
9781,You'll Get Over It,50256,50256,1.0,0,0.0,2004,2004.csv
9782,In Order of Disappearance 2016 Re-release,50251,50251,1.0,0,0.0,2016,2016.csv
9783,"Tristan und Isolde, Azione in tre atti",50172,50172,1.0,0,0.0,2008,2008.csv
9784,Royal Kill,50090,50090,1.0,0,0.0,2009,2009.csv
9785,A Family Affair,50075,50075,1.0,0,0.0,2003,2003.csv
9786,Le combat dans l'île,50039,50039,1.0,0,0.0,2009,2009.csv
9787,Quest,50022,47807,0.955719483427292,2215,0.04428051657270801,2017,2017.csv
9788,The Discoverers,50020,50020,1.0,0,0.0,2014,2014.csv
9789,Bigger,49997,46382,0.9276956617397044,3615,0.07230433826029561,2018,2018.csv
9790,AKA,49988,49988,1.0,0,0.0,2003,2003.csv
9791,Afterschool,49971,3911,0.07826539392847852,46060,0.9217346060715215,2008,2008.csv
9792,Spring,49970,49970,1.0,0,0.0,2015,2015.csv
9793,On the Outs,49940,49940,1.0,0,0.0,2005,2005.csv
9794,Transformation: The Life and Legacy of Werner Erhard,49919,49919,1.0,0,0.0,2007,2007.csv
9795,How to Kill Your Neighbor's Dog,49894,49894,1.0,0,0.0,2002,2002.csv
9796,Fakers,49880,49880,1.0,0,0.0,2007,2007.csv
9797,Free Trip to Egypt,49693,49693,1.0,0,0.0,2019,2019.csv
9798,The Fantasticks,49666,49666,1.0,0,0.0,2000,2000.csv
9799,NOW: In the Wings on a World Stage,49591,49591,1.0,0,0.0,2014,2014.csv
9800,Ciao,49494,49494,1.0,0,0.0,2008,2008.csv
9801,Red Herring,49480,49480,1.0,0,0.0,2015,2015.csv
9802,GasLand,49428,30846,0.6240592376790484,18582,0.3759407623209517,2010,2010.csv
9803,Eureka,49388,49388,1.0,0,0.0,2001,2001.csv
9804,Jumanji/Jumanji: Welcome to the Jungle 2018 NCM Fathom Event,49381,49381,1.0,0,0.0,2018,2018.csv
9805,Shirin in Love,49254,49254,1.0,0,0.0,2014,2014.csv
9806,Confusion of Genders 2003 Re-release,49237,49237,1.0,0,0.0,2003,2003.csv
9807,Journey to the End of the Night,49172,0,0.0,49172,1.0,2007,2007.csv
9808,The Amati Girls,49136,49136,1.0,0,0.0,2001,2001.csv
9809,Bonsai,49128,21267,0.4328895945285784,27861,0.5671104054714216,2012,2012.csv
9810,La Rondine,49088,49088,1.0,0,0.0,2008,2008.csv
9811,Assisted Living,49048,49048,1.0,0,0.0,2005,2005.csv
9812,Hal,49045,48698,0.9929248649199715,347,0.007075135080028545,2018,2018.csv
9813,Raging Bull 25th Anniversary,49034,49034,1.0,0,0.0,2005,2005.csv
9814,Orgasm Inc.,49001,49001,1.0,0,0.0,2011,2011.csv
9815,Chocolate: Deep Dark Secrets,49000,49000,1.0,0,0.0,2005,2005.csv
9816,Box Elder,48996,48996,1.0,0,0.0,2008,2008.csv
9817,Lucky Them,48995,48995,1.0,0,0.0,2014,2014.csv
9818,Alice Neel,48969,48969,1.0,0,0.0,2007,2007.csv
9819,The Internet's Own Boy: The Story of Aaron Swartz,48911,48911,1.0,0,0.0,2014,2014.csv
9820,Bolivar Is Me,48911,48911,1.0,0,0.0,2002,2002.csv
9821,The Situation,48896,48896,1.0,0,0.0,2007,2007.csv
9822,The Seven Five,48869,48869,1.0,0,0.0,2015,2015.csv
9823,The Bounty Killer,48815,48815,1.0,0,0.0,2019,2019.csv
9824,A Thousand Clouds of Peace,48782,48782,1.0,0,0.0,2004,2004.csv
9825,The Citizen,48767,24296,0.49820575389095084,24471,0.5017942461090491,2013,2013.csv
9826,A Birder's Guide to Everything,48713,48713,1.0,0,0.0,2014,2014.csv
9827,American Mustang,48700,48700,1.0,0,0.0,2014,2014.csv
9828,Tales from Earthsea 2010 Re-release,48658,48658,1.0,0,0.0,2010,2010.csv
9829,The China Hustle,48650,48650,1.0,0,0.0,2018,2018.csv
9830,Shakespeare Behind Bars,48594,48594,1.0,0,0.0,2006,2006.csv
9831,Sisters in Law,48526,33312,0.6864773523471953,15214,0.3135226476528047,2006,2006.csv
9832,Person to Person,48499,48499,1.0,0,0.0,2017,2017.csv
9833,The Cats of Mirikitani,48483,38925,0.8028587339892334,9558,0.19714126601076665,2007,2007.csv
9834,Be with Me,48443,1365,0.028177445657783375,47078,0.9718225543422166,2006,2006.csv
9835,Alleluia,48426,6334,0.13079750547226696,42092,0.869202494527733,2014,2014.csv
9836,Boogie Woogie,48411,2618,0.05407861849579641,45793,0.9459213815042036,2010,2010.csv
9837,"Lebanon, Pa.",48381,48381,1.0,0,0.0,2011,2011.csv
9838,Waydowntown,48333,48333,1.0,0,0.0,2000,2000.csv
9839,Dry Season,48251,3303,0.06845453980228389,44948,0.9315454601977161,2007,2007.csv
9840,Ceremony,48174,22270,0.4622825590567526,25904,0.5377174409432474,2011,2011.csv
9841,The Forbidden Room,48082,34404,0.7155276402811863,13678,0.2844723597188137,2015,2015.csv
9842,Interview with the Assassin,48058,48058,1.0,0,0.0,2002,2002.csv
9843,Life Happens,48041,30905,0.6433046772548449,17136,0.3566953227451552,2012,2012.csv
9844,A Cop,48040,48040,1.0,0,0.0,2013,2013.csv
9845,Blackball 2005 Re-release,48000,48000,1.0,0,0.0,2005,2005.csv
9846,Two Weeks,47986,47986,1.0,0,0.0,2006,2006.csv
9847,Saving Banksy,47965,47965,1.0,0,0.0,2017,2017.csv
9848,The Queen,47818,47818,1.0,0,0.0,2019,2019.csv
9849,Alphaville,47696,47696,1.0,0,0.0,2014,2014.csv
9850,So B. It,47627,47627,1.0,0,0.0,2017,2017.csv
9851,Laila's Birthday,47622,13689,0.28745117802696235,33933,0.7125488219730377,2009,2009.csv
9852,GMO OMG,47558,47558,1.0,0,0.0,2013,2013.csv
9853,350 Days - Legends. Champions. Survivors,47526,47526,1.0,0,0.0,2018,2018.csv
9854,Entre les Bras,47439,47439,1.0,0,0.0,2012,2012.csv
9855,Twist,47370,47370,1.0,0,0.0,2004,2004.csv
9856,Alabama Moon,47305,47305,1.0,0,0.0,2011,2011.csv
9857,Daughters of the Dust 2016 Re-release,47287,40986,0.8667498466809059,6301,0.13325015331909404,2016,2016.csv
9858,The Raft,47269,39678,0.8394084918233937,7591,0.16059150817660622,2019,2019.csv
9859,Every Man for Himself,47262,47262,1.0,0,0.0,2010,2010.csv
9860,Tibet: A Buddhist Trilogy,47243,47243,1.0,0,0.0,2006,2006.csv
9861,Never Been Thawed,47219,47219,1.0,0,0.0,2005,2005.csv
9862,Went the Day Well?,47214,47214,1.0,0,0.0,2011,2011.csv
9863,The Goebbels Experiment,47211,47211,1.0,0,0.0,2005,2005.csv
9864,VHYes,47037,47037,1.0,0,0.0,2020,2020.csv
9865,Ivans xtc.,47027,47027,1.0,0,0.0,2002,2002.csv
9866,Diary of a Country Priest,47000,47000,1.0,0,0.0,2011,2011.csv
9867,Collapse,46964,46964,1.0,0,0.0,2009,2009.csv
9868,A Master Builder,46874,46874,1.0,0,0.0,2014,2014.csv
9869,Enter the Fat Dragon,46855,46855,1.0,0,0.0,2020,2020.csv
9870,78/52: Hitchcock's Shower Scene,46838,37664,0.8041333959605449,9174,0.19586660403945513,2017,2017.csv
9871,"Connected: An Autoblogography About Love, Death & Technology",46782,46782,1.0,0,0.0,2011,2011.csv
9872,Tropical Malady,46750,46750,1.0,0,0.0,2005,2005.csv
9873,The Woodmans,46623,46623,1.0,0,0.0,2011,2011.csv
9874,Casi divas 2009 Re-release,46612,46612,1.0,0,0.0,2009,2009.csv
9875,Beeswax,46590,46590,1.0,0,0.0,2009,2009.csv
9876,Ca$h,46488,46488,1.0,0,0.0,2010,2010.csv
9877,Shanghai 2015 Re-release,46425,46425,1.0,0,0.0,2015,2015.csv
9878,Etoiles: Dancers of the Paris Opera Ballet,46412,46412,1.0,0,0.0,2002,2002.csv
9879,Patience,46410,15941,0.34348200818789054,30469,0.6565179918121095,2012,2012.csv
9880,Mediterranea,46392,22076,0.4758579065356096,24316,0.5241420934643904,2015,2015.csv
9881,William S. Burroughs: A Man Within,46380,46380,1.0,0,0.0,2010,2010.csv
9882,New Best Friend,46375,46375,1.0,0,0.0,2002,2002.csv
9883,The Tunnel 2005 Re-release,46296,46296,1.0,0,0.0,2005,2005.csv
9884,The Hip Hop Project,46208,46208,1.0,0,0.0,2007,2007.csv
9885,Greedy Lying Bastards,46121,45000,0.9756943691593851,1121,0.024305630840614906,2012,2012.csv
9886,Ballplayer: Pelotero,46109,46109,1.0,0,0.0,2012,2012.csv
9887,William Kunstler: Disturbing the Universe,46078,46078,1.0,0,0.0,2009,2009.csv
9888,Breakfast with Scot,46060,46060,1.0,0,0.0,2008,2008.csv
9889,Panique,46041,46041,1.0,0,0.0,2017,2017.csv
9890,Every Day,46029,46029,1.0,0,0.0,2011,2011.csv
9891,Babyteeth,46014,4507,0.0979484504715956,41507,0.9020515495284044,2020,2020.csv
9892,Monk with a Camera,45938,45938,1.0,0,0.0,2014,2014.csv
9893,Maurice 2017 Re-release,45926,45926,1.0,0,0.0,2017,2017.csv
9894,Ellie Parker,45726,34410,0.7525259152342212,11316,0.24747408476577876,2005,2005.csv
9895,High on the Hog,45696,45696,1.0,0,0.0,2019,2019.csv
9896,Eddie: The Sleepwalking Cannibal,45604,1632,0.035786334532058595,43972,0.9642136654679414,2012,2012.csv
9897,3 Weeks in Yerevan,45536,45536,1.0,0,0.0,2016,2016.csv
9898,An Eye for Beauty,45513,9395,0.20642453804407532,36118,0.7935754619559247,2015,2015.csv
9899,Straight-Jacket,45497,45497,1.0,0,0.0,2004,2004.csv
9900,Mercury,45429,0,0.0,45429,1.0,2018,2018.csv
9901,Randy and the Mob,45410,45410,1.0,0,0.0,2007,2007.csv
9902,Filmistaan,45406,45406,1.0,0,0.0,2014,2014.csv
9903,Au Hasard Balthazar,45406,45406,1.0,0,0.0,2003,2003.csv
9904,Return to the Hiding Place,45405,45405,1.0,0,0.0,2014,2014.csv
9905,Dhadkan,45380,45380,1.0,0,0.0,2000,2000.csv
9906,Sympathy for Mr. Vengeance 2005 Re-release,45289,45289,1.0,0,0.0,2005,2005.csv
9907,Ai Weiwei: The Fake Case,45255,45255,1.0,0,0.0,2014,2014.csv
9908,There's No Place Like Utopia,45254,45254,1.0,0,0.0,2014,2014.csv
9909,Karobaar: The Business of Love,45200,45200,1.0,0,0.0,2000,2000.csv
9910,CornerStore,45176,45176,1.0,0,0.0,2011,2011.csv
9911,American Made Movie,45175,45175,1.0,0,0.0,2013,2013.csv
9912,The Proposal,45149,45149,1.0,0,0.0,2019,2019.csv
9913,Bailey's Billion$,45000,45000,1.0,0,0.0,2005,2005.csv
9914,Undoing,44999,44999,1.0,0,0.0,2008,2008.csv
9915,The Farthest,44921,14773,0.32886623182921126,30148,0.6711337681707887,2017,2017.csv
9916,Celebration,44898,22557,0.5024054523586797,22341,0.49759454764132033,2019,2019.csv
9917,The Pruitt-Igoe Myth,44883,44883,1.0,0,0.0,2012,2012.csv
9918,What Doesn't Kill You,44872,0,0.0,44872,1.0,2008,2008.csv
9919,The Babysitters,44852,44852,1.0,0,0.0,2008,2008.csv
9920,River of Fundament,44840,44840,1.0,0,0.0,2015,2015.csv
9921,Union Square,44830,44830,1.0,0,0.0,2012,2012.csv
9922,Pressure Cooker,44803,44803,1.0,0,0.0,2009,2009.csv
9923,That Summer,44659,34556,0.7737746031035178,10103,0.22622539689648224,2018,2018.csv
9924,The Dog,44581,44581,1.0,0,0.0,2014,2014.csv
9925,The Bride Wore Black,44566,44566,1.0,0,0.0,2011,2011.csv
9926,What Is Democracy?,44536,44536,1.0,0,0.0,2019,2019.csv
9927,"Léon Morin, Priest 2017 Re-release",44511,44511,1.0,0,0.0,2017,2017.csv
9928,Defendor,44462,44462,1.0,0,0.0,2010,2010.csv
9929,William Eggleston in the Real World,44435,44435,1.0,0,0.0,2005,2005.csv
9930,Maze 2019 Re-release,44381,44381,1.0,0,0.0,2019,2019.csv
9931,Such a Long Journey,44364,44364,1.0,0,0.0,2000,2000.csv
9932,Saint Frances,44330,44330,1.0,0,0.0,2020,2020.csv
9933,What You Gonna Do When the World's on Fire?,44290,4672,0.10548656581621134,39618,0.8945134341837887,2019,2019.csv
9934,Lana's Rain,44287,44287,1.0,0,0.0,2004,2004.csv
9935,Carmine Street Guitars,44253,44253,1.0,0,0.0,2019,2019.csv
9936,Slut in a Good Way,44240,40513,0.915754972875226,3727,0.08424502712477396,2019,2019.csv
9937,Nuts!,44230,44230,1.0,0,0.0,2016,2016.csv
9938,Danny Says,44213,44213,1.0,0,0.0,2016,2016.csv
9939,Life of a King,44161,6547,0.14825298340164397,37614,0.851747016598356,2014,2014.csv
9940,Hermia & Helena,44156,43152,0.9772624331914123,1004,0.022737566808587736,2017,2017.csv
9941,Apaharan,44133,44133,1.0,0,0.0,2005,2005.csv
9942,Submission,44069,39985,0.9073271460663959,4084,0.09267285393360412,2018,2018.csv
9943,Liyana,44045,44045,1.0,0,0.0,2018,2018.csv
9944,Garry Winogrand: All Things are Photographable,44002,44002,1.0,0,0.0,2018,2018.csv
9945,Granito,43942,43942,1.0,0,0.0,2011,2011.csv
9946,The Circle,43918,43918,1.0,0,0.0,2001,2001.csv
9947,All Roads Lead Home,43907,43907,1.0,0,0.0,2008,2008.csv
9948,Summer 2011 Re-release,43839,43839,1.0,0,0.0,2011,2011.csv
9949,Altered,43836,0,0.0,43836,1.0,2007,2007.csv
9950,Animal Factory,43805,43805,1.0,0,0.0,2000,2000.csv
9951,Hitler's Hollywood,43766,43766,1.0,0,0.0,2018,2018.csv
9952,Contempt 2013 Re-release,43763,43763,1.0,0,0.0,2013,2013.csv
9953,Bad Blood 2013 Re-release,43758,35176,0.8038758626993922,8582,0.19612413730060788,2013,2013.csv
9954,The Land,43756,43756,1.0,0,0.0,2016,2016.csv
9955,Bereavement,43712,43712,1.0,0,0.0,2011,2011.csv
9956,Woodshock,43682,42603,0.9752987500572318,1079,0.024701249942768188,2017,2017.csv
9957,A Grin Without A Cat,43616,43616,1.0,0,0.0,2002,2002.csv
9958,The Golden Boys,43600,43600,1.0,0,0.0,2009,2009.csv
9959,"February 15, 1839",43595,43595,1.0,0,0.0,2001,2001.csv
9960,Love Etc.,43593,43593,1.0,0,0.0,2011,2011.csv
9961,"OC87: The Obsessive Compulsive, Major Depression, Bipolar, Asperger's Movie",43583,43583,1.0,0,0.0,2012,2012.csv
9962,The Graduate 45th Anniversary Reunion,43466,43466,1.0,0,0.0,2012,2012.csv
9963,If You Build It,43393,43393,1.0,0,0.0,2014,2014.csv
9964,The Empire of Corpses,43320,0,0.0,43320,1.0,2016,2016.csv
9965,Next Goal Wins,43089,43089,1.0,0,0.0,2014,2014.csv
9966,3 Backyards,43073,43073,1.0,0,0.0,2011,2011.csv
9967,Jenny's Wedding,42927,4704,0.10958138234677475,38223,0.8904186176532253,2015,2015.csv
9968,Hadh Kar Di Aapne,42914,42914,1.0,0,0.0,2000,2000.csv
9969,Tell Them Who You Are,42908,39075,0.9106693390509928,3833,0.08933066094900718,2005,2005.csv
9970,Andre Gregory: Before and After Dinner,42892,42892,1.0,0,0.0,2013,2013.csv
9971,Tekkonkinkreet,42840,6000,0.1400560224089636,36840,0.8599439775910365,2007,2007.csv
9972,First We Take Brooklyn,42812,42812,1.0,0,0.0,2018,2018.csv
9973,White Palms,42630,0,0.0,42630,1.0,2007,2007.csv
9974,La petite Lili 2004 Re-release,42628,34634,0.812470676550624,7994,0.187529323449376,2004,2004.csv
9975,Moving McAllister,42538,42538,1.0,0,0.0,2007,2007.csv
9976,Interior. Leather Bar.,42534,42534,1.0,0,0.0,2014,2014.csv
9977,Bolivia,42451,33098,0.7796753904501661,9353,0.22032460954983393,2002,2002.csv
9978,Last Call at the Oasis,42423,42423,1.0,0,0.0,2012,2012.csv
9979,Fixing the Future,42393,42393,1.0,0,0.0,2012,2012.csv
9980,Secret Lives: Hidden Children and Their Rescuers During WWII,42390,42390,1.0,0,0.0,2003,2003.csv
9981,Closet Monster,42360,42166,0.9954202077431539,194,0.004579792256846081,2016,2016.csv
9982,The Tracey Fragments,42318,32645,0.7714211446665722,9673,0.22857885533342787,2008,2008.csv
9983,The Oath,42273,42273,1.0,0,0.0,2010,2010.csv
9984,Girlhood,42213,37977,0.8996517660436358,4236,0.10034823395636415,2002,2002.csv
9985,Death of a Dynasty,42108,42108,1.0,0,0.0,2005,2005.csv
9986,Our Time,42107,14777,0.3509392737549576,27330,0.6490607262450424,2019,2019.csv
9987,Down for Life,41914,41914,1.0,0,0.0,2011,2011.csv
9988,In Pursuit of Silence,41913,29834,0.7118077923317347,12079,0.2881922076682652,2016,2016.csv
9989,Golden Exits,41888,41888,1.0,0,0.0,2018,2018.csv
9990,The Nightmare,41853,28281,0.675722170453731,13572,0.3242778295462691,2015,2015.csv
9991,Azumi 2006 Re-release,41803,41803,1.0,0,0.0,2006,2006.csv
9992,On the Bowery,41802,41802,1.0,0,0.0,2010,2010.csv
9993,Blackboards,41772,23520,0.5630565929330652,18252,0.4369434070669348,2002,2002.csv
9994,The Road Within,41760,0,0.0,41760,1.0,2015,2015.csv
9995,Thomas Kinkade's Christmas Cottage,41724,0,0.0,41724,1.0,2008,2008.csv
9996,We Live in Public,41711,41711,1.0,0,0.0,2009,2009.csv
9997,Adored,41703,41703,1.0,0,0.0,2004,2004.csv
9998,Union,41656,41656,1.0,0,0.0,2019,2019.csv
9999,Kalakalappu,41624,30949,0.7435373822794542,10675,0.25646261772054585,2012,2012.csv
10000,Death of a Superhero,41575,607,0.014600120264582081,40968,0.9853998797354179,2012,2012.csv
10001,The Settlers,41562,41562,1.0,0,0.0,2017,2017.csv
10002,Jonathan,41558,0,0.0,41558,1.0,2018,2018.csv
10003,Holla II,41537,41537,1.0,0,0.0,2013,2013.csv
10004,My Mother's Smile 2005 Re-release,41432,41432,1.0,0,0.0,2005,2005.csv
10005,The Betrayal,41271,41271,1.0,0,0.0,2008,2008.csv
10006,Censored Voices,41260,41260,1.0,0,0.0,2015,2015.csv
10007,Steve McQueen: The Man & Le Mans,41203,6843,0.16608013979564595,34360,0.833919860204354,2015,2015.csv
10008,Vlad,41176,0,0.0,41176,1.0,2004,2004.csv
10009,Colma: The Musical,41131,41131,1.0,0,0.0,2007,2007.csv
10010,The Comedy,41113,41113,1.0,0,0.0,2012,2012.csv
10011,Karl Marx City,41072,41072,1.0,0,0.0,2017,2017.csv
10012,Blue Iguana,41050,0,0.0,41050,1.0,2018,2018.csv
10013,The Myth of the American Sleepover,41045,41045,1.0,0,0.0,2011,2011.csv
10014,Canvas,41010,35630,0.8688124847598147,5380,0.13118751524018532,2007,2007.csv
10015,Fat Kid Rules the World,41000,41000,1.0,0,0.0,2012,2012.csv
10016,Why Don't You Just Die!,40995,0,0.0,40995,1.0,2019,2019.csv
10017,Hell and Back Again,40949,40634,0.9923075044567633,315,0.007692495543236709,2011,2011.csv
10018,I Can't Think Straight,40945,39576,0.9665649041396996,1369,0.033435095860300405,2008,2008.csv
10019,Tom Dowd & the Language of Music,40919,40919,1.0,0,0.0,2004,2004.csv
10020,Moving Midway,40864,40864,1.0,0,0.0,2008,2008.csv
10021,Simon Magus,40861,40861,1.0,0,0.0,2001,2001.csv
10022,The Intruder,40853,40853,1.0,0,0.0,2005,2005.csv
10023,Hate Crime,40758,40758,1.0,0,0.0,2005,2005.csv
10024,Found Memories,40729,10575,0.25964300621179015,30154,0.7403569937882098,2012,2012.csv
10025,Shikari,40712,40712,1.0,0,0.0,2000,2000.csv
10026,Language of a Broken Heart,40645,40645,1.0,0,0.0,2013,2013.csv
10027,Mercedes Sosa: The Voice of Latin America,40643,2648,0.06515267081662279,37995,0.9348473291833772,2013,2013.csv
10028,Life and Nothing More,40581,24358,0.6002316354944432,16223,0.3997683645055568,2017,2017.csv
10029,Tying the Knot,40576,40576,1.0,0,0.0,2004,2004.csv
10030,My Flesh and Blood,40573,40573,1.0,0,0.0,2003,2003.csv
10031,The FP,40557,40557,1.0,0,0.0,2012,2012.csv
10032,Backstage,40507,12663,0.31261263485323526,27844,0.6873873651467648,2006,2006.csv
10033,The Dhamma Brothers,40492,40492,1.0,0,0.0,2008,2008.csv
10034,Sex Is Comedy 2004 Re-release,40470,40470,1.0,0,0.0,2004,2004.csv
10035,CBGB,40400,40400,1.0,0,0.0,2013,2013.csv
10036,Terkel in Trouble 2010 Re-release,40385,40385,1.0,0,0.0,2010,2010.csv
10037,Committed,40361,40361,1.0,0,0.0,2000,2000.csv
10038,Bliss 2009 Re-release,40349,40349,1.0,0,0.0,2009,2009.csv
10039,Zizek!,40331,20177,0.5002851404626714,20154,0.4997148595373286,2005,2005.csv
10040,Of Mind and Music,40322,15073,0.37381578294727447,25249,0.6261842170527255,2016,2016.csv
10041,Paan Singh Tomar,40311,40311,1.0,0,0.0,2012,2012.csv
10042,The Red Baron 2010 Re-release,40239,37189,0.9242028877457193,3050,0.07579711225428068,2010,2010.csv
10043,Khosla's Nest,40194,26472,0.6586057620540379,13722,0.3413942379459621,2006,2006.csv
10044,Yiddish Theater: A Love Story,40182,40182,1.0,0,0.0,2007,2007.csv
10045,Teenage,40169,40169,1.0,0,0.0,2014,2014.csv
10046,On Her Shoulders,40145,28288,0.7046456594843692,11857,0.29535434051563086,2018,2018.csv
10047,Aniara,40124,40124,1.0,0,0.0,2019,2019.csv
10048,Margaret Cho: Assassin,40123,40123,1.0,0,0.0,2005,2005.csv
10049,Addiction Incorporated,40106,40106,1.0,0,0.0,2011,2011.csv
10050,Humor Me,40099,40099,1.0,0,0.0,2018,2018.csv
10051,Unrest,40081,40081,1.0,0,0.0,2017,2017.csv
10052,Ghost River 2004 Re-release,40029,40029,1.0,0,0.0,2004,2004.csv
10053,Louder Than a Bomb,40000,40000,1.0,0,0.0,2011,2011.csv
10054,Rape of the Soul,39975,39975,1.0,0,0.0,2006,2006.csv
10055,Is That a Gun in Your Pocket?,39928,39928,1.0,0,0.0,2016,2016.csv
10056,Good Dick,39924,27595,0.6911882576896102,12329,0.3088117423103897,2008,2008.csv
10057,Justice,39895,39895,1.0,0,0.0,2004,2004.csv
10058,Loins of Punjab Presents,39891,39891,1.0,0,0.0,2008,2008.csv
10059,The Short Game,39819,39819,1.0,0,0.0,2013,2013.csv
10060,Plot for Peace,39811,7051,0.17711185350782446,32760,0.8228881464921756,2013,2013.csv
10061,Freeze Frame,39663,1100,0.027733656052240124,38563,0.9722663439477599,2004,2004.csv
10062,Port of Shadows,39623,27389,0.6912399364005755,12234,0.3087600635994246,2012,2012.csv
10063,An Elephant Sitting Still,39599,32556,0.8221419732821535,7043,0.17785802671784642,2018,2018.csv
10064,The Homeless Billionaire,39493,39493,1.0,0,0.0,2016,2016.csv
10065,Refusenik,39456,39456,1.0,0,0.0,2008,2008.csv
10066,Power Trip,39359,39359,1.0,0,0.0,2003,2003.csv
10067,Prophet's Prey,39347,39347,1.0,0,0.0,2015,2015.csv
10068,Child of God,39324,39324,1.0,0,0.0,2014,2014.csv
10069,"3 1/2 Minutes, 10 Bullets",39263,30407,0.7744441331533505,8856,0.22555586684664952,2015,2015.csv
10070,La Notte,39236,39236,1.0,0,0.0,2016,2016.csv
10071,Where Soldiers Come From,39201,39201,1.0,0,0.0,2011,2011.csv
10072,Sea of Dreams 2007 Re-release,39200,39200,1.0,0,0.0,2007,2007.csv
10073,How to Make Money Selling Drugs,39192,39192,1.0,0,0.0,2013,2013.csv
10074,I Do Not Care If We Go Down in History as Barbarians,39171,11307,0.2886574251359424,27864,0.7113425748640576,2018,2018.csv
10075,The Expedition to the End of the World,39115,39115,1.0,0,0.0,2014,2014.csv
10076,Zilla and Zoe,39003,39003,1.0,0,0.0,2019,2019.csv
10077,I Used to Be Darker,38974,22214,0.5699697234053471,16760,0.43003027659465287,2013,2013.csv
10078,The Life of Reilly,38960,38960,1.0,0,0.0,2007,2007.csv
10079,Herb & Dorothy 50X50,38933,38933,1.0,0,0.0,2013,2013.csv
10080,Shed of the Dead,38901,38901,1.0,0,0.0,2019,2019.csv
10081,The Son of Joseph,38774,30588,0.7888791458193635,8186,0.2111208541806365,2016,2016.csv
10082,Restored Me,38745,38745,1.0,0,0.0,2016,2016.csv
10083,Bluebeard,38696,33490,0.8654641306594997,5206,0.1345358693405003,2010,2010.csv
10084,The Blossoming of Maximo Oliveros,38691,28041,0.7247421881057611,10650,0.275257811894239,2006,2006.csv
10085,Paul Williams Still Alive,38691,38691,1.0,0,0.0,2012,2012.csv
10086,Catching the Sun,38613,38613,1.0,0,0.0,2016,2016.csv
10087,A Rumor of Angels,38610,38610,1.0,0,0.0,2002,2002.csv
10088,The Year of the Yao,38585,35591,0.9224050796941817,2994,0.07759492030581833,2005,2005.csv
10089,Spa Night,38578,38578,1.0,0,0.0,2016,2016.csv
10090,Troublemakers: The Story of Land Art,38571,29462,0.7638381167198154,9109,0.2361618832801846,2016,2016.csv
10091,Divide and Conquer,38510,38510,1.0,0,0.0,2018,2018.csv
10092,Death by China,38492,38492,1.0,0,0.0,2012,2012.csv
10093,Multiple Maniacs,38403,33036,0.860245293336458,5367,0.13975470666354192,2016,2016.csv
10094,Araby,38399,38399,1.0,0,0.0,2018,2018.csv
10095,Batman Forever 2019 Re-release,38387,38014,0.9902831687810978,373,0.009716831218902232,2019,2019.csv
10096,Nine Nation Animation,38382,38382,1.0,0,0.0,2010,2010.csv
10097,The Blackcoat's Daughter,38348,20435,0.5328830708250756,17913,0.46711692917492437,2017,2017.csv
10098,Small Change,38296,38296,1.0,0,0.0,2009,2009.csv
10099,Policeman,38263,11263,0.29435747327705614,27000,0.7056425267229438,2013,2013.csv
10100,No Intenso Agora,38223,24955,0.6528791565287916,13268,0.3471208434712084,2018,2018.csv
10101,Shadow Hours,38181,38181,1.0,0,0.0,2000,2000.csv
10102,Germans & Jews,38100,38100,1.0,0,0.0,2016,2016.csv
10103,The Legend of Pale Male,38083,38083,1.0,0,0.0,2010,2010.csv
10104,All About Lily Chou-Chou,38082,26485,0.6954729268420776,11597,0.3045270731579224,2002,2002.csv
10105,Gray Matter,38034,38034,1.0,0,0.0,2018,2018.csv
10106,Moscow Never Sleeps,38004,25306,0.6658772760762025,12698,0.3341227239237975,2016,2016.csv
10107,Band of Outsiders 2016 Re-release,38004,38004,1.0,0,0.0,2016,2016.csv
10108,The Crime of Monsieur Lange,38002,36438,0.9588442713541393,1564,0.04115572864586074,2017,2017.csv
10109,Russian Ark 2013 Re-release,37984,37984,1.0,0,0.0,2013,2013.csv
10110,Bollywood/Hollywood 2003 Re-release,37962,37962,1.0,0,0.0,2003,2003.csv
10111,Moondance Alexander,37895,37895,1.0,0,0.0,2007,2007.csv
10112,Adult World,37887,25368,0.6695700372159316,12519,0.3304299627840684,2014,2014.csv
10113,I Am the Blues,37849,37849,1.0,0,0.0,2017,2017.csv
10114,The Heart of Nuba,37788,37788,1.0,0,0.0,2018,2018.csv
10115,Khadak,37781,3139,0.08308408988645086,34642,0.9169159101135491,2007,2007.csv
10116,Out 1,37743,31539,0.835625149034258,6204,0.164374850965742,2015,2015.csv
10117,Mumia: Long Distance Revolutionary,37731,37731,1.0,0,0.0,2013,2013.csv
10118,Millennium Actress,37641,37641,1.0,0,0.0,2003,2003.csv
10119,Krystal,37516,37516,1.0,0,0.0,2018,2018.csv
10120,News from Planet Mars,37507,310,0.008265123843549204,37197,0.9917348761564508,2016,2016.csv
10121,Incident at Loch Ness,37493,37493,1.0,0,0.0,2004,2004.csv
10122,Big Sur,37466,37466,1.0,0,0.0,2013,2013.csv
10123,Back to Normandy,37430,503,0.013438418380977825,36927,0.9865615816190222,2007,2007.csv
10124,Raising Flagg,37329,4130,0.1106378418923625,33199,0.8893621581076375,2007,2007.csv
10125,Match 2015 Re-release,37285,37285,1.0,0,0.0,2015,2015.csv
10126,Memory: The Origins of Alien,37272,31378,0.8418652071259927,5894,0.1581347928740073,2019,2019.csv
10127,Savannah,37240,37240,1.0,0,0.0,2013,2013.csv
10128,This Thing of Ours,37227,37227,1.0,0,0.0,2003,2003.csv
10129,Benjamin Smoke,37111,37111,1.0,0,0.0,2000,2000.csv
10130,Eating Out 2: Sloppy Seconds,37072,37072,1.0,0,0.0,2006,2006.csv
10131,Small Group,37058,37058,1.0,0,0.0,2018,2018.csv
10132,24 Frames,37045,34482,0.9308138750168714,2563,0.06918612498312862,2018,2018.csv
10133,The Quiet One,37010,37010,1.0,0,0.0,2019,2019.csv
10134,Pavilion of Women,36992,36992,1.0,0,0.0,2001,2001.csv
10135,Children of Paradise 2012 Re-release,36986,36986,1.0,0,0.0,2012,2012.csv
10136,Grey Gardens,36923,36923,1.0,0,0.0,2015,2015.csv
10137,Kurukshetra,36890,36890,1.0,0,0.0,2000,2000.csv
10138,Trust Fund,36885,36885,1.0,0,0.0,2016,2016.csv
10139,Monkey Warfare,36875,36875,1.0,0,0.0,2006,2006.csv
10140,The Death of Dick Long,36856,36856,1.0,0,0.0,2019,2019.csv
10141,Three Christs,36723,36723,1.0,0,0.0,2020,2020.csv
10142,Uncertainty,36689,36689,1.0,0,0.0,2009,2009.csv
10143,Sister Code,36676,36676,1.0,0,0.0,2015,2015.csv
10144,Blind Mountain,36615,13164,0.3595247849242114,23451,0.6404752150757886,2007,2007.csv
10145,Mind Game,36613,36613,1.0,0,0.0,2018,2018.csv
10146,Bending the Arc,36586,21907,0.5987809544634559,14679,0.40121904553654403,2017,2017.csv
10147,Yoga Hosers,36585,0,0.0,36585,1.0,2016,2016.csv
10148,Paper Dolls,36577,36577,1.0,0,0.0,2006,2006.csv
10149,Hit So Hard,36576,34025,0.9302548118985127,2551,0.06974518810148732,2012,2012.csv
10150,Tread,36527,36527,1.0,0,0.0,2020,2020.csv
10151,For Those Who Don't Read Me,36506,36506,1.0,0,0.0,2018,2018.csv
10152,Cherry,36465,11362,0.31158645276292335,25103,0.6884135472370766,2010,2010.csv
10153,The Servant,36463,36463,1.0,0,0.0,2013,2013.csv
10154,The Umbrellas of Cherbourg,36432,28030,0.7693785682916118,8402,0.23062143170838822,2004,2004.csv
10155,From Here to Eternity,36416,36416,1.0,0,0.0,2003,2003.csv
10156,Been Rich All My Life,36406,36406,1.0,0,0.0,2006,2006.csv
10157,Waiting for Anya,36404,0,0.0,36404,1.0,2020,2020.csv
10158,Unexpected,36402,23986,0.6589198395692545,12416,0.34108016043074557,2015,2015.csv
10159,How to Let Go of the World: and Love All the Things Climate Can't Change,36386,36386,1.0,0,0.0,2016,2016.csv
10160,Welcome to Leith,36380,36010,0.9898295766904893,370,0.01017042330951072,2015,2015.csv
10161,Mansome,36280,36280,1.0,0,0.0,2012,2012.csv
10162,Loosies,36145,3519,0.09735786415825148,32626,0.9026421358417485,2012,2012.csv
10163,Touchy Feely,36128,36128,1.0,0,0.0,2013,2013.csv
10164,Dirty Love,36099,36099,1.0,0,0.0,2005,2005.csv
10165,Le Corbeau,36089,36089,1.0,0,0.0,2018,2018.csv
10166,Jiminy Glick in Lalawood,36039,36039,1.0,0,0.0,2005,2005.csv
10167,Brimstone & Glory,36036,32059,0.8896381396381396,3977,0.11036186036186037,2017,2017.csv
10168,"Kill Me, Deadly",36027,36027,1.0,0,0.0,2016,2016.csv
10169,Not Cool,36026,36026,1.0,0,0.0,2014,2014.csv
10170,Day Night Day Night,35933,31856,0.8865388361673114,4077,0.11346116383268862,2007,2007.csv
10171,Almost Friends,35842,1481,0.04132023882595837,34361,0.9586797611740416,2017,2017.csv
10172,The House of Tomorrow,35821,35821,1.0,0,0.0,2018,2018.csv
10173,Bangkok Revenge,35784,35784,1.0,0,0.0,2012,2012.csv
10174,The Road Movie,35757,35757,1.0,0,0.0,2018,2018.csv
10175,Good Manners,35714,31177,0.8729629837038696,4537,0.12703701629613037,2018,2018.csv
10176,Fighting Words,35688,35688,1.0,0,0.0,2007,2007.csv
10177,Paul Goodman Changed My Life,35671,35671,1.0,0,0.0,2011,2011.csv
10178,Far Out Isn't Far Enough: The Tomi Ungerer Story,35647,35647,1.0,0,0.0,2013,2013.csv
10179,After Freedom,35639,35639,1.0,0,0.0,2004,2004.csv
10180,Loro,35613,35613,1.0,0,0.0,2019,2019.csv
10181,M 2013 Re-release,35566,35566,1.0,0,0.0,2013,2013.csv
10182,Guy and Madeline on a Park Bench,35556,35556,1.0,0,0.0,2010,2010.csv
10183,Finders Keepers,35555,35555,1.0,0,0.0,2015,2015.csv
10184,The Event,35554,35554,1.0,0,0.0,2003,2003.csv
10185,PGS: Intuition Is Your Personal Guidance System,35423,35423,1.0,0,0.0,2018,2018.csv
10186,Kinyarwanda,35412,35412,1.0,0,0.0,2011,2011.csv
10187,Can Mr. Smith Get to Washington Anymore?,35397,35397,1.0,0,0.0,2006,2006.csv
10188,Max and the Junkmen,35387,35387,1.0,0,0.0,2012,2012.csv
10189,Le Jour Se Leve,35321,35321,1.0,0,0.0,2014,2014.csv
10190,Growing Up Smith,35312,35312,1.0,0,0.0,2017,2017.csv
10191,The Decent One,35282,21327,0.6044725355705459,13955,0.39552746442945413,2014,2014.csv
10192,Underdogs,35271,35271,1.0,0,0.0,2013,2013.csv
10193,Rat Film,35195,35195,1.0,0,0.0,2017,2017.csv
10194,Ága,35178,35178,1.0,0,0.0,2019,2019.csv
10195,That Man from Rio,35144,35144,1.0,0,0.0,2014,2014.csv
10196,"Goodbye, Dragon Inn",35120,35120,1.0,0,0.0,2004,2004.csv
10197,When Harry Tries to Marry,35100,35100,1.0,0,0.0,2011,2011.csv
10198,The Girl,35048,35048,1.0,0,0.0,2013,2013.csv
10199,Bon Jovi: Lost Highway - The Concert,35000,35000,1.0,0,0.0,2007,2007.csv
10200,Our City Dreams,34972,34972,1.0,0,0.0,2009,2009.csv
10201,Hotel,34971,29813,0.8525063624145721,5158,0.14749363758542794,2003,2003.csv
10202,A Decade Under the Influence,34837,34837,1.0,0,0.0,2003,2003.csv
10203,Campfire,34835,34835,1.0,0,0.0,2005,2005.csv
10204,Swimmers,34812,34812,1.0,0,0.0,2006,2006.csv
10205,Beneath the Harvest Sky,34768,34768,1.0,0,0.0,2014,2014.csv
10206,This Ain't No Mouse Music,34754,34754,1.0,0,0.0,2014,2014.csv
10207,Comic-Con Episode IV: A Fan's Hope,34665,34665,1.0,0,0.0,2012,2012.csv
10208,The Old Dark House,34649,25678,0.7410892089237785,8971,0.25891079107622156,2017,2017.csv
10209,Showboy,34646,34646,1.0,0,0.0,2004,2004.csv
10210,Sophie and the Rising Sun,34630,34630,1.0,0,0.0,2017,2017.csv
10211,Le Trou,34588,34588,1.0,0,0.0,2017,2017.csv
10212,Orchestra of Exiles,34577,34577,1.0,0,0.0,2012,2012.csv
10213,Rakuen Tsuiho: Expelled from Paradise,34510,34510,1.0,0,0.0,2014,2014.csv
10214,Cosmos,34393,25856,0.7517808856453349,8537,0.2482191143546652,2015,2015.csv
10215,Pierrot le Fou 2015 Re-release,34371,34371,1.0,0,0.0,2015,2015.csv
10216,Holy Hell,34366,34366,1.0,0,0.0,2018,2018.csv
10217,Off the Rails,34249,34249,1.0,0,0.0,2016,2016.csv
10218,Rocks in My Pockets,34236,34236,1.0,0,0.0,2014,2014.csv
10219,Martin & Orloff,34222,34222,1.0,0,0.0,2003,2003.csv
10220,Just Like a Woman,34206,11403,0.3333625679705315,22803,0.6666374320294686,2013,2013.csv
10221,American Gun,34138,24098,0.7058995840412443,10040,0.29410041595875563,2006,2006.csv
10222,Dave Made a Maze,34117,34117,1.0,0,0.0,2017,2017.csv
10223,Beautiful Darling,34096,34096,1.0,0,0.0,2011,2011.csv
10224,Familiar Strangers,34068,34068,1.0,0,0.0,2008,2008.csv
10225,Kilo Two Bravo,34017,7891,0.23197224916953288,26126,0.7680277508304671,2015,2015.csv
10226,Bert Stern: Original Madman,34005,34005,1.0,0,0.0,2013,2013.csv
10227,Your Mommy Kills Animals!,34000,34000,1.0,0,0.0,2007,2007.csv
10228,Maui,33953,33953,1.0,0,0.0,2018,2018.csv
10229,Killer Unicorn,33901,33901,1.0,0,0.0,2019,2019.csv
10230,Signs & Wonders,33842,33842,1.0,0,0.0,2001,2001.csv
10231,Moonlight Sonata: Deafness in Three Movements,33823,33823,1.0,0,0.0,2019,2019.csv
10232,It Felt Like Love,33817,33817,1.0,0,0.0,2014,2014.csv
10233,Brief Interviews with Hideous Men,33745,33745,1.0,0,0.0,2009,2009.csv
10234,Closed Curtain,33735,28098,0.8329035126722988,5637,0.1670964873277012,2014,2014.csv
10235,Itty Bitty Titty Committee,33723,18445,0.5469560833852267,15278,0.4530439166147733,2007,2007.csv
10236,Below Her Mouth,33673,0,0.0,33673,1.0,2017,2017.csv
10237,"My Country, My Country",33620,33620,1.0,0,0.0,2006,2006.csv
10238,The Turandot Project,33504,33504,1.0,0,0.0,2001,2001.csv
10239,Making the Boys,33443,33443,1.0,0,0.0,2011,2011.csv
10240,The Winding Stream,33420,33420,1.0,0,0.0,2015,2015.csv
10241,Final Girl,33411,0,0.0,33411,1.0,2015,2015.csv
10242,"Distant Voices, Still Lives 2018 Re-release",33301,5234,0.15717245728356505,28067,0.8428275427164349,2018,2018.csv
10243,Running from Crazy,33300,33300,1.0,0,0.0,2013,2013.csv
10244,Life: A User's Manual,33236,33236,1.0,0,0.0,2001,2001.csv
10245,Loverboy 2006 Re-release,33223,33223,1.0,0,0.0,2006,2006.csv
10246,Daddy Longlegs,33217,21766,0.6552668814161423,11451,0.3447331185838577,2010,2010.csv
10247,Mississippi Mermaid,33216,33216,1.0,0,0.0,2009,2009.csv
10248,Wasted! The Story of Food Waste,33211,33211,1.0,0,0.0,2017,2017.csv
10249,Redoubt,33155,33155,1.0,0,0.0,2019,2019.csv
10250,Love & Taxes,33150,33150,1.0,0,0.0,2017,2017.csv
10251,American Teacher,33144,33144,1.0,0,0.0,2011,2011.csv
10252,Super Dark Times,33109,33109,1.0,0,0.0,2017,2017.csv
10253,Dislecksia: The Movie,33066,33066,1.0,0,0.0,2013,2013.csv
10254,Falling for Grace,33060,33060,1.0,0,0.0,2007,2007.csv
10255,Meet Monica Velour,33042,33042,1.0,0,0.0,2011,2011.csv
10256,Ahead of Time: The Extraordinary Journey of Ruth Gruber,33024,33024,1.0,0,0.0,2010,2010.csv
10257,Albatross,32992,0,0.0,32992,1.0,2011,2011.csv
10258,Being Charlie,32964,30400,0.9222181774056547,2564,0.07778182259434535,2016,2016.csv
10259,Spoken Word,32961,32961,1.0,0,0.0,2010,2010.csv
10260,The Intervention,32919,32919,1.0,0,0.0,2016,2016.csv
10261,Smile,32833,32833,1.0,0,0.0,2005,2005.csv
10262,Local Color,32788,32788,1.0,0,0.0,2007,2007.csv
10263,No Home Movie,32757,32757,1.0,0,0.0,2016,2016.csv
10264,Controlled Chaos 2007 Re-release,32740,32740,1.0,0,0.0,2007,2007.csv
10265,L'Age d'Or,32712,32712,1.0,0,0.0,2004,2004.csv
10266,The Nun,32659,30245,0.9260846933463976,2414,0.07391530665360238,2018,2018.csv
10267,Boesman and Lena,32625,32625,1.0,0,0.0,2000,2000.csv
10268,Sollers Point,32608,32608,1.0,0,0.0,2018,2018.csv
10269,The Day I Saw Your Heart 2012 Re-release,32567,3546,0.10888322535081524,29021,0.8911167746491847,2012,2012.csv
10270,Spettacolo,32494,32494,1.0,0,0.0,2017,2017.csv
10271,Boxing Gym,32476,32476,1.0,0,0.0,2010,2010.csv
10272,Fuel,32465,32465,1.0,0,0.0,2009,2009.csv
10273,Rurouni Kenshin Part I: Origins 2016 Re-release,32445,32445,1.0,0,0.0,2016,2016.csv
10274,An Acceptable Loss,32427,32427,1.0,0,0.0,2019,2019.csv
10275,Brotherhood,32416,19722,0.6084032576505429,12694,0.39159674234945707,2010,2010.csv
10276,10E,32413,32413,1.0,0,0.0,2019,2019.csv
10277,Beetle Queen Conquers Tokyo,32308,32308,1.0,0,0.0,2010,2010.csv
10278,Living in Emergency,32208,32208,1.0,0,0.0,2010,2010.csv
10279,Sacco and Vanzetti,32203,32203,1.0,0,0.0,2007,2007.csv
10280,The Hero of Color City,32188,32188,1.0,0,0.0,2014,2014.csv
10281,Goodland,32140,32140,1.0,0,0.0,2018,2018.csv
10282,Pontypool,32118,3865,0.12033750544865807,28253,0.8796624945513419,2009,2009.csv
10283,Glass: A Portrait of Philip in Twelve Parts,32089,20018,0.6238274798217458,12071,0.37617252017825425,2008,2008.csv
10284,The Weekend,32050,32050,1.0,0,0.0,2000,2000.csv
10285,Shooting the Mafia,32042,10881,0.33958554397353474,21161,0.6604144560264653,2019,2019.csv
10286,Kiss the Bride,32033,32033,1.0,0,0.0,2008,2008.csv
10287,Desolation Center,32016,32016,1.0,0,0.0,2019,2019.csv
10288,Last Life in the Universe,32014,32014,1.0,0,0.0,2004,2004.csv
10289,"Rio, I Love You 2016 Re-release",31982,31982,1.0,0,0.0,2016,2016.csv
10290,Moynihan,31970,31970,1.0,0,0.0,2018,2018.csv
10291,District of Corruption,31954,31954,1.0,0,0.0,2012,2012.csv
10292,Reel Paradise,31918,31918,1.0,0,0.0,2005,2005.csv
10293,Going Shopping,31908,31908,1.0,0,0.0,2005,2005.csv
10294,Amira & Sam,31849,31849,1.0,0,0.0,2015,2015.csv
10295,The Pleasure of Being Robbed,31823,10687,0.3358262891619269,21136,0.6641737108380731,2008,2008.csv
10296,Paths of the Soul,31747,31747,1.0,0,0.0,2016,2016.csv
10297,180° South,31745,31745,1.0,0,0.0,2010,2010.csv
10298,At Berkeley,31736,31736,1.0,0,0.0,2013,2013.csv
10299,Aurora,31720,5677,0.1789722572509458,26043,0.8210277427490542,2011,2011.csv
10300,Glowing Eyes,31653,31653,1.0,0,0.0,2003,2003.csv
10301,Gift,31588,31588,1.0,0,0.0,2019,2019.csv
10302,Signature Move,31551,31551,1.0,0,0.0,2017,2017.csv
10303,The Cat Rescuers,31540,31540,1.0,0,0.0,2019,2019.csv
10304,The Passionate Thief,31539,31539,1.0,0,0.0,2014,2014.csv
10305,Forever,31502,31502,1.0,0,0.0,2007,2007.csv
10306,Musical Chairs,31478,31478,1.0,0,0.0,2012,2012.csv
10307,Celine and Julie Go Boating,31452,31452,1.0,0,0.0,2012,2012.csv
10308,Beyond the Farthest Star,31433,31433,1.0,0,0.0,2013,2013.csv
10309,Here,31428,26743,0.8509291078019601,4685,0.14907089219803996,2012,2012.csv
10310,Fabled,31425,31425,1.0,0,0.0,2004,2004.csv
10311,Sidemen: Long Road to Glory,31399,31399,1.0,0,0.0,2017,2017.csv
10312,Mudbound,31389,0,0.0,31389,1.0,2017,2017.csv
10313,Don Verdean,31309,31309,1.0,0,0.0,2015,2015.csv
10314,Funny Money,31290,2844,0.09089165867689358,28446,0.9091083413231065,2007,2007.csv
10315,Bootmen,31288,31288,1.0,0,0.0,2000,2000.csv
10316,Hats Off,31272,31272,1.0,0,0.0,2008,2008.csv
10317,The Raspberry Reich,31211,31211,1.0,0,0.0,2004,2004.csv
10318,Buddy,31203,31203,1.0,0,0.0,2019,2019.csv
10319,I'm Glad My Mother Is Alive,31140,8705,0.27954399486191395,22435,0.720456005138086,2009,2009.csv
10320,"Hey, Boo: Harper Lee and 'To Kill a Mockingbird'",31135,31135,1.0,0,0.0,2011,2011.csv
10321,Small Town Murder Songs,31133,31133,1.0,0,0.0,2011,2011.csv
10322,7 Witches,31100,31100,1.0,0,0.0,2017,2017.csv
10323,White Irish Drinkers,31056,31056,1.0,0,0.0,2011,2011.csv
10324,Poor Boy,31031,31031,1.0,0,0.0,2018,2018.csv
10325,Chooch,31015,31015,1.0,0,0.0,2004,2004.csv
10326,"2 Autumns, 3 Winters",30985,5819,0.18780054865257384,25166,0.8121994513474262,2014,2014.csv
10327,The Seventh Fire,30977,30112,0.9720760564289634,865,0.027923943571036575,2016,2016.csv
10328,Who Is Harry Nilsson (And Why Is Everybody Talkin' About Him?),30975,30975,1.0,0,0.0,2010,2010.csv
10329,Super Capers: The Origins of Ed and the Missing Bullion,30955,30955,1.0,0,0.0,2009,2009.csv
10330,The Exiles,30945,30945,1.0,0,0.0,2008,2008.csv
10331,Gangster No. 1,30915,30915,1.0,0,0.0,2002,2002.csv
10332,Sans Soleil,30878,30878,1.0,0,0.0,2003,2003.csv
10333,La Chinoise,30857,30857,1.0,0,0.0,2007,2007.csv
10334,Lamb,30844,14547,0.47163143561146414,16297,0.5283685643885359,2016,2016.csv
10335,Meet the Fokkens,30810,30810,1.0,0,0.0,2012,2012.csv
10336,Pasolini 2019 Re-release,30757,30757,1.0,0,0.0,2019,2019.csv
10337,Under the Skin of the City,30666,30666,1.0,0,0.0,2003,2003.csv
10338,Documented,30662,30662,1.0,0,0.0,2014,2014.csv
10339,Hide Away,30655,30655,1.0,0,0.0,2012,2012.csv
10340,Fighting for Life,30606,30606,1.0,0,0.0,2008,2008.csv
10341,Fanfan la Tulipe,30590,30590,1.0,0,0.0,2006,2006.csv
10342,The Chaperone,30514,0,0.0,30514,1.0,2011,2011.csv
10343,Gang of Roses,30497,30497,1.0,0,0.0,2003,2003.csv
10344,Take My Eyes 2006 Re-release,30496,30496,1.0,0,0.0,2006,2006.csv
10345,The Boondock Saints,30471,30471,1.0,0,0.0,2000,2000.csv
10346,After Parkland,30444,30444,1.0,0,0.0,2020,2020.csv
10347,Los Reyes,30418,30418,1.0,0,0.0,2019,2019.csv
10348,Dealt,30414,30414,1.0,0,0.0,2017,2017.csv
10349,These Birds Walk,30408,30408,1.0,0,0.0,2013,2013.csv
10350,"Hare Krishna! The Mantra, the Movement and the Swami Who Started It 2017 Re-release",30380,19278,0.6345622119815668,11102,0.3654377880184332,2017,2017.csv
10351,The Take,30380,30380,1.0,0,0.0,2004,2004.csv
10352,Shanghai Red 2010 Re-release,30353,30353,1.0,0,0.0,2010,2010.csv
10353,Heavy Trip,30351,10153,0.33451945570162434,20198,0.6654805442983757,2018,2018.csv
10354,39 Pounds of Love,30330,28195,0.9296076491922189,2135,0.07039235080778107,2005,2005.csv
10355,Walking on Dead Fish,30328,30328,1.0,0,0.0,2008,2008.csv
10356,Happy Christmas,30312,30312,1.0,0,0.0,2014,2014.csv
10357,No Greater Love,30247,30247,1.0,0,0.0,2017,2017.csv
10358,Down to the Bone,30241,30241,1.0,0,0.0,2005,2005.csv
10359,WMD: Weapons of Mass Deception,30210,30210,1.0,0,0.0,2004,2004.csv
10360,Cold Water,30209,30209,1.0,0,0.0,2018,2018.csv
10361,Army of Shadows 2015 Re-release,30190,30190,1.0,0,0.0,2015,2015.csv
10362,The Times of Harvey Milk,30187,13801,0.45718355583529335,16386,0.5428164441647066,2000,2000.csv
10363,Runoff,30186,30186,1.0,0,0.0,2015,2015.csv
10364,Paul Taylor: Creative Domain,30168,30168,1.0,0,0.0,2015,2015.csv
10365,Southern Baptist Sissies,30160,30160,1.0,0,0.0,2014,2014.csv
10366,In My Sleep,30158,30158,1.0,0,0.0,2010,2010.csv
10367,American Swing,30156,30156,1.0,0,0.0,2009,2009.csv
10368,Standing Still,30142,30142,1.0,0,0.0,2006,2006.csv
10369,Lionel Richie at Glastonbury,30123,30123,1.0,0,0.0,2019,2019.csv
10370,Therapy for a Vampire 2016 Re-release,30115,30115,1.0,0,0.0,2016,2016.csv
10371,A Long Way Off,30104,30104,1.0,0,0.0,2014,2014.csv
10372,The Windmill Movie,30050,30050,1.0,0,0.0,2009,2009.csv
10373,Runaways,30032,27908,0.9292754395311668,2124,0.07072456046883324,2008,2008.csv
10374,Manakamana,30029,30029,1.0,0,0.0,2014,2014.csv
10375,Cat Run,30000,30000,1.0,0,0.0,2011,2011.csv
10376,Evidence of a Haunting,29904,29904,1.0,0,0.0,2011,2011.csv
10377,Saint Misbehavin': The Wavy Gravy Movie,29893,29893,1.0,0,0.0,2010,2010.csv
10378,Praise,29874,29874,1.0,0,0.0,2000,2000.csv
10379,Lbs.,29866,29866,1.0,0,0.0,2010,2010.csv
10380,Brother 2012 Re-release,29864,29864,1.0,0,0.0,2012,2012.csv
10381,Long Shot: The Kevin Laue Story 2013 Re-release,29863,29863,1.0,0,0.0,2013,2013.csv
10382,A Fierce Green Fire: The Battle for A Living Planet,29817,29817,1.0,0,0.0,2013,2013.csv
10383,Uncertain,29736,29736,1.0,0,0.0,2017,2017.csv
10384,Multiple Sarcasms,29731,29731,1.0,0,0.0,2010,2010.csv
10385,Henri Cartier-Bresson: The Impassioned Eye,29710,29710,1.0,0,0.0,2006,2006.csv
10386,Yellow Day,29656,29656,1.0,0,0.0,2014,2014.csv
10387,My Faraway Bride,29655,0,0.0,29655,1.0,2007,2007.csv
10388,Memories of Underdevelopment 2018 Re-release,29647,29647,1.0,0,0.0,2018,2018.csv
10389,The Perfect Race,29644,29644,1.0,0,0.0,2019,2019.csv
10390,Dead Man's Burden,29634,29634,1.0,0,0.0,2013,2013.csv
10391,The Eyes of My Mother,29539,27099,0.9173973391110057,2440,0.0826026608889942,2016,2016.csv
10392,Little Fugitive 2013 Re-release,29505,29505,1.0,0,0.0,2013,2013.csv
10393,The Best Democracy Money Can Buy,29500,29500,1.0,0,0.0,2016,2016.csv
10394,The Dog Wedding,29495,29495,1.0,0,0.0,2016,2016.csv
10395,Poisoned by Polonium: The Litvinenko File,29467,5080,0.17239623986154004,24387,0.8276037601384599,2007,2007.csv
10396,Romántico,29460,29460,1.0,0,0.0,2006,2006.csv
10397,Olympic Dreams,29450,29450,1.0,0,0.0,2020,2020.csv
10398,Redemption Road,29384,29384,1.0,0,0.0,2011,2011.csv
10399,Gypsy 83,29367,29367,1.0,0,0.0,2004,2004.csv
10400,Big Girls Don't Cry,29361,1238,0.04216477640407343,28123,0.9578352235959265,2003,2003.csv
10401,Empathy,29345,29345,1.0,0,0.0,2004,2004.csv
10402,Cousin Jules,29337,29337,1.0,0,0.0,2013,2013.csv
10403,Charm City,29335,29335,1.0,0,0.0,2018,2018.csv
10404,The Topp Twins: Untouchable Girls 2011 Re-release,29316,29316,1.0,0,0.0,2011,2011.csv
10405,Xenia 2015 Re-release,29274,3181,0.10866297738607639,26093,0.8913370226139237,2015,2015.csv
10406,Lemon,29258,29258,1.0,0,0.0,2017,2017.csv
10407,The Ground Beneath My Feet,29251,29251,1.0,0,0.0,2019,2019.csv
10408,Sinbad: Beyond the Veil of Mists,29245,29245,1.0,0,0.0,2000,2000.csv
10409,Time to Choose,29233,29233,1.0,0,0.0,2016,2016.csv
10410,Naked Fame,29220,29220,1.0,0,0.0,2005,2005.csv
10411,The Piano Tuner of EarthQuakes,29121,29121,1.0,0,0.0,2006,2006.csv
10412,Buffaloed,29118,29118,1.0,0,0.0,2020,2020.csv
10413,Daybreak,29081,6995,0.2405350572538771,22086,0.7594649427461229,2004,2004.csv
10414,The Heart Is Deceitful Above All Things 2006 Re-release,29058,29058,1.0,0,0.0,2006,2006.csv
10415,Fire in the Blood,28994,28994,1.0,0,0.0,2013,2013.csv
10416,Othello,28980,28980,1.0,0,0.0,2014,2014.csv
10417,A Foreign Affair,28909,28909,1.0,0,0.0,2004,2004.csv
10418,Plush,28864,3080,0.10670731707317073,25784,0.8932926829268293,2013,2013.csv
10419,Teknolust,28811,28811,1.0,0,0.0,2003,2003.csv
10420,Two in the Wave,28808,28808,1.0,0,0.0,2010,2010.csv
10421,Batman & Robin 2019 Re-release,28793,28597,0.9931927899142152,196,0.00680721008578474,2019,2019.csv
10422,Rebels of the Neon God,28791,28791,1.0,0,0.0,2015,2015.csv
10423,Americons,28782,28782,1.0,0,0.0,2015,2015.csv
10424,Metropolis 2007 Re-release,28779,28779,1.0,0,0.0,2007,2007.csv
10425,Hearts and Minds,28754,28754,1.0,0,0.0,2004,2004.csv
10426,Nénette,28699,18009,0.627513153768424,10690,0.372486846231576,2010,2010.csv
10427,Hitler's Children,28663,28663,1.0,0,0.0,2012,2012.csv
10428,Abe,28657,0,0.0,28657,1.0,2020,2020.csv
10429,Band of Outsiders,28656,28656,1.0,0,0.0,2001,2001.csv
10430,Streetballers,28642,28642,1.0,0,0.0,2009,2009.csv
10431,The Transfiguration,28631,22091,0.771576263490622,6540,0.22842373650937794,2017,2017.csv
10432,Explicit Ills,28564,28564,1.0,0,0.0,2009,2009.csv
10433,Garbo: El espía 2011 Re-release,28563,28563,1.0,0,0.0,2011,2011.csv
10434,Restoring Tomorrow,28556,28556,1.0,0,0.0,2018,2018.csv
10435,Stations of the Elevated,28516,28516,1.0,0,0.0,2014,2014.csv
10436,P.S. Your Cat Is Dead!,28454,28454,1.0,0,0.0,2003,2003.csv
10437,Carrie Pilby,28430,18957,0.6667956384101301,9473,0.3332043615898699,2017,2017.csv
10438,"Rabin, the Last Day",28411,28411,1.0,0,0.0,2016,2016.csv
10439,The Load,28410,28410,1.0,0,0.0,2019,2019.csv
10440,Struck by Lightning,28378,28378,1.0,0,0.0,2013,2013.csv
10441,The Strange Ones,28374,0,0.0,28374,1.0,2017,2017.csv
10442,Southpaw,28365,28365,1.0,0,0.0,2000,2000.csv
10443,Guys and Balls 2006 Re-release,28324,28324,1.0,0,0.0,2006,2006.csv
10444,North Sea Texas 2012 Re-release,28307,28307,1.0,0,0.0,2012,2012.csv
10445,"Arabian Nights - Volume 1, The Restless One",28245,12260,0.43405912550893966,15985,0.5659408744910603,2015,2015.csv
10446,"Like Sunday, Like Rain",28208,28208,1.0,0,0.0,2015,2015.csv
10447,7 Chinese Brothers,28180,28180,1.0,0,0.0,2015,2015.csv
10448,Teddy Bears' Picnic,28149,28149,1.0,0,0.0,2002,2002.csv
10449,"South of Heaven, West of Hell",28149,28149,1.0,0,0.0,2001,2001.csv
10450,Sunflower,28146,23919,0.8498188019612023,4227,0.1501811980387977,2007,2007.csv
10451,The Ambassador,28102,28102,1.0,0,0.0,2012,2012.csv
10452,Eternal,28089,28089,1.0,0,0.0,2005,2005.csv
10453,Bikes vs Cars,28072,28072,1.0,0,0.0,2015,2015.csv
10454,Sembene!,28059,28059,1.0,0,0.0,2015,2015.csv
10455,An American Affair,28044,28044,1.0,0,0.0,2009,2009.csv
10456,Take Me to the River,28041,28041,1.0,0,0.0,2016,2016.csv
10457,Superstar in a Housedress,28032,28032,1.0,0,0.0,2004,2004.csv
10458,Least Among Saints,28026,28026,1.0,0,0.0,2012,2012.csv
10459,Quai des Orfèvres 2018 Re-release,28013,28013,1.0,0,0.0,2018,2018.csv
10460,The Amendment,27961,27961,1.0,0,0.0,2018,2018.csv
10461,Ribbons,27959,27959,1.0,0,0.0,2017,2017.csv
10462,El Norte 2019 Re-release,27920,27920,1.0,0,0.0,2019,2019.csv
10463,King of the Jungle,27841,27841,1.0,0,0.0,2001,2001.csv
10464,Radio Dreams,27836,27836,1.0,0,0.0,2017,2017.csv
10465,Don Carlo,27834,27834,1.0,0,0.0,2008,2008.csv
10466,Slipstream,27769,8965,0.32284201807771257,18804,0.6771579819222875,2007,2007.csv
10467,Bauhaus Spirit: 100 Years of Bauhaus,27768,17122,0.6166090463843272,10646,0.3833909536156727,2019,2019.csv
10468,La león,27765,1708,0.06151629749684855,26057,0.9384837025031515,2007,2007.csv
10469,Simon Killer,27740,27740,1.0,0,0.0,2013,2013.csv
10470,30 Years of Garbage: The Garbage Pail Kids Story,27739,27739,1.0,0,0.0,2017,2017.csv
10471,Senso,27723,27723,1.0,0,0.0,2018,2018.csv
10472,Broadway Idiot,27595,27595,1.0,0,0.0,2013,2013.csv
10473,"Léon Morin, Priest",27567,27567,1.0,0,0.0,2009,2009.csv
10474,The King and the Mockingbird 2014 Re-release,27513,27513,1.0,0,0.0,2014,2014.csv
10475,Boys Briefs 4,27449,27449,1.0,0,0.0,2006,2006.csv
10476,Beyond Vanilla,27396,27396,1.0,0,0.0,2003,2003.csv
10477,Kate Plays Christine,27364,25564,0.9342201432539102,1800,0.06577985674608976,2016,2016.csv
10478,Who Gets to Call It Art?,27344,27344,1.0,0,0.0,2006,2006.csv
10479,Cane River 2020 Re-release,27317,27317,1.0,0,0.0,2020,2020.csv
10480,Unlocking the Cage,27284,27284,1.0,0,0.0,2016,2016.csv
10481,Three 2004 Re-release,27256,27256,1.0,0,0.0,2004,2004.csv
10482,Everybody Says I'm Fine!,27225,27225,1.0,0,0.0,2003,2003.csv
10483,Iron Island,27177,27177,1.0,0,0.0,2006,2006.csv
10484,Tiger Eyes,27160,27160,1.0,0,0.0,2013,2013.csv
10485,Bronx Gothic,27151,27151,1.0,0,0.0,2017,2017.csv
10486,"Leaving Home, Coming Home: A Portrait of Robert Frank",27073,27073,1.0,0,0.0,2019,2019.csv
10487,Last Weekend,27053,27053,1.0,0,0.0,2014,2014.csv
10488,Guest of Cindy Sherman,27052,27052,1.0,0,0.0,2009,2009.csv
10489,Clash,27052,27052,1.0,0,0.0,2011,2011.csv
10490,The Last Ride,27000,27000,1.0,0,0.0,2011,2011.csv
10491,Level Five,27000,27000,1.0,0,0.0,2014,2014.csv
10492,Frontrunners,26976,26976,1.0,0,0.0,2008,2008.csv
10493,Mali Blues,26950,26950,1.0,0,0.0,2017,2017.csv
10494,Gringo Wedding,26946,26946,1.0,0,0.0,2007,2007.csv
10495,The Garden,26931,26931,1.0,0,0.0,2009,2009.csv
10496,Cape of Good Hope,26904,26904,1.0,0,0.0,2005,2005.csv
10497,The Dukes,26875,26875,1.0,0,0.0,2008,2008.csv
10498,A Monster with a Thousand Heads,26865,24852,0.925069793411502,2013,0.07493020658849804,2016,2016.csv
10499,Abduction: The Megumi Yokota Story,26859,26859,1.0,0,0.0,2006,2006.csv
10500,"The Devil, Probably",26816,26816,1.0,0,0.0,2012,2012.csv
10501,Fish Without a Bicycle,26799,26799,1.0,0,0.0,2004,2004.csv
10502,Trudell,26756,26756,1.0,0,0.0,2006,2006.csv
10503,Earth Days,26748,26748,1.0,0,0.0,2009,2009.csv
10504,"Massoud, the Afghan 2002 Re-release",26747,26747,1.0,0,0.0,2002,2002.csv
10505,Tap World,26747,26747,1.0,0,0.0,2015,2015.csv
10506,Khiladi 420,26731,26731,1.0,0,0.0,2000,2000.csv
10507,The Answer Man,26676,26676,1.0,0,0.0,2009,2009.csv
10508,Peace Officer,26632,26632,1.0,0,0.0,2015,2015.csv
10509,"Pink Ribbons, Inc.",26608,26608,1.0,0,0.0,2012,2012.csv
10510,Wrestle,26597,26597,1.0,0,0.0,2019,2019.csv
10511,Milford Graves Full Mantis,26566,26566,1.0,0,0.0,2018,2018.csv
10512,José,26563,26563,1.0,0,0.0,2020,2020.csv
10513,Front Cover,26409,26409,1.0,0,0.0,2016,2016.csv
10514,9 Dead Gay Guys,26377,26377,1.0,0,0.0,2003,2003.csv
10515,At First Light,26338,3292,0.12499050801123851,23046,0.8750094919887614,2018,2018.csv
10516,Marlina the Murderer in Four Acts,26331,17788,0.6755535300596255,8543,0.32444646994037446,2018,2018.csv
10517,Donnybrook,26284,26284,1.0,0,0.0,2019,2019.csv
10518,Endgame,26260,9645,0.3672886519421173,16615,0.6327113480578828,2009,2009.csv
10519,October Country,26185,26185,1.0,0,0.0,2010,2010.csv
10520,The Misandrists,26123,26123,1.0,0,0.0,2018,2018.csv
10521,"Sex, Politics & Cocktails",26087,26087,1.0,0,0.0,2005,2005.csv
10522,They Call us Monsters,26080,26080,1.0,0,0.0,2017,2017.csv
10523,"Lipstick & Dynamite, Piss & Vinegar: The First Ladies of Wrestling",26073,26073,1.0,0,0.0,2005,2005.csv
10524,Perestroika,26064,26064,1.0,0,0.0,2009,2009.csv
10525,Nursery University,26042,26042,1.0,0,0.0,2009,2009.csv
10526,Maze,26041,26041,1.0,0,0.0,2001,2001.csv
10527,Ridge Runners,26019,26019,1.0,0,0.0,2018,2018.csv
10528,Main Street,26011,2560,0.09841989927338433,23451,0.9015801007266157,2011,2011.csv
10529,Jet Trash 2018 Re-release,26002,26002,1.0,0,0.0,2018,2018.csv
10530,Black Mother,25919,18762,0.7238705196959759,7157,0.27612948030402407,2018,2018.csv
10531,Django,25916,25916,1.0,0,0.0,2012,2012.csv
10532,Hood of Horror,25900,25900,1.0,0,0.0,2007,2007.csv
10533,Cowards Bend the Knee,25860,25860,1.0,0,0.0,2004,2004.csv
10534,Women Like Us,25859,25859,1.0,0,0.0,2017,2017.csv
10535,Caesar and Otto's Summer Camp Massacre,25844,25844,1.0,0,0.0,2011,2011.csv
10536,Spriggan,25824,25824,1.0,0,0.0,2001,2001.csv
10537,Elena,25788,25788,1.0,0,0.0,2014,2014.csv
10538,Through the Fire,25752,25752,1.0,0,0.0,2006,2006.csv
10539,Stephanie Daley,25751,25751,1.0,0,0.0,2007,2007.csv
10540,Quitting,25717,18531,0.7205739394175059,7186,0.2794260605824941,2002,2002.csv
10541,Gurukulam,25651,25651,1.0,0,0.0,2016,2016.csv
10542,Immortality,25648,25648,1.0,0,0.0,2000,2000.csv
10543,Passion Play,25603,3669,0.14330351911885325,21934,0.8566964808811467,2011,2011.csv
10544,The Exploding Girl,25572,25572,1.0,0,0.0,2010,2010.csv
10545,Banjo,25531,25531,1.0,0,0.0,2016,2016.csv
10546,Naked Boys Singing!,25526,25526,1.0,0,0.0,2007,2007.csv
10547,Waiting for Forever,25517,25517,1.0,0,0.0,2011,2011.csv
10548,Unsubscribe,25488,25488,1.0,0,0.0,2020,2020.csv
10549,Falling,25484,509,0.019973316590802072,24975,0.980026683409198,2007,2007.csv
10550,Christian Mingle,25480,25480,1.0,0,0.0,2014,2014.csv
10551,Werckmeister Harmonies,25461,25461,1.0,0,0.0,2001,2001.csv
10552,Fuck,25428,22359,0.8793062765455404,3069,0.12069372345445965,2006,2006.csv
10553,Kill Command,25427,0,0.0,25427,1.0,2016,2016.csv
10554,Nobody Walks,25342,25342,1.0,0,0.0,2012,2012.csv
10555,Lake of Fire,25317,25317,1.0,0,0.0,2007,2007.csv
10556,Maestro,25315,25315,1.0,0,0.0,2004,2004.csv
10557,Rediscover Sautet,25314,25314,1.0,0,0.0,2015,2015.csv
10558,Badland,25309,1924,0.07602038800426726,23385,0.9239796119957328,2007,2007.csv
10559,Disturbing the Peace,25287,25287,1.0,0,0.0,2016,2016.csv
10560,In Search of Fellini,25269,12772,0.5054414499980213,12497,0.49455855000197874,2017,2017.csv
10561,Death of the Virgin,25247,25247,1.0,0,0.0,2012,2012.csv
10562,The Worst Movie Ever!,25206,25206,1.0,0,0.0,2011,2011.csv
10563,Drivers Wanted,25189,25189,1.0,0,0.0,2005,2005.csv
10564,Fresh,25115,25115,1.0,0,0.0,2010,2010.csv
10565,Gotta Dance,25108,25108,1.0,0,0.0,2009,2009.csv
10566,Vazante,25091,23884,0.9518951018293412,1207,0.0481048981706588,2018,2018.csv
10567,Disappearance at Clifton Hill,25084,25084,1.0,0,0.0,2020,2020.csv
10568,Bonnie & Clyde vs. Dracula,25027,25027,1.0,0,0.0,2011,2011.csv
10569,The Lucky Man,25015,25015,1.0,0,0.0,2017,2017.csv
10570,The Power of Few,25000,25000,1.0,0,0.0,2013,2013.csv
10571,Shadow Glories,24997,24997,1.0,0,0.0,2001,2001.csv
10572,The Isle,24963,20666,0.827865240556023,4297,0.17213475944397708,2002,2002.csv
10573,Ugetsu,24959,11197,0.44861572979686687,13762,0.5513842702031332,2017,2017.csv
10574,R100,24956,24956,1.0,0,0.0,2015,2015.csv
10575,Rana's Wedding,24930,10604,0.4253509827517048,14326,0.5746490172482952,2003,2003.csv
10576,Hannah Takes the Stairs,24869,22815,0.9174072138003136,2054,0.08259278619968635,2007,2007.csv
10577,Naples '44,24863,24620,0.9902264408961107,243,0.009773559103889313,2017,2017.csv
10578,An Elephant's Journey,24844,24844,1.0,0,0.0,2018,2018.csv
10579,Madaari,24822,0,0.0,24822,1.0,2016,2016.csv
10580,Light from Light,24808,24808,1.0,0,0.0,2019,2019.csv
10581,Marius/Fanny/César,24787,24787,1.0,0,0.0,2017,2017.csv
10582,Paradise 2017 Re-release,24749,24749,1.0,0,0.0,2017,2017.csv
10583,Strike,24743,15758,0.6368669926847997,8985,0.36313300731520026,2019,2019.csv
10584,Cold Comes the Night,24732,16971,0.6861960213488598,7761,0.31380397865114024,2013,2013.csv
10585,Wrestling with Angels: Playwright Tony Kushner,24729,24729,1.0,0,0.0,2006,2006.csv
10586,Horses: The Story of Equus,24716,0,0.0,24716,1.0,2002,2002.csv
10587,The Day,24686,20984,0.8500364579113667,3702,0.14996354208863324,2012,2012.csv
10588,Hyenas,24672,24672,1.0,0,0.0,2019,2019.csv
10589,The Departure,24662,24662,1.0,0,0.0,2017,2017.csv
10590,Harvest,24657,24657,1.0,0,0.0,2011,2011.csv
10591,Knuckle,24655,2647,0.1073615899411884,22008,0.8926384100588116,2011,2011.csv
10592,Eat This New York,24640,24640,1.0,0,0.0,2004,2004.csv
10593,Olvidados 2015 Re-release,24638,24638,1.0,0,0.0,2015,2015.csv
10594,Born to Fly: Elizabeth Streb vs. Gravity,24630,24630,1.0,0,0.0,2014,2014.csv
10595,Bang Rajan 2004 Re-release,24629,24629,1.0,0,0.0,2004,2004.csv
10596,Immigration Tango,24554,24554,1.0,0,0.0,2011,2011.csv
10597,The Aspern Papers,24554,9277,0.3778203144090576,15277,0.6221796855909424,2019,2019.csv
10598,After,24544,24544,1.0,0,0.0,2011,2011.csv
10599,Graceland,24529,24529,1.0,0,0.0,2013,2013.csv
10600,Dreaming Lhasa,24523,21504,0.8768910818415365,3019,0.12310891815846349,2007,2007.csv
10601,Vivre Sa Vie,24517,24517,1.0,0,0.0,2008,2008.csv
10602,Too Late to Die Young,24487,16591,0.6775431861804223,7896,0.32245681381957775,2018,2018.csv
10603,Sudden Fear,24476,24476,1.0,0,0.0,2016,2016.csv
10604,Two Drifters,24452,24452,1.0,0,0.0,2006,2006.csv
10605,Otter 501,24449,24449,1.0,0,0.0,2012,2012.csv
10606,Off the Black,24425,24425,1.0,0,0.0,2006,2006.csv
10607,The Man Who Copied,24391,24391,1.0,0,0.0,2005,2005.csv
10608,Coyote County Loser,24375,24375,1.0,0,0.0,2009,2009.csv
10609,Last Days in the Desert,24352,0,0.0,24352,1.0,2016,2016.csv
10610,Honeymoon,24343,9318,0.3827794437826069,15025,0.6172205562173931,2014,2014.csv
10611,Le Petit Soldat,24296,24296,1.0,0,0.0,2013,2013.csv
10612,Jasmine,24248,24248,1.0,0,0.0,2017,2017.csv
10613,The Big Gay Musical,24140,24140,1.0,0,0.0,2009,2009.csv
10614,Heart of Africa,24139,24139,1.0,0,0.0,2020,2020.csv
10615,Luster,24137,24137,1.0,0,0.0,2003,2003.csv
10616,I'll Believe You,24110,24110,1.0,0,0.0,2007,2007.csv
10617,Radio Unnameable,24090,24090,1.0,0,0.0,2012,2012.csv
10618,Level Up,24083,1469,0.06099738404683802,22614,0.939002615953162,2016,2016.csv
10619,American Storytellers,24082,24082,1.0,0,0.0,2003,2003.csv
10620,Chasing Einstein,24057,24057,1.0,0,0.0,2019,2019.csv
10621,When the Sea Rises 2006 Re-release,24038,24038,1.0,0,0.0,2006,2006.csv
10622,Ranchero,24036,24036,1.0,0,0.0,2011,2011.csv
10623,Steven Universe: The Movie,24012,0,0.0,24012,1.0,2019,2019.csv
10624,Beneath the Darkness,23998,0,0.0,23998,1.0,2012,2012.csv
10625,The Fiancé,23986,23986,1.0,0,0.0,2016,2016.csv
10626,On Broadway,23968,23968,1.0,0,0.0,2008,2008.csv
10627,Harry Dean Stanton: Partly Fiction,23959,23959,1.0,0,0.0,2013,2013.csv
10628,Almost Holy,23957,21142,0.8824978085736945,2815,0.11750219142630547,2016,2016.csv
10629,Simple Creature,23918,23918,1.0,0,0.0,2017,2017.csv
10630,Shut Up Little Man! An Audio Misadventure,23901,23901,1.0,0,0.0,2011,2011.csv
10631,Dear Mr. Watterson,23899,23899,1.0,0,0.0,2013,2013.csv
10632,Under The Wire,23897,3429,0.14349081474662093,20468,0.856509185253379,2018,2018.csv
10633,Vincent N Roxxy,23896,0,0.0,23896,1.0,2017,2017.csv
10634,Behind the Burly Q,23889,23889,1.0,0,0.0,2010,2010.csv
10635,Emoticon ;),23881,23881,1.0,0,0.0,2014,2014.csv
10636,Happy Valley,23868,23868,1.0,0,0.0,2014,2014.csv
10637,Argentina,23864,14869,0.623072410325176,8995,0.376927589674824,2015,2015.csv
10638,Death House,23833,23833,1.0,0,0.0,2018,2018.csv
10639,Frequently Asked Questions About Time Travel,23820,0,0.0,23820,1.0,2009,2009.csv
10640,Liars Club,23792,23792,1.0,0,0.0,2002,2002.csv
10641,Emmanuel's Gift,23728,23728,1.0,0,0.0,2005,2005.csv
10642,Diminished Capacity,23719,21659,0.9131497955225768,2060,0.08685020447742316,2008,2008.csv
10643,Greenwich Village: Music That Defined a Generation,23701,23701,1.0,0,0.0,2013,2013.csv
10644,Raw Faith,23667,23667,1.0,0,0.0,2011,2011.csv
10645,Southbound,23665,23665,1.0,0,0.0,2016,2016.csv
10646,Good Kids,23627,0,0.0,23627,1.0,2016,2016.csv
10647,Arnolds Park,23616,23616,1.0,0,0.0,2007,2007.csv
10648,"Phoenix, Oregon",23613,23613,1.0,0,0.0,2020,2020.csv
10649,Lost Bohemia,23584,23584,1.0,0,0.0,2011,2011.csv
10650,"A Woman, a Part",23562,23562,1.0,0,0.0,2017,2017.csv
10651,An Evening with Beverly Luff Linn,23515,6701,0.28496704231341696,16814,0.715032957686583,2018,2018.csv
10652,The Hill Chris Climbed: The Gridiron Heroes Story,23487,23487,1.0,0,0.0,2016,2016.csv
10653,Letter from Masanjia,23481,23481,1.0,0,0.0,2018,2018.csv
10654,The Sensation of Sight,23457,23457,1.0,0,0.0,2007,2007.csv
10655,Robert the Bruce,23425,0,0.0,23425,1.0,2019,2019.csv
10656,Believe Me,23419,23419,1.0,0,0.0,2014,2014.csv
10657,Death in Love,23412,23412,1.0,0,0.0,2009,2009.csv
10658,Esther Kahn,23371,23371,1.0,0,0.0,2002,2002.csv
10659,Can't Stand Losing You: Surviving the Police,23262,23262,1.0,0,0.0,2015,2015.csv
10660,For Ahkeem,23136,23136,1.0,0,0.0,2017,2017.csv
10661,The Judge,23127,22257,0.9623816318588663,870,0.03761836814113374,2018,2018.csv
10662,Finding Oscar,23116,23116,1.0,0,0.0,2017,2017.csv
10663,The Iran Job,23115,23115,1.0,0,0.0,2012,2012.csv
10664,The World Unseen,23101,17808,0.7708757196658154,5293,0.22912428033418467,2008,2008.csv
10665,S21: The Khmer Rouge Killing Machine,23078,22606,0.9795476211110148,472,0.02045237888898518,2004,2004.csv
10666,The Grace of Jake,23078,23078,1.0,0,0.0,2017,2017.csv
10667,Premature,23071,23071,1.0,0,0.0,2020,2020.csv
10668,Three Peaks,23069,16216,0.7029346742381551,6853,0.2970653257618449,2018,2018.csv
10669,History of Jazz: Oxygen for the Ears,23048,23048,1.0,0,0.0,2014,2014.csv
10670,Video Games: The Movie,23043,23043,1.0,0,0.0,2014,2014.csv
10671,Incantato 2004 Re-release,23039,23039,1.0,0,0.0,2004,2004.csv
10672,Goat,23020,23020,1.0,0,0.0,2016,2016.csv
10673,Islam: What the West Needs to Know,22938,22938,1.0,0,0.0,2006,2006.csv
10674,Ambrose Bierce: Civil War Stories,22918,22918,1.0,0,0.0,2006,2006.csv
10675,Frankie and Johnny Are Married,22900,22900,1.0,0,0.0,2004,2004.csv
10676,Hellbound?,22887,22887,1.0,0,0.0,2012,2012.csv
10677,Mirza's Lady,22886,0,0.0,22886,1.0,2016,2016.csv
10678,ABC Africa,22881,9075,0.3966172807132555,13806,0.6033827192867445,2001,2001.csv
10679,Keyhole,22826,22826,1.0,0,0.0,2012,2012.csv
10680,Weather Girl,22779,22779,1.0,0,0.0,2009,2009.csv
10681,The Long Day Closes,22765,22765,1.0,0,0.0,2012,2012.csv
10682,Carol Channing: Larger Than Life,22740,22740,1.0,0,0.0,2012,2012.csv
10683,Dead Fish,22679,0,0.0,22679,1.0,2006,2006.csv
10684,The Revisionaries,22664,22664,1.0,0,0.0,2012,2012.csv
10685,Poultrygeist: Night of the Chicken Dead,22623,13804,0.6101754851257569,8819,0.389824514874243,2007,2007.csv
10686,Ode to Joy,22594,17303,0.7658227848101266,5291,0.23417721518987342,2019,2019.csv
10687,Trophy,22553,21439,0.9506052409878952,1114,0.04939475901210482,2017,2017.csv
10688,L'Innocente,22549,22549,1.0,0,0.0,2020,2020.csv
10689,The Other City,22539,22539,1.0,0,0.0,2010,2010.csv
10690,Anything,22537,19037,0.8446998269512358,3500,0.15530017304876426,2018,2018.csv
10691,The Black Dove,22517,22517,1.0,0,0.0,2016,2016.csv
10692,Casting By,22497,18164,0.8073965417611237,4333,0.19260345823887629,2013,2013.csv
10693,Middleground,22490,0,0.0,22490,1.0,2017,2017.csv
10694,Happy Tears,22464,22464,1.0,0,0.0,2010,2010.csv
10695,Incendiary,22457,22457,1.0,0,0.0,2011,2011.csv
10696,Realms,22443,147,0.006549926480417056,22296,0.9934500735195829,2017,2017.csv
10697,Kamikaze 89,22440,22440,1.0,0,0.0,2016,2016.csv
10698,Be Here Now,22424,22424,1.0,0,0.0,2016,2016.csv
10699,Blackmail Boy 2005 Re-release,22393,22393,1.0,0,0.0,2005,2005.csv
10700,Paradise Club,22381,22381,1.0,0,0.0,2017,2017.csv
10701,Girl Model,22369,21154,0.9456837587733024,1215,0.05431624122669766,2012,2012.csv
10702,Picture Me,22369,12008,0.5368143412758729,10361,0.46318565872412715,2010,2010.csv
10703,The Painting,22313,21008,0.9415139156545511,1305,0.058486084345448844,2012,2012.csv
10704,Falcone,22300,22300,1.0,0,0.0,2006,2006.csv
10705,The Atomic Cafe,22293,22293,1.0,0,0.0,2018,2018.csv
10706,Metropolitan 2015 Re-release,22284,22284,1.0,0,0.0,2015,2015.csv
10707,Downloading Nancy,22282,22282,1.0,0,0.0,2009,2009.csv
10708,Slow Learners,22272,22272,1.0,0,0.0,2015,2015.csv
10709,Generation Startup,22271,22271,1.0,0,0.0,2016,2016.csv
10710,Reparation,22267,22267,1.0,0,0.0,2016,2016.csv
10711,Winning Formula,22189,22189,1.0,0,0.0,2018,2018.csv
10712,All's Faire in Love,22180,22180,1.0,0,0.0,2011,2011.csv
10713,Princess Cut,22167,22167,1.0,0,0.0,2015,2015.csv
10714,Rails & Ties,22136,22136,1.0,0,0.0,2007,2007.csv
10715,Murder Eleven,22107,22107,1.0,0,0.0,2013,2013.csv
10716,The Garden of Eden,22083,22083,1.0,0,0.0,2010,2010.csv
10717,Losing Control,22081,22081,1.0,0,0.0,2012,2012.csv
10718,And Everything Is Going Fine,22080,22080,1.0,0,0.0,2010,2010.csv
10719,Cuba feliz,22071,22071,1.0,0,0.0,2002,2002.csv
10720,Four Adventures of Reinette and Mirabelle,22039,22039,1.0,0,0.0,2011,2011.csv
10721,Answers to Nothing,22029,22029,1.0,0,0.0,2011,2011.csv
10722,Great World of Sound,22011,22011,1.0,0,0.0,2007,2007.csv
10723,Pet,22003,8004,0.3637685770122256,13999,0.6362314229877744,2016,2016.csv
10724,Lovesickness,22000,22000,1.0,0,0.0,2008,2008.csv
10725,The Sound of Silence,21994,20013,0.9099299809038829,1981,0.09007001909611713,2019,2019.csv
10726,Giuliani Time,21967,21967,1.0,0,0.0,2006,2006.csv
10727,Never Too Late,21915,0,0.0,21915,1.0,2020,2020.csv
10728,Three Dancing Slaves,21888,21888,1.0,0,0.0,2005,2005.csv
10729,Garden Party,21886,21886,1.0,0,0.0,2008,2008.csv
10730,The Passion of Joan of Arc,21877,21877,1.0,0,0.0,2017,2017.csv
10731,Deep Gold 3D,21868,12000,0.5487470276202671,9868,0.45125297237973294,2011,2011.csv
10732,The ABCs of Death,21832,21832,1.0,0,0.0,2013,2013.csv
10733,Animals 2015 Re-release,21821,21821,1.0,0,0.0,2015,2015.csv
10734,Viola,21818,21818,1.0,0,0.0,2013,2013.csv
10735,The Matador,21816,21816,1.0,0,0.0,2008,2008.csv
10736,The Female Brain,21786,21786,1.0,0,0.0,2018,2018.csv
10737,Master of the Flying Guillotine,21779,21779,1.0,0,0.0,2002,2002.csv
10738,Better Than Something: Jay Reatard,21697,21697,1.0,0,0.0,2012,2012.csv
10739,Crazy as Hell,21679,21679,1.0,0,0.0,2002,2002.csv
10740,Antarctica,21679,21679,1.0,0,0.0,2008,2008.csv
10741,Dead Awake,21675,11528,0.5318569780853518,10147,0.46814302191464824,2017,2017.csv
10742,Évocateur: The Morton Downey Jr. Movie,21652,21652,1.0,0,0.0,2013,2013.csv
10743,Toe to Toe,21648,21648,1.0,0,0.0,2010,2010.csv
10744,Sedona,21638,21638,1.0,0,0.0,2012,2012.csv
10745,Blue Jay,21626,21626,1.0,0,0.0,2016,2016.csv
10746,Czech Dream 2007 Re-release,21603,21603,1.0,0,0.0,2007,2007.csv
10747,Wicked Witches,21600,21600,1.0,0,0.0,2019,2019.csv
10748,Half the Picture,21589,21589,1.0,0,0.0,2018,2018.csv
10749,Dr. Bronner's Magic Soapbox,21579,21579,1.0,0,0.0,2007,2007.csv
10750,Waiting for Lightning,21577,21577,1.0,0,0.0,2012,2012.csv
10751,10 timer til Paradis,21561,16000,0.742080608506099,5561,0.25791939149390103,2012,2012.csv
10752,Monogamy,21527,21527,1.0,0,0.0,2011,2011.csv
10753,So Much So Fast,21525,21525,1.0,0,0.0,2006,2006.csv
10754,Slutty Summer,21515,21515,1.0,0,0.0,2005,2005.csv
10755,Imaginary Witness: Hollywood and the Holocaust,21507,21507,1.0,0,0.0,2007,2007.csv
10756,Thank You for Your Service,21497,21497,1.0,0,0.0,2016,2016.csv
10757,Hagazussa,21487,13253,0.616791548378089,8234,0.3832084516219109,2018,2018.csv
10758,Tyrel,21456,21456,1.0,0,0.0,2018,2018.csv
10759,Three of Hearts 2005 Re-release,21429,21429,1.0,0,0.0,2005,2005.csv
10760,The Cry,21427,21427,1.0,0,0.0,2008,2008.csv
10761,Almost Salinas,21419,21419,1.0,0,0.0,2003,2003.csv
10762,Bigger Than the Sky,21398,21398,1.0,0,0.0,2005,2005.csv
10763,The Guys,21366,21366,1.0,0,0.0,2003,2003.csv
10764,Song Of Granite,21349,16182,0.7579746123940231,5167,0.24202538760597686,2017,2017.csv
10765,Tio Papi,21316,21316,1.0,0,0.0,2013,2013.csv
10766,Young Ahmed Domestic,21291,21291,1.0,0,0.0,2020,2020.csv
10767,Memphis,21286,21286,1.0,0,0.0,2014,2014.csv
10768,The Burial Society,21285,21285,1.0,0,0.0,2004,2004.csv
10769,Yang Ban Xi: The 8 Modelworks,21244,21244,1.0,0,0.0,2006,2006.csv
10770,Resurrect Dead: The Mystery of the Toynbee Tiles,21242,21242,1.0,0,0.0,2011,2011.csv
10771,Already Tomorrow in Hong Kong,21206,21206,1.0,0,0.0,2016,2016.csv
10772,Ganja & Hess,21197,21197,1.0,0,0.0,2018,2018.csv
10773,NightLights,21147,21147,1.0,0,0.0,2014,2014.csv
10774,God Knows Where I Am,21135,21135,1.0,0,0.0,2017,2017.csv
10775,The Happys,21108,21108,1.0,0,0.0,2018,2018.csv
10776,Dallas 362,21108,21108,1.0,0,0.0,2005,2005.csv
10777,Massacre on Aisle 12,21106,21106,1.0,0,0.0,2017,2017.csv
10778,A Beginner's Guide to Snuff,21031,21031,1.0,0,0.0,2017,2017.csv
10779,The Sacrifice 2014 Re-release,20945,20945,1.0,0,0.0,2014,2014.csv
10780,The Case of the Grinning Cat,20944,20944,1.0,0,0.0,2006,2006.csv
10781,Round of Your Life,20941,20941,1.0,0,0.0,2019,2019.csv
10782,Ava,20940,20940,1.0,0,0.0,2018,2018.csv
10783,Man Underground,20907,20907,1.0,0,0.0,2017,2017.csv
10784,Lekar Hum Deewana Dil,20874,20874,1.0,0,0.0,2014,2014.csv
10785,The Tripper,20840,20840,1.0,0,0.0,2007,2007.csv
10786,Cameraman: The Life and Work of Jack Cardiff,20840,20840,1.0,0,0.0,2011,2011.csv
10787,Major Dundee,20807,20807,1.0,0,0.0,2005,2005.csv
10788,Time Changer 2016 Re-release,20797,20797,1.0,0,0.0,2016,2016.csv
10789,Killer Diller,20795,20795,1.0,0,0.0,2006,2006.csv
10790,Did You Wonder Who Fired the Gun?,20765,20765,1.0,0,0.0,2018,2018.csv
10791,All These Sleepless Nights,20762,20762,1.0,0,0.0,2017,2017.csv
10792,For Ellen,20746,12396,0.5975127735467078,8350,0.4024872264532922,2012,2012.csv
10793,The Ghosts in Our Machine,20709,20709,1.0,0,0.0,2013,2013.csv
10794,Voices in Wartime,20702,20702,1.0,0,0.0,2005,2005.csv
10795,The Great Flood,20694,20694,1.0,0,0.0,2014,2014.csv
10796,The Last Dispatch,20684,20684,1.0,0,0.0,2005,2005.csv
10797,Freak Show,20657,19696,0.9534782398218522,961,0.046521760178147846,2018,2018.csv
10798,Meeting Resistance,20616,20616,1.0,0,0.0,2007,2007.csv
10799,Douchebag,20615,20615,1.0,0,0.0,2010,2010.csv
10800,Shoot the Piano Player,20615,20615,1.0,0,0.0,2008,2008.csv
10801,Our Nixon,20584,20584,1.0,0,0.0,2013,2013.csv
10802,Fidelio: Alice's Odyssey,20571,3580,0.17403140343201595,16991,0.825968596567984,2015,2015.csv
10803,Coming Up Roses 2014 Re-release,20567,20567,1.0,0,0.0,2014,2014.csv
10804,Band of Robbers,20555,20555,1.0,0,0.0,2016,2016.csv
10805,The Work,20554,5853,0.28476209010411596,14701,0.715237909895884,2017,2017.csv
10806,Ice Dragon: Legend of the Blue Daisies,20549,20549,1.0,0,0.0,2018,2018.csv
10807,4,20523,20523,1.0,0,0.0,2006,2006.csv
10808,Walt & El Grupo,20521,20521,1.0,0,0.0,2009,2009.csv
10809,This Last Lonely Place,20507,20507,1.0,0,0.0,2016,2016.csv
10810,Consumed,20476,20476,1.0,0,0.0,2015,2015.csv
10811,The Devil and Father Amorth,20449,20449,1.0,0,0.0,2018,2018.csv
10812,Boy Meets Girl,20441,20441,1.0,0,0.0,2015,2015.csv
10813,The First Basket,20440,20440,1.0,0,0.0,2008,2008.csv
10814,Burden,20437,18440,0.9022850711944023,1997,0.09771492880559769,2017,2017.csv
10815,Never,20431,20431,1.0,0,0.0,2016,2016.csv
10816,Crossing the Line,20429,9258,0.4531793039306868,11171,0.5468206960693133,2007,2007.csv
10817,Orwell Rolls in His Grave,20389,20389,1.0,0,0.0,2004,2004.csv
10818,The Highest Pass,20386,20386,1.0,0,0.0,2012,2012.csv
10819,London,20361,20361,1.0,0,0.0,2006,2006.csv
10820,The All Americans,20324,20324,1.0,0,0.0,2019,2019.csv
10821,Words of My Perfect Teacher,20318,20318,1.0,0,0.0,2006,2006.csv
10822,Koroshiya 1 2017 Re-release,20285,20285,1.0,0,0.0,2017,2017.csv
10823,The Korean,20279,20279,1.0,0,0.0,2010,2010.csv
10824,Double Take,20218,20218,1.0,0,0.0,2010,2010.csv
10825,If I Die Tonight,20214,20214,1.0,0,0.0,2009,2009.csv
10826,Izzy Gets the F*ck Across Town,20208,20208,1.0,0,0.0,2018,2018.csv
10827,New World Order,20205,20205,1.0,0,0.0,2016,2016.csv
10828,Jesus Henry Christ,20183,20183,1.0,0,0.0,2012,2012.csv
10829,Shoah,20175,20175,1.0,0,0.0,2010,2010.csv
10830,A Wink and a Smile,20169,20169,1.0,0,0.0,2009,2009.csv
10831,Chaos,20166,10289,0.5102152137260736,9877,0.4897847862739264,2005,2005.csv
10832,Flying: Confessions of a Free Woman,20157,20157,1.0,0,0.0,2007,2007.csv
10833,Dirty Laundry,20138,20138,1.0,0,0.0,2007,2007.csv
10834,Friends and Romans,20136,20136,1.0,0,0.0,2015,2015.csv
10835,How to Grow a Band,20135,20135,1.0,0,0.0,2012,2012.csv
10836,The Man from Outer Space,20102,20102,1.0,0,0.0,2017,2017.csv
10837,Love Me True,20100,20100,1.0,0,0.0,2016,2016.csv
10838,Harmony and Me,20099,20099,1.0,0,0.0,2009,2009.csv
10839,"Float Like a Butterfly, Sting Like a Bee",20073,20073,1.0,0,0.0,2003,2003.csv
10840,The Past is a Grotesque Animal,20056,20056,1.0,0,0.0,2014,2014.csv
10841,State of Fear,20055,20055,1.0,0,0.0,2006,2006.csv
10842,Apocalypsis,20052,20052,1.0,0,0.0,2018,2018.csv
10843,General Magic,20046,20046,1.0,0,0.0,2019,2019.csv
10844,The Gospel of Eureka,20039,20039,1.0,0,0.0,2019,2019.csv
10845,The Deal,20035,0,0.0,20035,1.0,2005,2005.csv
10846,"No Pay, Nudity",20017,20017,1.0,0,0.0,2016,2016.csv
10847,The Ground Truth,20013,20013,1.0,0,0.0,2006,2006.csv
10848,Lore,20006,20006,1.0,0,0.0,2020,2020.csv
10849,Eight Hours Don't Make a Day,19987,19987,1.0,0,0.0,2018,2018.csv
10850,"One Sings, the Other Doesn't",19919,19919,1.0,0,0.0,2018,2018.csv
10851,Wedding Palace,19908,19908,1.0,0,0.0,2013,2013.csv
10852,Forbidden Games,19889,19889,1.0,0,0.0,2015,2015.csv
10853,Merci Dr Rey!,19867,19867,1.0,0,0.0,2004,2004.csv
10854,Active Measures,19862,19862,1.0,0,0.0,2018,2018.csv
10855,Heat and Dust 2017 Re-release,19856,19856,1.0,0,0.0,2017,2017.csv
10856,"Sia, the Dream of the Python",19830,4662,0.2350983358547655,15168,0.7649016641452345,2002,2002.csv
10857,The Simian Line,19823,19823,1.0,0,0.0,2001,2001.csv
10858,The Journey,19800,19800,1.0,0,0.0,2003,2003.csv
10859,L'iceberg,19789,19789,1.0,0,0.0,2007,2007.csv
10860,Favela Rising,19781,19781,1.0,0,0.0,2006,2006.csv
10861,Wild Canaries,19777,19777,1.0,0,0.0,2015,2015.csv
10862,The Trial,19753,19753,1.0,0,0.0,2010,2010.csv
10863,The Open Road,19716,19716,1.0,0,0.0,2009,2009.csv
10864,Trying to Get Good: The Jazz Odyssey of Jack Sheldon,19712,19712,1.0,0,0.0,2008,2008.csv
10865,The Romans,19705,19705,1.0,0,0.0,2016,2016.csv
10866,Trafficked,19698,19698,1.0,0,0.0,2017,2017.csv
10867,Kills On Wheels 2016 Re-release,19680,15898,0.8078252032520326,3782,0.19217479674796747,2016,2016.csv
10868,Misery Loves Comedy,19634,19634,1.0,0,0.0,2015,2015.csv
10869,Bad Milo,19613,19613,1.0,0,0.0,2013,2013.csv
10870,Art Bastard,19600,19600,1.0,0,0.0,2016,2016.csv
10871,Uzumasa Limelight,19597,19597,1.0,0,0.0,2014,2014.csv
10872,Zoology,19572,0,0.0,19572,1.0,2016,2016.csv
10873,Damascus Cover,19532,0,0.0,19532,1.0,2018,2018.csv
10874,Comet,19530,8623,0.4415258576548899,10907,0.5584741423451101,2014,2014.csv
10875,Hannah: Buddhism's Untold Journey,19526,396,0.02028065143910683,19130,0.9797193485608932,2016,2016.csv
10876,BOSTON: An American Running Story 2017 Re-release,19499,19499,1.0,0,0.0,2017,2017.csv
10877,Grassroots,19492,12356,0.6339010876256926,7136,0.3660989123743074,2012,2012.csv
10878,In Over My Head,19482,19482,1.0,0,0.0,2012,2012.csv
10879,Guardian Angel,19480,19480,1.0,0,0.0,2014,2014.csv
10880,A Picture of You,19480,19480,1.0,0,0.0,2014,2014.csv
10881,A Room for Romeo Brass,19478,19478,1.0,0,0.0,2000,2000.csv
10882,Whensday,19463,19463,1.0,0,0.0,2013,2013.csv
10883,Hunter Gatherer,19462,19462,1.0,0,0.0,2016,2016.csv
10884,Skateland,19411,19411,1.0,0,0.0,2011,2011.csv
10885,Garmento,19402,19402,1.0,0,0.0,2003,2003.csv
10886,Mansfield 66/67,19390,17930,0.9247034553893759,1460,0.07529654461062403,2017,2017.csv
10887,Tchoupitoulas,19375,19375,1.0,0,0.0,2012,2012.csv
10888,Everything's Gone Green,19373,19373,1.0,0,0.0,2007,2007.csv
10889,Actress,19365,19365,1.0,0,0.0,2014,2014.csv
10890,Peter Brook: The Tightrope,19365,19365,1.0,0,0.0,2014,2014.csv
10891,Wild Tigers I Have Known,19351,9946,0.5139786057568084,9405,0.4860213942431916,2007,2007.csv
10892,Watchers of the Sky,19339,19339,1.0,0,0.0,2014,2014.csv
10893,Gabo: The Creation of Gabriel Garcia Marquez,19337,19337,1.0,0,0.0,2015,2015.csv
10894,Melancholian 3 huonetta,19317,19317,1.0,0,0.0,2005,2005.csv
10895,Jackie & Ryan,19305,0,0.0,19305,1.0,2015,2015.csv
10896,Beauty in Trouble 2008 Re-release,19300,19300,1.0,0,0.0,2008,2008.csv
10897,Invisible Waves,19293,0,0.0,19293,1.0,2006,2006.csv
10898,Reuniting the Rubins,19288,13569,0.703494400663625,5719,0.29650559933637494,2011,2011.csv
10899,Romeos,19248,1081,0.056161679135494594,18167,0.9438383208645054,2011,2011.csv
10900,Neshoba,19245,19245,1.0,0,0.0,2010,2010.csv
10901,City Lights 2007 Re-release,19181,19181,1.0,0,0.0,2007,2007.csv
10902,The Manson Family,19140,19140,1.0,0,0.0,2004,2004.csv
10903,The People I've Slept With,19137,19137,1.0,0,0.0,2010,2010.csv
10904,Who We Are Now,19128,19128,1.0,0,0.0,2018,2018.csv
10905,L'important c'est d'aimer,19120,19120,1.0,0,0.0,2017,2017.csv
10906,Revelation: Dawn of Global Government,19107,19107,1.0,0,0.0,2016,2016.csv
10907,Make Believe,19085,19085,1.0,0,0.0,2011,2011.csv
10908,November,19084,19084,1.0,0,0.0,2018,2018.csv
10909,Daddy Cool: Join the Fun,19069,14319,0.7509046095757512,4750,0.24909539042424877,2009,2009.csv
10910,Search Engines,19033,19033,1.0,0,0.0,2016,2016.csv
10911,The Challenger,19003,19003,1.0,0,0.0,2015,2015.csv
10912,The Color Wheel,19001,19001,1.0,0,0.0,2012,2012.csv
10913,The Kill Team,18983,18983,1.0,0,0.0,2014,2014.csv
10914,Sophomore,18945,18945,1.0,0,0.0,2012,2012.csv
10915,Devils on the Doorstep,18944,18944,1.0,0,0.0,2002,2002.csv
10916,Smash & Grab: The Story of the Pink Panthers,18938,18938,1.0,0,0.0,2013,2013.csv
10917,Love and a Bullet,18926,18926,1.0,0,0.0,2002,2002.csv
10918,Steal a Pencil for Me,18918,18918,1.0,0,0.0,2007,2007.csv
10919,What Love Is,18901,18901,1.0,0,0.0,2007,2007.csv
10920,The Deserted Station,18867,18867,1.0,0,0.0,2004,2004.csv
10921,Ktown Cowboys,18863,18863,1.0,0,0.0,2016,2016.csv
10922,Nostalgia,18846,18846,1.0,0,0.0,2013,2013.csv
10923,Frank and Ava,18829,18829,1.0,0,0.0,2018,2018.csv
10924,Test,18823,18823,1.0,0,0.0,2014,2014.csv
10925,A League of Ordinary Gentlemen 2005 Re-release,18807,18807,1.0,0,0.0,2005,2005.csv
10926,The Sorcerer and the White Snake 2013 Re-release,18759,18759,1.0,0,0.0,2013,2013.csv
10927,Scandalous: The True Story of the National Enquirer,18759,18759,1.0,0,0.0,2019,2019.csv
10928,Max Winslow and the House of Secrets,18750,18750,1.0,0,0.0,2020,2020.csv
10929,Severed Ways: The Norse Discovery of America,18728,18728,1.0,0,0.0,2009,2009.csv
10930,Before Stonewall,18724,18724,1.0,0,0.0,2019,2019.csv
10931,Saving Marriage,18720,18720,1.0,0,0.0,2008,2008.csv
10932,Seoul Searching,18654,18654,1.0,0,0.0,2016,2016.csv
10933,Blessed Is the Match,18654,18654,1.0,0,0.0,2009,2009.csv
10934,Crime + Punishment,18644,18644,1.0,0,0.0,2018,2018.csv
10935,A Single Shot,18642,18642,1.0,0,0.0,2013,2013.csv
10936,Wish Me Away,18618,18618,1.0,0,0.0,2012,2012.csv
10937,The Return of Martin Guerre 2019 Re-release,18603,18603,1.0,0,0.0,2019,2019.csv
10938,The Pagan King: The Battle of Death,18598,0,0.0,18598,1.0,2018,2018.csv
10939,Bobbi Jene,18579,18579,1.0,0,0.0,2017,2017.csv
10940,La Camioneta: The Journey of One American School Bus,18558,18558,1.0,0,0.0,2013,2013.csv
10941,Let My People Go!,18529,18529,1.0,0,0.0,2013,2013.csv
10942,Allegiance to Broadway,18527,18527,1.0,0,0.0,2018,2018.csv
10943,Mr Ya Miss,18516,18516,1.0,0,0.0,2005,2005.csv
10944,Venus Boyz 2003 Re-release,18515,18515,1.0,0,0.0,2003,2003.csv
10945,Desolation,18490,18490,1.0,0,0.0,2018,2018.csv
10946,All the Rage,18489,18489,1.0,0,0.0,2017,2017.csv
10947,Between Love & Goodbye,18480,18480,1.0,0,0.0,2009,2009.csv
10948,The Ghoul,18459,2032,0.11008180291456741,16427,0.8899181970854326,2017,2017.csv
10949,One to Another,18435,18435,1.0,0,0.0,2007,2007.csv
10950,306 Hollywood,18399,18399,1.0,0,0.0,2018,2018.csv
10951,The Reception,18389,18389,1.0,0,0.0,2005,2005.csv
10952,Oka!,18364,18364,1.0,0,0.0,2011,2011.csv
10953,"Phoenix, Oregon",18356,18356,1.0,0,0.0,2019,2019.csv
10954,"Intent to Destroy: Death, Denial & Depiction 2017 Re-release",18340,18340,1.0,0,0.0,2017,2017.csv
10955,"Live Fast, Die Young",18335,18335,1.0,0,0.0,2008,2008.csv
10956,Dear Zachary: A Letter to a Son About His Father,18334,18334,1.0,0,0.0,2008,2008.csv
10957,The Channel,18319,18319,1.0,0,0.0,2016,2016.csv
10958,Four Bags Full,18297,18297,1.0,0,0.0,2013,2013.csv
10959,The Life: What's Your Pleasure?,18297,5130,0.2803738317757009,13167,0.719626168224299,2004,2004.csv
10960,SHOT! The Psycho-Spiritual Mantra of Rock,18295,15157,0.8284777261546871,3138,0.17152227384531293,2017,2017.csv
10961,Hell House,18279,18279,1.0,0,0.0,2002,2002.csv
10962,Off and Running,18262,18262,1.0,0,0.0,2010,2010.csv
10963,Suicide Killers,18239,18239,1.0,0,0.0,2006,2006.csv
10964,Tosca's Kiss,18236,18236,1.0,0,0.0,2014,2014.csv
10965,Torn,18202,18202,1.0,0,0.0,2013,2013.csv
10966,Marcelino Pan y Vino 2012 Re-release,18193,18193,1.0,0,0.0,2012,2012.csv
10967,Who is Dayani Cristal?,18190,18190,1.0,0,0.0,2014,2014.csv
10968,The Lion in Winter 2016 Re-release,18177,18177,1.0,0,0.0,2016,2016.csv
10969,Restless,18154,18154,1.0,0,0.0,2000,2000.csv
10970,Coming Through the Rye,18137,18137,1.0,0,0.0,2016,2016.csv
10971,King of Hearts,18130,17646,0.973303916161059,484,0.02669608383894098,2018,2018.csv
10972,Peter and the Farm,18123,18123,1.0,0,0.0,2016,2016.csv
10973,Harry Benson: Shoot First,18092,18092,1.0,0,0.0,2016,2016.csv
10974,A Bit of Bad Luck,18089,18089,1.0,0,0.0,2016,2016.csv
10975,Total Recall 2012 Re-release,18081,18081,1.0,0,0.0,2012,2012.csv
10976,Scarlet Diva,18062,18062,1.0,0,0.0,2002,2002.csv
10977,Holy Hell,18051,18051,1.0,0,0.0,2016,2016.csv
10978,On Tour with Pina Bausch,18016,18016,1.0,0,0.0,2014,2014.csv
10979,I Knew Her Well,18010,18010,1.0,0,0.0,2016,2016.csv
10980,Men Go to Battle,18006,18006,1.0,0,0.0,2016,2016.csv
10981,Dare,18000,18000,1.0,0,0.0,2009,2009.csv
10982,Battle for Brooklyn,18000,18000,1.0,0,0.0,2011,2011.csv
10983,Women in Trouble,18000,18000,1.0,0,0.0,2009,2009.csv
10984,Jamel Shabazz Street Photographer,17992,17992,1.0,0,0.0,2013,2013.csv
10985,Cruel World,17986,17986,1.0,0,0.0,2006,2006.csv
10986,Payback,17979,17979,1.0,0,0.0,2012,2012.csv
10987,Cook County,17977,17977,1.0,0,0.0,2011,2011.csv
10988,The King Is Alive,17929,17929,1.0,0,0.0,2001,2001.csv
10989,The Cranes Are Flying,17923,17923,1.0,0,0.0,2019,2019.csv
10990,Great Directors,17921,17921,1.0,0,0.0,2010,2010.csv
10991,Dealin' with Idiots,17909,17909,1.0,0,0.0,2013,2013.csv
10992,The Missing Person,17896,17896,1.0,0,0.0,2009,2009.csv
10993,Li'l Quinquin,17868,7192,0.4025072755764495,10676,0.5974927244235505,2015,2015.csv
10994,The Thorn in the Heart,17849,7376,0.41324443946439576,10473,0.5867555605356042,2010,2010.csv
10995,The Last Shaman,17844,17844,1.0,0,0.0,2017,2017.csv
10996,David,17828,0,0.0,17828,1.0,2013,2013.csv
10997,Batman: Mask of the Phantasm 2018 Re-release,17813,17813,1.0,0,0.0,2018,2018.csv
10998,Purple Butterfly,17790,17790,1.0,0,0.0,2004,2004.csv
10999,Escapes,17778,17778,1.0,0,0.0,2017,2017.csv
11000,Sacred,17740,17740,1.0,0,0.0,2017,2017.csv
11001,Little Birds,17739,17739,1.0,0,0.0,2012,2012.csv
11002,The Other One,17727,17727,1.0,0,0.0,2015,2015.csv
11003,Kelly & Cal,17702,17702,1.0,0,0.0,2014,2014.csv
11004,Bad Grandmas,17688,17688,1.0,0,0.0,2017,2017.csv
11005,The History of Future Folk,17646,17646,1.0,0,0.0,2013,2013.csv
11006,Night at the Golden Eagle,17643,17643,1.0,0,0.0,2002,2002.csv
11007,20 Centimeters 2006 Re-release,17632,6635,0.37630444646098005,10997,0.62369555353902,2006,2006.csv
11008,The New Twenty,17625,17625,1.0,0,0.0,2009,2009.csv
11009,How He Fell in Love,17575,17575,1.0,0,0.0,2016,2016.csv
11010,"Milwaukee, Minnesota",17528,17528,1.0,0,0.0,2005,2005.csv
11011,The Chronicle of Anna Magdalena Bach,17527,17527,1.0,0,0.0,2018,2018.csv
11012,Sunset Story,17508,17508,1.0,0,0.0,2005,2005.csv
11013,Streit's: Matzo and the American Dream,17506,17506,1.0,0,0.0,2016,2016.csv
11014,Butterfly Girl,17503,17503,1.0,0,0.0,2015,2015.csv
11015,Chained for Life,17431,17431,1.0,0,0.0,2019,2019.csv
11016,Adventures of Power,17419,17419,1.0,0,0.0,2009,2009.csv
11017,Pandora and the Flying Dutchman 2020 Re-release,17401,17401,1.0,0,0.0,2020,2020.csv
11018,A Skin Too Few: The Days of Nick Drake,17384,17384,1.0,0,0.0,2002,2002.csv
11019,Transfixed,17361,17361,1.0,0,0.0,2004,2004.csv
11020,The Law,17351,17351,1.0,0,0.0,2010,2010.csv
11021,Film Geek,17341,17341,1.0,0,0.0,2006,2006.csv
11022,"A Bread Factory, Part One/A Bread Factory, Part Two",17325,17325,1.0,0,0.0,2018,2018.csv
11023,Littlerock,17309,17309,1.0,0,0.0,2011,2011.csv
11024,Defamation,17309,12038,0.6954763417875094,5271,0.3045236582124906,2009,2009.csv
11025,The Homestretch,17306,17306,1.0,0,0.0,2014,2014.csv
11026,Ever Again,17304,17304,1.0,0,0.0,2006,2006.csv
11027,Stand Clear of the Closing Doors,17282,17282,1.0,0,0.0,2014,2014.csv
11028,Archie's Final Project,17282,17282,1.0,0,0.0,2011,2011.csv
11029,The Great Water,17257,17257,1.0,0,0.0,2005,2005.csv
11030,Made in Hong Kong,17255,17255,1.0,0,0.0,2020,2020.csv
11031,Revival,17252,17252,1.0,0,0.0,2018,2018.csv
11032,Speedway Junky,17246,17246,1.0,0,0.0,2001,2001.csv
11033,A Real Young Girl,17245,17245,1.0,0,0.0,2001,2001.csv
11034,Baby Blues,17234,17234,1.0,0,0.0,2008,2008.csv
11035,Landfill Harmonic,17205,17205,1.0,0,0.0,2016,2016.csv
11036,My Brother's Wedding,17197,8217,0.47781589812176545,8980,0.5221841018782346,2007,2007.csv
11037,Home,17182,9478,0.5516237923408218,7704,0.4483762076591782,2009,2009.csv
11038,Food Evolution,17181,17181,1.0,0,0.0,2017,2017.csv
11039,Accident 2014 Re-release,17161,17161,1.0,0,0.0,2014,2014.csv
11040,Pandaemonium,17113,5151,0.30099924034359843,11962,0.6990007596564015,2001,2001.csv
11041,Le Pont du Nord,17110,17110,1.0,0,0.0,2013,2013.csv
11042,Always Shine,17102,17102,1.0,0,0.0,2016,2016.csv
11043,On the Map,17099,17099,1.0,0,0.0,2016,2016.csv
11044,Grandmaster,17077,17077,1.0,0,0.0,2012,2012.csv
11045,The Understudy,17036,17036,1.0,0,0.0,2012,2012.csv
11046,Goodbye to All That,16986,16986,1.0,0,0.0,2014,2014.csv
11047,The Prophet's Son,16983,16983,1.0,0,0.0,2012,2012.csv
11048,Joseph Pulitzer: Voice of the People,16970,16970,1.0,0,0.0,2019,2019.csv
11049,Advocate,16942,16942,1.0,0,0.0,2020,2020.csv
11050,Noise,16934,16513,0.9751387740640133,421,0.02486122593598677,2008,2008.csv
11051,Eban and Charley,16918,16918,1.0,0,0.0,2001,2001.csv
11052,Carbon Nation,16901,16901,1.0,0,0.0,2010,2010.csv
11053,Return,16886,16124,0.9548738600023688,762,0.045126139997631175,2012,2012.csv
11054,April Showers,16880,16880,1.0,0,0.0,2009,2009.csv
11055,Hank and Asha,16878,16878,1.0,0,0.0,2014,2014.csv
11056,Dark Streets,16815,16815,1.0,0,0.0,2008,2008.csv
11057,Holding Trevor,16814,16814,1.0,0,0.0,2008,2008.csv
11058,Hidden in Plain Sight,16803,16803,1.0,0,0.0,2003,2003.csv
11059,Seven Days,16791,16791,1.0,0,0.0,2007,2007.csv
11060,Cuban Rafters 2003 Re-release,16783,16783,1.0,0,0.0,2003,2003.csv
11061,Swim Team,16783,16783,1.0,0,0.0,2017,2017.csv
11062,Night Across the Street,16778,16778,1.0,0,0.0,2013,2013.csv
11063,Eva 2015 Re-release,16738,16738,1.0,0,0.0,2015,2015.csv
11064,Inventing Our Life: The Kibbutz Experiment,16734,16734,1.0,0,0.0,2012,2012.csv
11065,Medea,16714,16714,1.0,0,0.0,2003,2003.csv
11066,This Changes Everything,16692,16692,1.0,0,0.0,2015,2015.csv
11067,Fascination,16670,16670,1.0,0,0.0,2005,2005.csv
11068,Day Zero,16659,16659,1.0,0,0.0,2008,2008.csv
11069,The World of Kanako 2015 Re-release,16627,16627,1.0,0,0.0,2015,2015.csv
11070,The Freebie,16613,16613,1.0,0,0.0,2010,2010.csv
11071,The Freedom to Marry,16611,16611,1.0,0,0.0,2017,2017.csv
11072,Who Took Johnny,16595,16595,1.0,0,0.0,2015,2015.csv
11073,Haikara-San: Here Comes Miss Modern,16572,16572,1.0,0,0.0,2018,2018.csv
11074,American Cannibal,16566,16566,1.0,0,0.0,2007,2007.csv
11075,Life in a Walk,16557,16557,1.0,0,0.0,2015,2015.csv
11076,Brave New Jersey,16544,16544,1.0,0,0.0,2017,2017.csv
11077,33 & Beyond: The Royal Art of Freemasonry,16533,16533,1.0,0,0.0,2017,2017.csv
11078,Bright Future,16483,5166,0.3134138202997027,11317,0.6865861797002972,2004,2004.csv
11079,The Last Mogul,16469,16469,1.0,0,0.0,2005,2005.csv
11080,Ethan Mao,16444,10178,0.6189491607881294,6266,0.3810508392118706,2005,2005.csv
11081,Mission Control: The Unsung Heroes of Apollo,16405,16405,1.0,0,0.0,2017,2017.csv
11082,Magician: The Astonishing Life and Work of Orson Welles,16400,16400,1.0,0,0.0,2014,2014.csv
11083,Dying to Know: Ram Dass & Timothy Leary,16397,16397,1.0,0,0.0,2017,2017.csv
11084,Splinterheads,16392,16392,1.0,0,0.0,2009,2009.csv
11085,Design Is One: The Vignellis,16386,16386,1.0,0,0.0,2013,2013.csv
11086,April's Shower,16377,16377,1.0,0,0.0,2006,2006.csv
11087,The Intended,16290,8106,0.4976058931860037,8184,0.5023941068139963,2003,2003.csv
11088,Faster,16265,16265,1.0,0,0.0,2004,2004.csv
11089,Captive,16259,16259,1.0,0,0.0,2006,2006.csv
11090,Onmyoji: The Yin Yang Master,16234,16234,1.0,0,0.0,2003,2003.csv
11091,I Melt with You,16232,6361,0.3918802365697388,9871,0.6081197634302612,2011,2011.csv
11092,I Like Killing Flies,16214,16214,1.0,0,0.0,2006,2006.csv
11093,Perfect Opposites,16201,16201,1.0,0,0.0,2004,2004.csv
11094,The Human Centipede III (Final Sequence),16184,16184,1.0,0,0.0,2015,2015.csv
11095,This is Our Land,16182,11567,0.7148065752070202,4615,0.2851934247929799,2017,2017.csv
11096,Detour,16172,16172,1.0,0,0.0,2018,2018.csv
11097,All the Queen's Horses,16172,16172,1.0,0,0.0,2017,2017.csv
11098,Matthew Barney: No Restraint,16136,16136,1.0,0,0.0,2006,2006.csv
11099,Look,16136,16136,1.0,0,0.0,2007,2007.csv
11100,Virginia Minnesota,16118,16118,1.0,0,0.0,2019,2019.csv
11101,Tennessee,16100,16100,1.0,0,0.0,2009,2009.csv
11102,Levitated Mass,16086,16086,1.0,0,0.0,2014,2014.csv
11103,Who's That Knocking at My Door,16085,0,0.0,16085,1.0,2009,2009.csv
11104,Straight Up,16080,16080,1.0,0,0.0,2020,2020.csv
11105,1920 London,16077,0,0.0,16077,1.0,2016,2016.csv
11106,Out of the Clear Blue Sky,16050,16050,1.0,0,0.0,2013,2013.csv
11107,Night of Henna,16027,16027,1.0,0,0.0,2005,2005.csv
11108,Long Shot: The Kevin Laue Story,16011,16011,1.0,0,0.0,2012,2012.csv
11109,Planet of Snail,16002,13957,0.8722034745656793,2045,0.1277965254343207,2012,2012.csv
11110,Supercapitalist,16000,16000,1.0,0,0.0,2012,2012.csv
11111,Wattstax,16000,16000,1.0,0,0.0,2003,2003.csv
11112,The Shining 40th Anniversary,15960,0,0.0,15960,1.0,2020,2020.csv
11113,Vulgar,15927,15927,1.0,0,0.0,2002,2002.csv
11114,Charged: The Eduardo Garcia Story,15920,15920,1.0,0,0.0,2017,2017.csv
11115,Can You Dig This,15909,15909,1.0,0,0.0,2015,2015.csv
11116,Bobby G. Can't Swim,15900,15900,1.0,0,0.0,2002,2002.csv
11117,This Binary Universe,15875,15875,1.0,0,0.0,2012,2012.csv
11118,Starfish,15849,15849,1.0,0,0.0,2019,2019.csv
11119,A Reason,15792,15792,1.0,0,0.0,2015,2015.csv
11120,Defining Hope,15788,15788,1.0,0,0.0,2017,2017.csv
11121,Take Me Home,15760,15760,1.0,0,0.0,2012,2012.csv
11122,Full Moon in Paris,15726,15726,1.0,0,0.0,2015,2015.csv
11123,Trinity Seven The Movie 2: Heavens Library & Crimson Lord,15712,15712,1.0,0,0.0,2019,2019.csv
11124,People Say I'm Crazy,15679,15679,1.0,0,0.0,2004,2004.csv
11125,A Letter to True,15635,15635,1.0,0,0.0,2004,2004.csv
11126,7th Street,15629,15629,1.0,0,0.0,2003,2003.csv
11127,Breakdance Academy,15628,15628,1.0,0,0.0,2010,2010.csv
11128,Dreams Rewired,15626,11843,0.7579034941763727,3783,0.2420965058236273,2015,2015.csv
11129,Out on Stage,15623,15623,1.0,0,0.0,2018,2018.csv
11130,The Competition 2019 Re-release,15622,15622,1.0,0,0.0,2019,2019.csv
11131,Red,15617,4643,0.2973042197605174,10974,0.7026957802394826,2008,2008.csv
11132,Eden,15611,15611,1.0,0,0.0,2008,2008.csv
11133,Quiet City,15610,15610,1.0,0,0.0,2007,2007.csv
11134,Basmati Blues,15605,0,0.0,15605,1.0,2017,2017.csv
11135,Five Nights in Maine,15587,15587,1.0,0,0.0,2016,2016.csv
11136,Bob le Flambeur,15586,15586,1.0,0,0.0,2018,2018.csv
11137,When You Read This Letter,15552,15552,1.0,0,0.0,2018,2018.csv
11138,Postcards from London,15548,5312,0.3416516593774119,10236,0.6583483406225881,2018,2018.csv
11139,Six in Paris,15532,15532,1.0,0,0.0,2008,2008.csv
11140,Stuffed,15532,15532,1.0,0,0.0,2019,2019.csv
11141,Bomb the System,15520,15520,1.0,0,0.0,2005,2005.csv
11142,Save the Green Planet!,15516,15516,1.0,0,0.0,2005,2005.csv
11143,Last Dance,15515,15515,1.0,0,0.0,2002,2002.csv
11144,Dreamkiller,15514,15514,1.0,0,0.0,2010,2010.csv
11145,One Bright Shining Moment,15504,15504,1.0,0,0.0,2005,2005.csv
11146,Tom of Finland 2018 Re-release,15483,3314,0.21404120648453143,12169,0.7859587935154686,2018,2018.csv
11147,Abouna,15476,3290,0.21258723184285344,12186,0.7874127681571466,2003,2003.csv
11148,They Will Have to Kill Us First: Malian Music In Exile,15453,7516,0.48637804956966285,7937,0.5136219504303372,2015,2015.csv
11149,California Solo,15433,15433,1.0,0,0.0,2012,2012.csv
11150,Pipe Dream,15430,15430,1.0,0,0.0,2002,2002.csv
11151,Formula 17 2005 Re-release,15427,15427,1.0,0,0.0,2005,2005.csv
11152,Be Somebody,15395,15395,1.0,0,0.0,2016,2016.csv
11153,Keeper of the Flame,15392,0,0.0,15392,1.0,2002,2002.csv
11154,The Beautiful Truth,15387,15387,1.0,0,0.0,2008,2008.csv
11155,Between the Lines,15383,15383,1.0,0,0.0,2019,2019.csv
11156,Dumbstruck,15379,15379,1.0,0,0.0,2011,2011.csv
11157,The Adderall Diaries,15364,13191,0.8585654777401718,2173,0.14143452225982817,2016,2016.csv
11158,Wild Side,15355,15355,1.0,0,0.0,2005,2005.csv
11159,No Regret 2008 Re-release,15347,15347,1.0,0,0.0,2008,2008.csv
11160,The President,15338,7578,0.4940670230799322,7760,0.5059329769200678,2016,2016.csv
11161,Narcissister Organ Player,15334,15334,1.0,0,0.0,2018,2018.csv
11162,Only the Young,15312,15312,1.0,0,0.0,2012,2012.csv
11163,Contemporary Color,15305,15305,1.0,0,0.0,2017,2017.csv
11164,The Hawk Is Dying,15285,7006,0.4583578671900556,8279,0.5416421328099444,2007,2007.csv
11165,Starcrossed,15263,15263,1.0,0,0.0,2016,2016.csv
11166,Harry + Max,15247,15247,1.0,0,0.0,2005,2005.csv
11167,"Arabian Nights - Volume 2, The Desolate One",15245,6398,0.4196785831420138,8847,0.5803214168579862,2015,2015.csv
11168,People's Republic of Desire,15241,15241,1.0,0,0.0,2018,2018.csv
11169,Descent,15233,15233,1.0,0,0.0,2007,2007.csv
11170,The Samaritan,15220,2521,0.16563731931668857,12699,0.8343626806833114,2012,2012.csv
11171,Off the Lip,15217,15217,1.0,0,0.0,2004,2004.csv
11172,Cthulhu,15213,15213,1.0,0,0.0,2008,2008.csv
11173,All Hat,15198,15198,1.0,0,0.0,2008,2008.csv
11174,Land of the Blind,15180,5244,0.34545454545454546,9936,0.6545454545454545,2006,2006.csv
11175,Funan,15152,15152,1.0,0,0.0,2019,2019.csv
11176,Chelsea on the Rocks,15148,11799,0.7789147082123052,3349,0.22108529178769473,2009,2009.csv
11177,The Olivia Experiment,15122,15122,1.0,0,0.0,2014,2014.csv
11178,Kung Fu Joe,15120,15120,1.0,0,0.0,2012,2012.csv
11179,Nora,15120,15120,1.0,0,0.0,2001,2001.csv
11180,El inmigrante,15100,15100,1.0,0,0.0,2007,2007.csv
11181,Trade of Innocents,15091,15091,1.0,0,0.0,2012,2012.csv
11182,Rebels on Pointe,15088,15088,1.0,0,0.0,2017,2017.csv
11183,Khachaturian,15084,15084,1.0,0,0.0,2003,2003.csv
11184,The Education of Charlie Banks,15078,15078,1.0,0,0.0,2009,2009.csv
11185,Cheatin',15077,15077,1.0,0,0.0,2015,2015.csv
11186,Barefoot,15071,15071,1.0,0,0.0,2014,2014.csv
11187,Caught in the Web,15033,1067,0.07097718352956828,13966,0.9290228164704317,2012,2012.csv
11188,I'm Not Jesus Mommy,15005,15005,1.0,0,0.0,2011,2011.csv
11189,The Tenant,15003,15003,1.0,0,0.0,2011,2011.csv
11190,Hannari: Geisha Modern,14974,14974,1.0,0,0.0,2006,2006.csv
11191,Wrinkles the Clown,14938,14938,1.0,0,0.0,2019,2019.csv
11192,I Declare War,14928,14928,1.0,0,0.0,2013,2013.csv
11193,La Maison de la radio,14905,8095,0.5431063401543106,6810,0.45689365984568936,2013,2013.csv
11194,Trust Machine: The Story of Blockchain,14905,14905,1.0,0,0.0,2018,2018.csv
11195,ZZ Top: That Little Ol' Band from Texas,14879,14879,1.0,0,0.0,2019,2019.csv
11196,A Tale of Two Pizzas,14831,14831,1.0,0,0.0,2005,2005.csv
11197,Reeseville,14824,14824,1.0,0,0.0,2004,2004.csv
11198,Horses of God 2014 Re-release,14817,14817,1.0,0,0.0,2014,2014.csv
11199,Vince Giordano: There's a Future in the Past,14807,14807,1.0,0,0.0,2017,2017.csv
11200,Shem,14804,14804,1.0,0,0.0,2006,2006.csv
11201,Kiss of the Damned,14752,14752,1.0,0,0.0,2013,2013.csv
11202,The Prey 2012 Re-release,14738,13959,0.9471434387298141,779,0.05285656127018591,2012,2012.csv
11203,Sweet Virginia,14725,11753,0.7981663837011884,2972,0.20183361629881155,2017,2017.csv
11204,Two Ninas,14725,14725,1.0,0,0.0,2001,2001.csv
11205,Gloria,14701,14701,1.0,0,0.0,2015,2015.csv
11206,Circus,14693,14693,1.0,0,0.0,2000,2000.csv
11207,30 Beats,14693,14693,1.0,0,0.0,2012,2012.csv
11208,Last Men in Aleppo,14637,14637,1.0,0,0.0,2017,2017.csv
11209,10 Days in a Madhouse,14616,14616,1.0,0,0.0,2015,2015.csv
11210,Unraveled,14615,14615,1.0,0,0.0,2012,2012.csv
11211,The Next Big Thing,14600,14600,1.0,0,0.0,2002,2002.csv
11212,Buzzard,14591,14591,1.0,0,0.0,2015,2015.csv
11213,Tristana,14586,14586,1.0,0,0.0,2012,2012.csv
11214,The Settlers,14556,14556,1.0,0,0.0,2002,2002.csv
11215,Ferrante Fever,14518,11137,0.7671166827386693,3381,0.23288331726133077,2018,2018.csv
11216,The Wanderers 2016 Re-release,14492,14492,1.0,0,0.0,2016,2016.csv
11217,Antarctica: Ice and Sky 2017 Re-release,14475,14475,1.0,0,0.0,2017,2017.csv
11218,Yuri Gagarin Conspiracy: Fallen Idol,14471,14471,1.0,0,0.0,2009,2009.csv
11219,The Public Image is Rotten,14464,11293,0.7807660398230089,3171,0.21923396017699115,2018,2018.csv
11220,The 24th Day,14460,14460,1.0,0,0.0,2004,2004.csv
11221,YPF,14459,9359,0.6472785116536414,5100,0.3527214883463587,2008,2008.csv
11222,The Two Escobars,14457,14457,1.0,0,0.0,2010,2010.csv
11223,My Son 2019 Re-release,14450,14450,1.0,0,0.0,2019,2019.csv
11224,The Last Movie Star,14410,14410,1.0,0,0.0,2018,2018.csv
11225,The Unbelievers,14400,14400,1.0,0,0.0,2013,2013.csv
11226,The Uncondemned,14393,14393,1.0,0,0.0,2016,2016.csv
11227,A Silent Love,14389,14389,1.0,0,0.0,2004,2004.csv
11228,Exhibition,14378,14344,0.9976352761162888,34,0.0023647238837112253,2014,2014.csv
11229,The Anarchist Cookbook,14369,14369,1.0,0,0.0,2003,2003.csv
11230,Justice Is Mind,14360,14360,1.0,0,0.0,2013,2013.csv
11231,Gone Doggy Gone,14354,14354,1.0,0,0.0,2015,2015.csv
11232,Peep World,14351,14351,1.0,0,0.0,2011,2011.csv
11233,Desert Bayou,14350,14350,1.0,0,0.0,2007,2007.csv
11234,Machines,14331,9710,0.6775521596538971,4621,0.32244784034610285,2017,2017.csv
11235,The Devil's Miner,14289,14289,1.0,0,0.0,2006,2006.csv
11236,It Always Rains on Sunday,14276,14276,1.0,0,0.0,2008,2008.csv
11237,Never Stand Still,14272,14272,1.0,0,0.0,2012,2012.csv
11238,Nobody,14271,14271,1.0,0,0.0,2009,2009.csv
11239,Military Intelligence and You!,14251,14251,1.0,0,0.0,2008,2008.csv
11240,Combat Obscura,14242,14242,1.0,0,0.0,2019,2019.csv
11241,Saheb Biwi Aur Gangster,14231,14231,1.0,0,0.0,2011,2011.csv
11242,Brother Nature,14218,14218,1.0,0,0.0,2016,2016.csv
11243,Crutch,14189,14189,1.0,0,0.0,2004,2004.csv
11244,A Perfect Man,14147,7117,0.5030748568601117,7030,0.49692514313988834,2013,2013.csv
11245,Carmen and Geoffrey,14130,14130,1.0,0,0.0,2009,2009.csv
11246,Newtown,14109,14109,1.0,0,0.0,2016,2016.csv
11247,We Won't Grow Old Together,14104,14104,1.0,0,0.0,2012,2012.csv
11248,"I Was at Home, But",14078,14078,1.0,0,0.0,2020,2020.csv
11249,Shangri-La Suite,14073,14073,1.0,0,0.0,2016,2016.csv
11250,Gayby,14062,14062,1.0,0,0.0,2012,2012.csv
11251,Ripple Effect,14059,14059,1.0,0,0.0,2008,2008.csv
11252,6 Month Rule,14057,14057,1.0,0,0.0,2012,2012.csv
11253,Head Games,14056,14056,1.0,0,0.0,2012,2012.csv
11254,Ghetto Physics,14034,14034,1.0,0,0.0,2010,2010.csv
11255,Chasing the Blues,14030,14030,1.0,0,0.0,2018,2018.csv
11256,Il Futuro,14001,14001,1.0,0,0.0,2013,2013.csv
11257,Screwball,13967,13967,1.0,0,0.0,2019,2019.csv
11258,And Then Came Love,13944,13944,1.0,0,0.0,2007,2007.csv
11259,Yosemite,13931,13931,1.0,0,0.0,2016,2016.csv
11260,Up for Grabs,13931,13931,1.0,0,0.0,2005,2005.csv
11261,Weed the People,13926,13926,1.0,0,0.0,2018,2018.csv
11262,This Is Martin Bonner,13888,13888,1.0,0,0.0,2013,2013.csv
11263,Cut Sleeve Boys,13875,13875,1.0,0,0.0,2007,2007.csv
11264,Macbeth,13870,9613,0.6930785868781543,4257,0.30692141312184573,2007,2007.csv
11265,Falling Away,13869,13869,1.0,0,0.0,2012,2012.csv
11266,Genesis,13856,6784,0.4896073903002309,7072,0.5103926096997691,2019,2019.csv
11267,Protagonist,13850,13850,1.0,0,0.0,2007,2007.csv
11268,Blackfoot Trail,13848,13848,1.0,0,0.0,2015,2015.csv
11269,Live Free or Die,13836,13836,1.0,0,0.0,2007,2007.csv
11270,Sympathy for Delicious,13826,13826,1.0,0,0.0,2011,2011.csv
11271,Stavisky...,13793,13793,1.0,0,0.0,2018,2018.csv
11272,The Pretty One,13769,13769,1.0,0,0.0,2014,2014.csv
11273,A Space Program,13739,13739,1.0,0,0.0,2016,2016.csv
11274,The Architect,13737,13737,1.0,0,0.0,2006,2006.csv
11275,Dorfman in Love,13737,13737,1.0,0,0.0,2013,2013.csv
11276,Don McKay,13722,13722,1.0,0,0.0,2010,2010.csv
11277,Full Grown Men,13716,13716,1.0,0,0.0,2008,2008.csv
11278,Who the #$&% Is Jackson Pollock?,13710,13710,1.0,0,0.0,2006,2006.csv
11279,Time to Die,13707,13707,1.0,0,0.0,2017,2017.csv
11280,Love for Sale,13703,13703,1.0,0,0.0,2007,2007.csv
11281,Daisies,13692,13692,1.0,0,0.0,2012,2012.csv
11282,This One's for the Ladies,13688,13688,1.0,0,0.0,2019,2019.csv
11283,The Law in These Parts,13683,13683,1.0,0,0.0,2012,2012.csv
11284,Tikkun,13671,13671,1.0,0,0.0,2016,2016.csv
11285,Red Trees,13666,13666,1.0,0,0.0,2017,2017.csv
11286,Soft Fruit,13654,13654,1.0,0,0.0,2000,2000.csv
11287,Fifi Howls from Happiness,13614,13614,1.0,0,0.0,2014,2014.csv
11288,When the Iron Bird Flies: Tibetan Buddhism Arrives in the West,13598,13598,1.0,0,0.0,2012,2012.csv
11289,Stray Dogs,13573,10433,0.7686583658734252,3140,0.23134163412657482,2014,2014.csv
11290,Eli,13547,13547,1.0,0,0.0,2015,2015.csv
11291,Dysfunctional Friends,13546,13546,1.0,0,0.0,2012,2012.csv
11292,Paper Man,13514,13514,1.0,0,0.0,2010,2010.csv
11293,Duane Hopwood,13510,13510,1.0,0,0.0,2005,2005.csv
11294,Handsome Harry,13500,13500,1.0,0,0.0,2010,2010.csv
11295,Shadowman,13498,13498,1.0,0,0.0,2017,2017.csv
11296,Written on the Wind,13495,0,0.0,13495,1.0,2008,2008.csv
11297,Looking for an Echo,13465,13465,1.0,0,0.0,2000,2000.csv
11298,Spices of Liberty,13463,13463,1.0,0,0.0,2016,2016.csv
11299,The Slaughter Rule,13411,13411,1.0,0,0.0,2003,2003.csv
11300,War of the Worlds: Goliath,13385,13385,1.0,0,0.0,2014,2014.csv
11301,Solaris 2017 Re-release,13352,0,0.0,13352,1.0,2017,2017.csv
11302,One Last Thing...,13334,13334,1.0,0,0.0,2006,2006.csv
11303,Yes Nurse! No Nurse! 2004 Re-release,13325,13325,1.0,0,0.0,2004,2004.csv
11304,Violet Tendencies,13304,13304,1.0,0,0.0,2010,2010.csv
11305,Rapid Response,13294,13294,1.0,0,0.0,2019,2019.csv
11306,Sherman's Way,13282,13282,1.0,0,0.0,2009,2009.csv
11307,The Specials,13276,13276,1.0,0,0.0,2000,2000.csv
11308,Kicking It,13266,13266,1.0,0,0.0,2008,2008.csv
11309,Late Spring,13254,13254,1.0,0,0.0,2016,2016.csv
11310,Days and Nights,13243,13243,1.0,0,0.0,2014,2014.csv
11311,Harold,13229,13229,1.0,0,0.0,2008,2008.csv
11312,Our Blood is Wine,13210,13210,1.0,0,0.0,2018,2018.csv
11313,"Intent to Destroy: Death, Denial & Depiction",13194,13194,1.0,0,0.0,2017,2017.csv
11314,Sol LeWitt,13146,13146,1.0,0,0.0,2014,2014.csv
11315,The Pleasures of Being Out of Step,13137,13137,1.0,0,0.0,2014,2014.csv
11316,The Trouble with Bliss,13093,13093,1.0,0,0.0,2012,2012.csv
11317,Under the Boardwalk: The Monopoly Story,13080,13080,1.0,0,0.0,2011,2011.csv
11318,Nothing But a Man,13063,13063,1.0,0,0.0,2012,2012.csv
11319,Betty Blue 2009 Director's Cut,13029,13029,1.0,0,0.0,2009,2009.csv
11320,"How Much Does Your Building Weigh, Mr Foster? 2012 Re-release",13013,13013,1.0,0,0.0,2012,2012.csv
11321,Jim,13000,13000,1.0,0,0.0,2010,2010.csv
11322,Bloodworth,12971,12971,1.0,0,0.0,2011,2011.csv
11323,Like Me,12965,12965,1.0,0,0.0,2018,2018.csv
11324,Duet for Cannibals 2019 re-release,12962,12962,1.0,0,0.0,2019,2019.csv
11325,Skid Marks,12959,12959,1.0,0,0.0,2007,2007.csv
11326,K2: Siren of the Himalayas,12959,12959,1.0,0,0.0,2014,2014.csv
11327,The Last Rampage,12944,6294,0.48624845488257107,6650,0.5137515451174289,2017,2017.csv
11328,The World According to Shorts,12908,12908,1.0,0,0.0,2006,2006.csv
11329,A Green Story,12901,12901,1.0,0,0.0,2013,2013.csv
11330,Taipei Story,12897,12897,1.0,0,0.0,2017,2017.csv
11331,Rock Bottom,12890,12890,1.0,0,0.0,2007,2007.csv
11332,I Can No Longer Hear the Guitar,12876,12876,1.0,0,0.0,2008,2008.csv
11333,I Trust You to Kill Me,12854,12854,1.0,0,0.0,2006,2006.csv
11334,Permanent,12847,12847,1.0,0,0.0,2017,2017.csv
11335,The Taqwacores,12839,11445,0.8914245657761508,1394,0.10857543422384922,2010,2010.csv
11336,The Art of Being Straight,12831,12831,1.0,0,0.0,2009,2009.csv
11337,Children Underground,12798,12798,1.0,0,0.0,2001,2001.csv
11338,Junction 48,12795,12795,1.0,0,0.0,2017,2017.csv
11339,Christmas at Maxwell's,12781,12781,1.0,0,0.0,2006,2006.csv
11340,Lake City,12767,12767,1.0,0,0.0,2008,2008.csv
11341,Yakuza Apocalypse,12756,12756,1.0,0,0.0,2015,2015.csv
11342,Virginia,12728,12728,1.0,0,0.0,2012,2012.csv
11343,Breakdance Academy 2013 Re-release,12708,12708,1.0,0,0.0,2013,2013.csv
11344,Cobra Verde,12702,12702,1.0,0,0.0,2007,2007.csv
11345,Concerning Violence,12680,12680,1.0,0,0.0,2014,2014.csv
11346,Heal,12668,12668,1.0,0,0.0,2017,2017.csv
11347,Autumn,12655,12655,1.0,0,0.0,2006,2006.csv
11348,August,12636,12636,1.0,0,0.0,2008,2008.csv
11349,Bhopal: A Prayer for Rain,12628,12628,1.0,0,0.0,2014,2014.csv
11350,Kangaroo,12626,4547,0.3601298907017266,8079,0.6398701092982734,2018,2018.csv
11351,Lansdown,12614,12614,1.0,0,0.0,2002,2002.csv
11352,American Socialist: The Life and Times of Eugene Victor Debs,12609,12609,1.0,0,0.0,2018,2018.csv
11353,Gory Gory Hallelujah,12604,12604,1.0,0,0.0,2005,2005.csv
11354,Freestyle: The Art of Rhyme,12600,12600,1.0,0,0.0,2004,2004.csv
11355,Buddy Boy,12597,12597,1.0,0,0.0,2000,2000.csv
11356,Boy Meets Girl,12589,12589,1.0,0,0.0,2014,2014.csv
11357,Husbands in Goa,12588,10135,0.8051318716237686,2453,0.19486812837623133,2012,2012.csv
11358,Of Fathers and Sons,12579,12579,1.0,0,0.0,2018,2018.csv
11359,Around June,12578,12578,1.0,0,0.0,2012,2012.csv
11360,My Art,12554,12554,1.0,0,0.0,2018,2018.csv
11361,Daltry Calhoun,12551,12551,1.0,0,0.0,2005,2005.csv
11362,"The Photographer, His Wife, Her Lover",12546,12546,1.0,0,0.0,2006,2006.csv
11363,Off Season,12544,12544,1.0,0,0.0,2019,2019.csv
11364,The Far Side of the Moon 2005 Re-release,12534,12534,1.0,0,0.0,2005,2005.csv
11365,Jake's Corner,12522,12522,1.0,0,0.0,2008,2008.csv
11366,City of Women,12516,12516,1.0,0,0.0,2016,2016.csv
11367,Seven Beauties,12408,12408,1.0,0,0.0,2017,2017.csv
11368,American Chaos,12368,12368,1.0,0,0.0,2018,2018.csv
11369,America the Beautiful 2: The Thin Commandments,12366,12366,1.0,0,0.0,2011,2011.csv
11370,Rebirth,12358,12358,1.0,0,0.0,2011,2011.csv
11371,Spin,12355,12355,1.0,0,0.0,2004,2004.csv
11372,Backseat,12343,12343,1.0,0,0.0,2008,2008.csv
11373,3 Needles,12327,0,0.0,12327,1.0,2006,2006.csv
11374,L'héritage de la chouette,12316,12316,1.0,0,0.0,2018,2018.csv
11375,The Dust Factory,12311,12311,1.0,0,0.0,2004,2004.csv
11376,Full Battle Rattle,12306,12306,1.0,0,0.0,2008,2008.csv
11377,Big Ain't Bad,12288,12288,1.0,0,0.0,2004,2004.csv
11378,4 Days in France,12273,12273,1.0,0,0.0,2017,2017.csv
11379,The Armor of Light,12267,12267,1.0,0,0.0,2015,2015.csv
11380,Wa-shoku Dream: Beyond Sushi,12240,12240,1.0,0,0.0,2015,2015.csv
11381,The Living Wake,12232,12232,1.0,0,0.0,2010,2010.csv
11382,Bricked,12201,12201,1.0,0,0.0,2019,2019.csv
11383,China Blue,12185,12185,1.0,0,0.0,2007,2007.csv
11384,Elstree 1976,12173,12173,1.0,0,0.0,2016,2016.csv
11385,Touch the Wall,12156,12156,1.0,0,0.0,2014,2014.csv
11386,Destiny,12156,12156,1.0,0,0.0,2016,2016.csv
11387,Greetings from Tim Buckley,12155,11157,0.9178938708350473,998,0.08210612916495269,2013,2013.csv
11388,Shahid,12153,12153,1.0,0,0.0,2013,2013.csv
11389,Back Door Channels: The Price of Peace,12139,12139,1.0,0,0.0,2011,2011.csv
11390,In No Great Hurry: 13 Lessons in Life with Saul Leiter,12133,12133,1.0,0,0.0,2014,2014.csv
11391,The Most Unknown,12119,12119,1.0,0,0.0,2018,2018.csv
11392,What the Snow Brings,12113,4816,0.3975893667960043,7297,0.6024106332039957,2007,2007.csv
11393,Call Me Kuchu,12110,9124,0.7534269199009084,2986,0.24657308009909165,2012,2012.csv
11394,Zen for Nothing,12107,12107,1.0,0,0.0,2019,2019.csv
11395,Hot Water,12101,12101,1.0,0,0.0,2016,2016.csv
11396,The Kids Grow Up,12095,12095,1.0,0,0.0,2010,2010.csv
11397,A Murder in the Park,12088,12088,1.0,0,0.0,2015,2015.csv
11398,When Two Worlds Collide,12080,12080,1.0,0,0.0,2016,2016.csv
11399,Little England 2015 Re-release,12077,12077,1.0,0,0.0,2015,2015.csv
11400,Close Call,12077,12077,1.0,0,0.0,2004,2004.csv
11401,Sex Positive,12069,12069,1.0,0,0.0,2009,2009.csv
11402,Imprisoned,12050,12050,1.0,0,0.0,2019,2019.csv
11403,Quartet,12042,12042,1.0,0,0.0,2019,2019.csv
11404,Lost Angels: Skid Row Is My Home,12025,12025,1.0,0,0.0,2012,2012.csv
11405,Queen Margot 2014 Re-release,12005,12005,1.0,0,0.0,2014,2014.csv
11406,Shaye & Kiki,12000,12000,1.0,0,0.0,2002,2002.csv
11407,Rick,11991,11991,1.0,0,0.0,2004,2004.csv
11408,The Legend of Leigh Bowery,11989,11989,1.0,0,0.0,2003,2003.csv
11409,All Babes Want to Kill Me,11975,11975,1.0,0,0.0,2005,2005.csv
11410,Autumn Sonata 2017 Re-release,11959,0,0.0,11959,1.0,2017,2017.csv
11411,The Strange Little Cat,11956,5885,0.4922214787554366,6071,0.5077785212445634,2014,2014.csv
11412,Last Stop for Paul,11951,11951,1.0,0,0.0,2008,2008.csv
11413,The Last Race,11947,11947,1.0,0,0.0,2018,2018.csv
11414,The Go-Getter,11931,11931,1.0,0,0.0,2008,2008.csv
11415,Frank Serpico,11925,11925,1.0,0,0.0,2017,2017.csv
11416,Yellow Asphalt,11907,11907,1.0,0,0.0,2002,2002.csv
11417,"Cassandro, The Exotico!",11897,11897,1.0,0,0.0,2019,2019.csv
11418,Vengeance Is Mine,11891,11891,1.0,0,0.0,2007,2007.csv
11419,Hollywould,11888,11888,1.0,0,0.0,2019,2019.csv
11420,New York in the 50's,11882,11882,1.0,0,0.0,2001,2001.csv
11421,Smokers Only,11871,11871,1.0,0,0.0,2002,2002.csv
11422,Quid Pro Quo,11864,11864,1.0,0,0.0,2008,2008.csv
11423,Revenge of the Mekons,11861,11861,1.0,0,0.0,2014,2014.csv
11424,Les Parents Terribles,11818,11818,1.0,0,0.0,2018,2018.csv
11425,Janice Beard,11816,11816,1.0,0,0.0,2002,2002.csv
11426,Emptying the Skies,11811,11811,1.0,0,0.0,2015,2015.csv
11427,Woman Is the Future of Man 2006 Re-release,11807,11807,1.0,0,0.0,2006,2006.csv
11428,Dead Man's Shoes 2006 Re-release,11777,6408,0.5441114035832555,5369,0.4558885964167445,2006,2006.csv
11429,The Dry Land,11777,11777,1.0,0,0.0,2010,2010.csv
11430,Blockade,11750,11750,1.0,0,0.0,2007,2007.csv
11431,Summer '03,11746,11746,1.0,0,0.0,2018,2018.csv
11432,Rid of Me,11740,11740,1.0,0,0.0,2011,2011.csv
11433,Writer of O,11728,11728,1.0,0,0.0,2005,2005.csv
11434,Lucha Mexico,11722,11722,1.0,0,0.0,2016,2016.csv
11435,White Wedding 2010 Re-release,11710,11710,1.0,0,0.0,2010,2010.csv
11436,One Peace at a Time,11698,11698,1.0,0,0.0,2009,2009.csv
11437,My Voyage to Italy,11683,11683,1.0,0,0.0,2001,2001.csv
11438,36 Saints,11640,11640,1.0,0,0.0,2013,2013.csv
11439,Angels in the Dust,11606,11606,1.0,0,0.0,2007,2007.csv
11440,The Tribes of Palos Verdes,11603,11603,1.0,0,0.0,2017,2017.csv
11441,11 Flowers,11599,9213,0.79429261143202,2386,0.20570738856798,2012,2012.csv
11442,Operation Filmmaker,11573,11573,1.0,0,0.0,2008,2008.csv
11443,Around India with a Movie Camera,11568,10389,0.8980809128630706,1179,0.10191908713692946,2018,2018.csv
11444,Crop Circles: Quest for Truth,11562,11562,1.0,0,0.0,2002,2002.csv
11445,Intoxicating,11560,11560,1.0,0,0.0,2004,2004.csv
11446,The Preppie Connection,11558,11558,1.0,0,0.0,2016,2016.csv
11447,River of Grass,11553,11553,1.0,0,0.0,2016,2016.csv
11448,East of Havana,11550,11550,1.0,0,0.0,2007,2007.csv
11449,The Ruins of Lifta,11548,11548,1.0,0,0.0,2016,2016.csv
11450,Ultrasuede: In Search of Halston,11539,11539,1.0,0,0.0,2012,2012.csv
11451,After the Cup: Sons of Sakhnin United,11538,11538,1.0,0,0.0,2010,2010.csv
11452,Girl Play,11523,11523,1.0,0,0.0,2005,2005.csv
11453,Elektra Luxx,11514,11514,1.0,0,0.0,2011,2011.csv
11454,Peter and Vandy,11495,11495,1.0,0,0.0,2009,2009.csv
11455,Manfast,11480,11480,1.0,0,0.0,2003,2003.csv
11456,Waltzing Anna,11455,11455,1.0,0,0.0,2006,2006.csv
11457,Whole New Thing,11445,11445,1.0,0,0.0,2007,2007.csv
11458,Sputnik Fever,11441,11441,1.0,0,0.0,2008,2008.csv
11459,Gardens of the Night,11436,11436,1.0,0,0.0,2008,2008.csv
11460,The Final Member,11428,11428,1.0,0,0.0,2014,2014.csv
11461,The Great Invisible,11428,11428,1.0,0,0.0,2014,2014.csv
11462,The Mesmerist,11422,11422,1.0,0,0.0,2002,2002.csv
11463,Love Forbidden 2003 Re-release,11421,11421,1.0,0,0.0,2003,2003.csv
11464,Taxidermia 2009 Re-release,11408,11408,1.0,0,0.0,2009,2009.csv
11465,Beside Bowie: The Mick Ronson Story,11400,11400,1.0,0,0.0,2017,2017.csv
11466,Strafsache 4 Ks 2/63 - Auschwitz vor dem Frankfurter Schwurgericht,11396,11396,1.0,0,0.0,2007,2007.csv
11467,Camera Obscura,11384,11384,1.0,0,0.0,2003,2003.csv
11468,Family Fundamentals,11344,11344,1.0,0,0.0,2002,2002.csv
11469,Rendezvous in July,11321,11321,1.0,0,0.0,2018,2018.csv
11470,Powerbomb,11319,11319,1.0,0,0.0,2020,2020.csv
11471,Saigon Bodyguards,11314,11314,1.0,0,0.0,2017,2017.csv
11472,Viktoria,11314,11314,1.0,0,0.0,2016,2016.csv
11473,Cinemania,11305,11305,1.0,0,0.0,2003,2003.csv
11474,Lost in America,11301,11301,1.0,0,0.0,2020,2020.csv
11475,"Otto; or, Up with Dead People",11295,11295,1.0,0,0.0,2008,2008.csv
11476,Live Freaky Die Freaky,11290,11290,1.0,0,0.0,2006,2006.csv
11477,Dishkiyaoon,11288,11288,1.0,0,0.0,2014,2014.csv
11478,Theo Who Lived,11271,11271,1.0,0,0.0,2016,2016.csv
11479,Looking for Palladin,11268,11268,1.0,0,0.0,2009,2009.csv
11480,Bullitt County,11257,11257,1.0,0,0.0,2018,2018.csv
11481,Daylight's End,11257,0,0.0,11257,1.0,2016,2016.csv
11482,In Like Flynn,11255,11255,1.0,0,0.0,2019,2019.csv
11483,Hacker,11239,11239,1.0,0,0.0,2016,2016.csv
11484,The Pathological Optimist,11222,11222,1.0,0,0.0,2017,2017.csv
11485,Fat Girls,11204,11204,1.0,0,0.0,2007,2007.csv
11486,Children of Invention,11183,11183,1.0,0,0.0,2010,2010.csv
11487,Made Me Do It,11151,11151,1.0,0,0.0,2019,2019.csv
11488,"Now, Forager",11146,11146,1.0,0,0.0,2012,2012.csv
11489,InSight,11100,11100,1.0,0,0.0,2011,2011.csv
11490,Winning Girls Through Psychic Mind Control,11089,11089,1.0,0,0.0,2005,2005.csv
11491,Edward II 2018 Re-release,11055,4826,0.4365445499773858,6229,0.5634554500226142,2018,2018.csv
11492,The Challenge,11043,11043,1.0,0,0.0,2017,2017.csv
11493,The Woman with the 5 Elephants 2011 Re-release,11026,11026,1.0,0,0.0,2011,2011.csv
11494,Gasoline,11023,11023,1.0,0,0.0,2003,2003.csv
11495,PAY 2 PLAY: Democracy's High Stakes,11021,11021,1.0,0,0.0,2014,2014.csv
11496,Midget Zombie Takeover,11006,11006,1.0,0,0.0,2013,2013.csv
11497,The Conrad Boys,11001,11001,1.0,0,0.0,2006,2006.csv
11498,Christina,11000,11000,1.0,0,0.0,2010,2010.csv
11499,Pauly Shore Is Dead,11000,11000,1.0,0,0.0,2004,2004.csv
11500,Manito,11000,11000,1.0,0,0.0,2003,2003.csv
11501,Suburban Birds,10997,10997,1.0,0,0.0,2019,2019.csv
11502,16 Bars,10985,10985,1.0,0,0.0,2019,2019.csv
11503,Just Before I Go,10970,10970,1.0,0,0.0,2015,2015.csv
11504,Digging Up the Marrow,10969,10969,1.0,0,0.0,2015,2015.csv
11505,Very Good Girls,10963,6940,0.6330384018972909,4023,0.3669615981027091,2014,2014.csv
11506,Wallander: Hämnden 2012 Re-release,10960,10960,1.0,0,0.0,2012,2012.csv
11507,Sarah Palin: You Betcha!,10935,10935,1.0,0,0.0,2011,2011.csv
11508,If the Dancer Dances,10912,10912,1.0,0,0.0,2019,2019.csv
11509,The Unknown Soldier,10907,9602,0.8803520674796003,1305,0.11964793252039975,2007,2007.csv
11510,MC5*: A True Testimonial,10888,10888,1.0,0,0.0,2004,2004.csv
11511,Stardom,10886,10886,1.0,0,0.0,2000,2000.csv
11512,As It Is in Heaven,10850,10850,1.0,0,0.0,2014,2014.csv
11513,What Happened Last Night,10844,10844,1.0,0,0.0,2016,2016.csv
11514,The Forecaster,10824,10172,0.9397634885439764,652,0.06023651145602365,2015,2015.csv
11515,Bleeding Heart,10815,0,0.0,10815,1.0,2015,2015.csv
11516,Terkel in Trouble 2010 Re-release,10783,10783,1.0,0,0.0,2010,2010.csv
11517,The Man Who Shook the Hand of Vicente Fernandez,10782,10782,1.0,0,0.0,2012,2012.csv
11518,Vision Portraits,10771,10771,1.0,0,0.0,2019,2019.csv
11519,Mala Mala,10761,10761,1.0,0,0.0,2015,2015.csv
11520,A Resurrection,10730,10730,1.0,0,0.0,2013,2013.csv
11521,Freshman Orientation,10718,10718,1.0,0,0.0,2007,2007.csv
11522,Hollow in the Land,10688,0,0.0,10688,1.0,2017,2017.csv
11523,You Go to My Head,10682,10682,1.0,0,0.0,2020,2020.csv
11524,Made in Cleveland,10681,10681,1.0,0,0.0,2013,2013.csv
11525,Frankie & Alice,10670,10670,1.0,0,0.0,2010,2010.csv
11526,National Bird,10656,10656,1.0,0,0.0,2016,2016.csv
11527,American Meat,10650,10650,1.0,0,0.0,2013,2013.csv
11528,Caucus,10645,10645,1.0,0,0.0,2013,2013.csv
11529,Mind the Gap,10637,10637,1.0,0,0.0,2004,2004.csv
11530,One More Round,10629,10629,1.0,0,0.0,2005,2005.csv
11531,Lovesong,10626,10626,1.0,0,0.0,2017,2017.csv
11532,Intuitions,10606,10606,1.0,0,0.0,2019,2019.csv
11533,Inside the Mind of Leonardo,10600,10600,1.0,0,0.0,2014,2014.csv
11534,Marriage Italian Style 2011 Re-release,10600,10600,1.0,0,0.0,2011,2011.csv
11535,Whaledreamers,10584,10584,1.0,0,0.0,2008,2008.csv
11536,Nola,10550,10550,1.0,0,0.0,2003,2003.csv
11537,China Heavyweight,10550,10550,1.0,0,0.0,2012,2012.csv
11538,White Rainbow,10529,10529,1.0,0,0.0,2006,2006.csv
11539,Fighting Tommy Riley,10514,10514,1.0,0,0.0,2005,2005.csv
11540,Waiting for Armageddon,10501,10501,1.0,0,0.0,2010,2010.csv
11541,Splinter,10497,10497,1.0,0,0.0,2007,2007.csv
11542,Clarence,10495,10495,1.0,0,0.0,2017,2017.csv
11543,Santa Mesa,10490,10490,1.0,0,0.0,2012,2012.csv
11544,Neon Flesh 2012 Re-release,10483,0,0.0,10483,1.0,2012,2012.csv
11545,"Norte, the End of History",10457,10457,1.0,0,0.0,2014,2014.csv
11546,Evil Intent,10454,10454,1.0,0,0.0,2013,2013.csv
11547,Class Rank,10452,10452,1.0,0,0.0,2018,2018.csv
11548,Let's Get Frank,10440,10440,1.0,0,0.0,2004,2004.csv
11549,Mama Africa 2018 Re-release,10430,10430,1.0,0,0.0,2018,2018.csv
11550,Love in the Time of Money,10410,10410,1.0,0,0.0,2002,2002.csv
11551,Forgiving Dr. Mengele,10403,10403,1.0,0,0.0,2006,2006.csv
11552,The Advocates,10402,10402,1.0,0,0.0,2018,2018.csv
11553,Shanghai Calling,10400,10400,1.0,0,0.0,2013,2013.csv
11554,Elemental,10358,10358,1.0,0,0.0,2013,2013.csv
11555,Zero Bridge,10357,10357,1.0,0,0.0,2011,2011.csv
11556,...So Goes the Nation,10337,10337,1.0,0,0.0,2006,2006.csv
11557,SK1 2016 Re-release,10330,10330,1.0,0,0.0,2016,2016.csv
11558,Oasis 2004 Re-release,10304,10304,1.0,0,0.0,2004,2004.csv
11559,Painted Woman,10298,10298,1.0,0,0.0,2017,2017.csv
11560,Vanished Empire 2009 Re-release,10289,10289,1.0,0,0.0,2009,2009.csv
11561,Shepard & Dark,10278,10278,1.0,0,0.0,2013,2013.csv
11562,Moebius,10254,2340,0.22820362785254536,7914,0.7717963721474547,2014,2014.csv
11563,As It Is in Heaven 2008 Re-release,10236,10236,1.0,0,0.0,2008,2008.csv
11564,The Endless Summer,10233,10233,1.0,0,0.0,2014,2014.csv
11565,Amelia 2.0,10233,10233,1.0,0,0.0,2017,2017.csv
11566,Approaching the Unknown,10232,10232,1.0,0,0.0,2016,2016.csv
11567,Steel City,10227,10227,1.0,0,0.0,2007,2007.csv
11568,Allegro,10208,7404,0.7253134796238244,2804,0.2746865203761755,2007,2007.csv
11569,Tip Top,10201,6050,0.5930791098911872,4151,0.4069208901088129,2013,2013.csv
11570,When Lambs Become Lions,10197,9337,0.9156614690595273,860,0.0843385309404727,2019,2019.csv
11571,Prince of the Himalayas,10190,10190,1.0,0,0.0,2011,2011.csv
11572,Miss Minoes 2011 Re-release,10189,10189,1.0,0,0.0,2011,2011.csv
11573,Zindaggi Rocks,10172,10172,1.0,0,0.0,2006,2006.csv
11574,A Bird of the Air,10152,10152,1.0,0,0.0,2011,2011.csv
11575,Broken Arrow,10145,0,0.0,10145,1.0,2008,2008.csv
11576,Revolution #9,10133,10133,1.0,0,0.0,2002,2002.csv
11577,Beta Test,10104,10104,1.0,0,0.0,2016,2016.csv
11578,Putin's Kiss,10082,10082,1.0,0,0.0,2012,2012.csv
11579,Pawn Shop Chronicles,10080,8088,0.8023809523809524,1992,0.1976190476190476,2013,2013.csv
11580,Before I Disappear,10078,10078,1.0,0,0.0,2014,2014.csv
11581,Little Accidents,10071,10071,1.0,0,0.0,2015,2015.csv
11582,Informant,10068,10068,1.0,0,0.0,2013,2013.csv
11583,Choking Man,10053,5474,0.544514075400378,4579,0.455485924599622,2007,2007.csv
11584,The Sunshine Makers,10042,10042,1.0,0,0.0,2017,2017.csv
11585,Circle,10024,10024,1.0,0,0.0,2010,2010.csv
11586,The Life and Mind of Mark DeFriest,10021,10021,1.0,0,0.0,2015,2015.csv
11587,Arjun: The Warrior Prince,10017,10017,1.0,0,0.0,2012,2012.csv
11588,The Do-Deca-Pentathlon,10000,10000,1.0,0,0.0,2012,2012.csv
11589,"Hugh Hefner: Playboy, Activist and Rebel",10000,10000,1.0,0,0.0,2010,2010.csv
11590,Tere Bin Laden: Dead Or Alive,9995,0,0.0,9995,1.0,2016,2016.csv
11591,Black White + Gray: A Portrait of Sam Wagstaff and Robert Mapplethorpe,9975,8939,0.896140350877193,1036,0.10385964912280701,2007,2007.csv
11592,Foosballers,9966,9966,1.0,0,0.0,2020,2020.csv
11593,Made in France,9956,9956,1.0,0,0.0,2016,2016.csv
11594,Act of God,9955,9955,1.0,0,0.0,2009,2009.csv
11595,Nina's Heavenly Delights 2007 Re-release,9936,9936,1.0,0,0.0,2007,2007.csv
11596,Olivia,9934,9934,1.0,0,0.0,2019,2019.csv
11597,Sólo con Tu Pareja,9915,9915,1.0,0,0.0,2006,2006.csv
11598,Streetwise,9904,9904,1.0,0,0.0,2019,2019.csv
11599,If I Didn't Care,9902,9902,1.0,0,0.0,2007,2007.csv
11600,Fix,9890,9890,1.0,0,0.0,2009,2009.csv
11601,Take Care of My Cat,9866,9866,1.0,0,0.0,2002,2002.csv
11602,52 Tuesdays,9844,0,0.0,9844,1.0,2015,2015.csv
11603,Kabbalah Me,9816,9816,1.0,0,0.0,2014,2014.csv
11604,Down Terrace,9812,9812,1.0,0,0.0,2010,2010.csv
11605,The River Within,9811,9811,1.0,0,0.0,2009,2009.csv
11606,Birth of the Living Dead,9802,9802,1.0,0,0.0,2013,2013.csv
11607,Cuba: Island of Music,9791,9791,1.0,0,0.0,2004,2004.csv
11608,Something to Cheer About,9777,9777,1.0,0,0.0,2007,2007.csv
11609,Pelle the Conqueror 2017 Re-release,9757,9757,1.0,0,0.0,2017,2017.csv
11610,Finding Home,9736,9736,1.0,0,0.0,2005,2005.csv
11611,All the Rage,9730,9730,1.0,0,0.0,2000,2000.csv
11612,The President's Last Bang,9724,9724,1.0,0,0.0,2005,2005.csv
11613,"If You Don't, I Will",9719,9719,1.0,0,0.0,2014,2014.csv
11614,Antoine and Antoinette,9704,9704,1.0,0,0.0,2013,2013.csv
11615,Weirdsville,9700,8161,0.841340206185567,1539,0.158659793814433,2007,2007.csv
11616,Brutal Beauty: Tales of the Rose City Rollers,9677,9677,1.0,0,0.0,2010,2010.csv
11617,The Quest of Alain Ducasse,9627,9627,1.0,0,0.0,2018,2018.csv
11618,Virgin,9614,9614,1.0,0,0.0,2004,2004.csv
11619,The Spanish Prisoner 2019 Re-release,9589,9589,1.0,0,0.0,2019,2019.csv
11620,Vito Bonafacci,9570,9570,1.0,0,0.0,2011,2011.csv
11621,Chosen,9536,9283,0.9734689597315436,253,0.026531040268456377,2016,2016.csv
11622,Blackballed: The Bobby Dukes Story,9528,9528,1.0,0,0.0,2006,2006.csv
11623,The Lost Arcade,9522,9522,1.0,0,0.0,2016,2016.csv
11624,Strangers on the Earth,9518,9518,1.0,0,0.0,2018,2018.csv
11625,Living Proof,9512,9512,1.0,0,0.0,2017,2017.csv
11626,In the House of Flies,9480,9480,1.0,0,0.0,2014,2014.csv
11627,Claire Dolan,9480,9480,1.0,0,0.0,2000,2000.csv
11628,Tru Loved,9467,9467,1.0,0,0.0,2008,2008.csv
11629,The Sasquatch Gang,9458,9458,1.0,0,0.0,2007,2007.csv
11630,Northern Lights,9453,9453,1.0,0,0.0,2013,2013.csv
11631,As Tears Go By,9436,9436,1.0,0,0.0,2008,2008.csv
11632,If I Were You,9432,9432,1.0,0,0.0,2013,2013.csv
11633,I'll Sing for You 2004 Re-release,9425,9425,1.0,0,0.0,2004,2004.csv
11634,Zero Charisma,9417,9417,1.0,0,0.0,2013,2013.csv
11635,"One Cut, One Life",9406,9406,1.0,0,0.0,2015,2015.csv
11636,"L'Chayim, Comrade Stalin",9397,9397,1.0,0,0.0,2003,2003.csv
11637,Innocence and Experience: The Making of 'The Age of Innocence',9395,9395,1.0,0,0.0,2005,2005.csv
11638,First Love 2005 Re-release,9392,9392,1.0,0,0.0,2005,2005.csv
11639,Miss Kiet's Children 2017 Re-release,9384,9384,1.0,0,0.0,2017,2017.csv
11640,Acts of Worship,9377,9377,1.0,0,0.0,2003,2003.csv
11641,Crazy Like a Fox,9376,9376,1.0,0,0.0,2006,2006.csv
11642,The Tree of Wooden Clogs,9367,0,0.0,9367,1.0,2016,2016.csv
11643,Radio Free Albemuth,9365,9365,1.0,0,0.0,2014,2014.csv
11644,Fritz Lang's Indian Epic 2019 re-release,9345,9345,1.0,0,0.0,2019,2019.csv
11645,The End of Love,9342,9342,1.0,0,0.0,2013,2013.csv
11646,Looking for Maria Sanchez,9338,9338,1.0,0,0.0,2013,2013.csv
11647,The Immortalists,9331,9331,1.0,0,0.0,2014,2014.csv
11648,Milk and Honey,9331,9331,1.0,0,0.0,2005,2005.csv
11649,Better Mus' Come,9318,9318,1.0,0,0.0,2013,2013.csv
11650,Wonderful World,9309,9309,1.0,0,0.0,2010,2010.csv
11651,Rolling Family 2006 Re-release,9291,9291,1.0,0,0.0,2006,2006.csv
11652,The City Dark,9269,9269,1.0,0,0.0,2012,2012.csv
11653,Hooligan Sparrow,9263,9263,1.0,0,0.0,2016,2016.csv
11654,Illusion,9261,9261,1.0,0,0.0,2006,2006.csv
11655,The Sacrament,9221,9221,1.0,0,0.0,2014,2014.csv
11656,A Dark Place,9212,0,0.0,9212,1.0,2019,2019.csv
11657,Cracked Up,9197,9197,1.0,0,0.0,2019,2019.csv
11658,Ghost Team One,9195,9195,1.0,0,0.0,2013,2013.csv
11659,Trouble Every Day 2013 Re-release,9189,9189,1.0,0,0.0,2013,2013.csv
11660,Frank & Lola,9188,9188,1.0,0,0.0,2016,2016.csv
11661,The Young Girl and the Monsoon,9186,9186,1.0,0,0.0,2001,2001.csv
11662,Robert Blecker Wants Me Dead,9166,9166,1.0,0,0.0,2009,2009.csv
11663,The Hottest August,9163,9163,1.0,0,0.0,2019,2019.csv
11664,The Hollow Point,9149,0,0.0,9149,1.0,2016,2016.csv
11665,Just One More Kiss,9130,9130,1.0,0,0.0,2020,2020.csv
11666,Cupcakes,9129,9129,1.0,0,0.0,2015,2015.csv
11667,Thirst Street,9129,9129,1.0,0,0.0,2017,2017.csv
11668,The Ardennes 2016 Re-release,9116,5638,0.6184730144800351,3478,0.3815269855199649,2016,2016.csv
11669,Faith Connections,9111,9111,1.0,0,0.0,2014,2014.csv
11670,Lycan,9110,9110,1.0,0,0.0,2017,2017.csv
11671,The Eyes,9104,9104,1.0,0,0.0,2017,2017.csv
11672,Julian Schnabel: A Private Portrait,9103,9103,1.0,0,0.0,2017,2017.csv
11673,Decoding Deepak,9100,9100,1.0,0,0.0,2012,2012.csv
11674,Il Posto,9080,9080,1.0,0,0.0,2002,2002.csv
11675,Gerontophilia 2015 Re-release,9074,4916,0.541767687899493,4158,0.45823231210050697,2015,2015.csv
11676,The Janky Promoters,9069,9069,1.0,0,0.0,2009,2009.csv
11677,El Mar La Mar,9065,9065,1.0,0,0.0,2018,2018.csv
11678,Living Life,9064,9064,1.0,0,0.0,2005,2005.csv
11679,Frantz Fanon: Black Skin White Mask,9025,9025,1.0,0,0.0,2019,2019.csv
11680,Step Up: High Water,9005,9005,1.0,0,0.0,2018,2018.csv
11681,Money Fight,9004,9004,1.0,0,0.0,2012,2012.csv
11682,Mosquita y Mari,9000,9000,1.0,0,0.0,2012,2012.csv
11683,Station to Station,9000,9000,1.0,0,0.0,2015,2015.csv
11684,Zoo Wars,8998,8998,1.0,0,0.0,2018,2018.csv
11685,Revolt,8986,0,0.0,8986,1.0,2017,2017.csv
11686,Survivors Guide To Prison,8982,8982,1.0,0,0.0,2018,2018.csv
11687,Colossal Youth,8968,8331,0.9289696699375558,637,0.07103033006244425,2018,2018.csv
11688,Big Words,8965,8965,1.0,0,0.0,2013,2013.csv
11689,Three Stars,8942,8942,1.0,0,0.0,2012,2012.csv
11690,Summer of '67,8941,8941,1.0,0,0.0,2018,2018.csv
11691,This is Congo,8905,7051,0.7918023582257159,1854,0.2081976417742841,2018,2018.csv
11692,Strike,8872,8872,1.0,0,0.0,2007,2007.csv
11693,B-Side,8870,8870,1.0,0,0.0,2015,2015.csv
11694,The Swenkas,8860,8860,1.0,0,0.0,2005,2005.csv
11695,Missing Young Woman,8858,8858,1.0,0,0.0,2003,2003.csv
11696,The Meanest Man in Texas,8850,8850,1.0,0,0.0,2019,2019.csv
11697,The Pardon,8845,8845,1.0,0,0.0,2015,2015.csv
11698,Providence,8840,8840,1.0,0,0.0,2016,2016.csv
11699,Out of the Blue 2007 Re-release,8826,1477,0.16734647631996374,7349,0.8326535236800363,2007,2007.csv
11700,Home Run Showdown,8824,8824,1.0,0,0.0,2012,2012.csv
11701,That Part Feeling - the Universe of Arvo Part,8812,8812,1.0,0,0.0,2019,2019.csv
11702,The Cabinet of Dr. Caligari 2014 Re-release,8811,8811,1.0,0,0.0,2014,2014.csv
11703,Dawn of the Crescent Moon,8799,8799,1.0,0,0.0,2015,2015.csv
11704,Hell Baby,8785,8785,1.0,0,0.0,2013,2013.csv
11705,Bounce: Behind the Velvet Rope,8779,8779,1.0,0,0.0,2001,2001.csv
11706,Evil Remains,8747,8747,1.0,0,0.0,2004,2004.csv
11707,Everything Put Together,8741,2963,0.33897723372611827,5778,0.6610227662738817,2001,2001.csv
11708,Only When I Dance,8738,8738,1.0,0,0.0,2010,2010.csv
11709,Closing Escrow,8719,8719,1.0,0,0.0,2007,2007.csv
11710,The Man in the White Suit,8718,8718,1.0,0,0.0,2012,2012.csv
11711,Blood Feast,8708,8708,1.0,0,0.0,2018,2018.csv
11712,Amnesia,8700,8700,1.0,0,0.0,2017,2017.csv
11713,Man on a Mission: Richard Garriott's Road to the Stars,8688,8688,1.0,0,0.0,2012,2012.csv
11714,Without the King,8663,8663,1.0,0,0.0,2008,2008.csv
11715,Amexicano,8655,8655,1.0,0,0.0,2008,2008.csv
11716,Dosed,8643,0,0.0,8643,1.0,2019,2019.csv
11717,"Small, Beautifully Moving Parts",8631,8631,1.0,0,0.0,2012,2012.csv
11718,A Good Day to Be Black & Sexy,8629,8629,1.0,0,0.0,2008,2008.csv
11719,Meet Me in Montenegro,8612,8612,1.0,0,0.0,2015,2015.csv
11720,Almost Human,8608,8447,0.981296468401487,161,0.018703531598513012,2014,2014.csv
11721,Mojave,8602,8253,0.9594280399906998,349,0.04057196000930016,2016,2016.csv
11722,General Education,8601,8601,1.0,0,0.0,2012,2012.csv
11723,Farewell to Hollywood,8601,8601,1.0,0,0.0,2015,2015.csv
11724,G.I. Jesus,8593,8593,1.0,0,0.0,2007,2007.csv
11725,Kaena: The Prophecy 2004 Re-release,8593,8593,1.0,0,0.0,2004,2004.csv
11726,Lucky,8564,8564,1.0,0,0.0,2011,2011.csv
11727,From the East,8540,8540,1.0,0,0.0,2016,2016.csv
11728,Inspector Maigret,8528,8528,1.0,0,0.0,2017,2017.csv
11729,The Quitter,8512,8512,1.0,0,0.0,2014,2014.csv
11730,The Empty Hours,8478,8244,0.9723991507430998,234,0.027600849256900213,2014,2014.csv
11731,Furlough,8472,8472,1.0,0,0.0,2018,2018.csv
11732,Zero Day,8466,8466,1.0,0,0.0,2003,2003.csv
11733,Canopy,8462,8462,1.0,0,0.0,2014,2014.csv
11734,Salvador Allende 2007 Re-release,8454,8454,1.0,0,0.0,2007,2007.csv
11735,Goodbye Momo,8453,8453,1.0,0,0.0,2007,2007.csv
11736,Blind Date,8449,8449,1.0,0,0.0,2009,2009.csv
11737,The Institute,8445,8445,1.0,0,0.0,2013,2013.csv
11738,We Are the Flesh,8438,8438,1.0,0,0.0,2017,2017.csv
11739,Hello Herman,8437,8437,1.0,0,0.0,2013,2013.csv
11740,Red Hollywood,8426,8426,1.0,0,0.0,2014,2014.csv
11741,The Happy Sad,8395,8395,1.0,0,0.0,2013,2013.csv
11742,Downloaded,8377,8377,1.0,0,0.0,2013,2013.csv
11743,Counting,8374,8374,1.0,0,0.0,2015,2015.csv
11744,Gilbert,8362,8362,1.0,0,0.0,2017,2017.csv
11745,The Rising Place,8360,8360,1.0,0,0.0,2002,2002.csv
11746,Eternity: The Movie,8350,8350,1.0,0,0.0,2014,2014.csv
11747,Stealing America: Vote by Vote,8350,8350,1.0,0,0.0,2008,2008.csv
11748,Gringo Trails,8349,8349,1.0,0,0.0,2014,2014.csv
11749,A Teacher,8348,8348,1.0,0,0.0,2013,2013.csv
11750,Natasha,8325,8325,1.0,0,0.0,2017,2017.csv
11751,Winter of Frozen Dreams,8321,8321,1.0,0,0.0,2009,2009.csv
11752,The Dead Center,8320,8320,1.0,0,0.0,2019,2019.csv
11753,About Cherry,8315,3003,0.36115453998797353,5312,0.6388454600120265,2012,2012.csv
11754,Mr. Chibbs,8302,8302,1.0,0,0.0,2017,2017.csv
11755,Grace,8297,8297,1.0,0,0.0,2009,2009.csv
11756,Served Like a Girl,8290,8290,1.0,0,0.0,2017,2017.csv
11757,Yonkers Joe,8286,8286,1.0,0,0.0,2009,2009.csv
11758,We Are Twisted Fucking Sister!,8277,8277,1.0,0,0.0,2016,2016.csv
11759,Life Partners,8265,8265,1.0,0,0.0,2014,2014.csv
11760,Aliyah,8253,8253,1.0,0,0.0,2013,2013.csv
11761,Silicon Cowboys,8239,8239,1.0,0,0.0,2016,2016.csv
11762,The Etruscan Smile 2019 release,8213,8213,1.0,0,0.0,2019,2019.csv
11763,Brooklyn Brothers Beat the Best,8210,7466,0.9093788063337394,744,0.09062119366626066,2012,2012.csv
11764,Spiral,8190,8190,1.0,0,0.0,2018,2018.csv
11765,Jellyfish Eyes,8176,8176,1.0,0,0.0,2015,2015.csv
11766,Anatahan,8171,8171,1.0,0,0.0,2017,2017.csv
11767,Suspended Animation,8169,8169,1.0,0,0.0,2003,2003.csv
11768,The Other Side,8168,8074,0.9884916748285995,94,0.011508325171400588,2016,2016.csv
11769,Inside the Rain,8140,8140,1.0,0,0.0,2020,2020.csv
11770,Far from Vietnam,8132,8132,1.0,0,0.0,2013,2013.csv
11771,Twist of Faith,8129,8129,1.0,0,0.0,2005,2005.csv
11772,Loren Cass,8125,8125,1.0,0,0.0,2009,2009.csv
11773,From Nowhere,8109,8109,1.0,0,0.0,2017,2017.csv
11774,The Wave,8101,8101,1.0,0,0.0,2020,2020.csv
11775,Restless City,8100,8100,1.0,0,0.0,2012,2012.csv
11776,Next Year Jerusalem,8093,8093,1.0,0,0.0,2014,2014.csv
11777,Golden Kingdom,8077,8077,1.0,0,0.0,2016,2016.csv
11778,In the Mirror of Maya Deren,8077,8077,1.0,0,0.0,2003,2003.csv
11779,Spinning Into Butter,8064,8064,1.0,0,0.0,2009,2009.csv
11780,I Sell the Dead,8050,8050,1.0,0,0.0,2009,2009.csv
11781,16 Years of Alcohol,8046,8046,1.0,0,0.0,2005,2005.csv
11782,Fall to Grace,8043,8043,1.0,0,0.0,2006,2006.csv
11783,No Turning Back,8042,8042,1.0,0,0.0,2003,2003.csv
11784,Steak (R)evolution,8038,8025,0.9983826822592685,13,0.0016173177407315252,2015,2015.csv
11785,Reunion,8030,8030,1.0,0,0.0,2009,2009.csv
11786,The Iron Man,8025,8025,1.0,0,0.0,2007,2007.csv
11787,Straight Outta Tompkins,8022,8022,1.0,0,0.0,2015,2015.csv
11788,Occupation: Dreamland,8018,8018,1.0,0,0.0,2005,2005.csv
11789,The Scoundrel's Wife,8018,8018,1.0,0,0.0,2003,2003.csv
11790,La otra conquista 2007 Re-release,8000,8000,1.0,0,0.0,2007,2007.csv
11791,Talent Has Hunger,7998,7998,1.0,0,0.0,2016,2016.csv
11792,All About Evil,7995,7995,1.0,0,0.0,2010,2010.csv
11793,Eleven Minutes,7986,7986,1.0,0,0.0,2009,2009.csv
11794,One Small Hitch 2015 Re-release,7965,7965,1.0,0,0.0,2015,2015.csv
11795,Roseanne for President!,7960,7960,1.0,0,0.0,2016,2016.csv
11796,Stolen,7943,7943,1.0,0,0.0,2010,2010.csv
11797,A Decent Factory,7925,7925,1.0,0,0.0,2005,2005.csv
11798,Mugabe and the White African,7924,7924,1.0,0,0.0,2010,2010.csv
11799,Angels Are Made Of Light,7919,7919,1.0,0,0.0,2019,2019.csv
11800,Portrait of a Garden,7914,7914,1.0,0,0.0,2016,2016.csv
11801,Bleak Street,7888,0,0.0,7888,1.0,2015,2015.csv
11802,This Magnificent Cake!,7888,7888,1.0,0,0.0,2019,2019.csv
11803,Coastlines,7883,7883,1.0,0,0.0,2006,2006.csv
11804,Swept Away,7876,7876,1.0,0,0.0,2017,2017.csv
11805,Zenith,7862,7862,1.0,0,0.0,2010,2010.csv
11806,The Ballad of Lefty Brown,7856,7856,1.0,0,0.0,2017,2017.csv
11807,Ghost Fleet,7850,7850,1.0,0,0.0,2019,2019.csv
11808,Prince of Central Park,7838,7838,1.0,0,0.0,2000,2000.csv
11809,Roadie,7825,7825,1.0,0,0.0,2012,2012.csv
11810,Photographic Memory,7822,7822,1.0,0,0.0,2012,2012.csv
11811,The Great Man,7814,7814,1.0,0,0.0,2015,2015.csv
11812,Archipelago 2014 Re-release,7791,7791,1.0,0,0.0,2014,2014.csv
11813,Old Stone,7768,7476,0.962409886714727,292,0.03759011328527292,2016,2016.csv
11814,The Plagiarists,7768,7768,1.0,0,0.0,2019,2019.csv
11815,Zerophilia,7763,7763,1.0,0,0.0,2006,2006.csv
11816,Kill Your Idols,7753,7753,1.0,0,0.0,2006,2006.csv
11817,And While We Were Here,7750,7750,1.0,0,0.0,2013,2013.csv
11818,Come Back to Me,7744,7744,1.0,0,0.0,2014,2014.csv
11819,Young Ones,7740,0,0.0,7740,1.0,2014,2014.csv
11820,A Walk to Beautiful,7718,7718,1.0,0,0.0,2008,2008.csv
11821,Gregory's Girl,7710,7710,1.0,0,0.0,2019,2019.csv
11822,Maurizio Cattelan: Be Right Back,7706,7706,1.0,0,0.0,2017,2017.csv
11823,I Don't Belong Anywhere: The Cinema of Chantal Akerman,7703,7703,1.0,0,0.0,2016,2016.csv
11824,Witness for the Prosecution,7693,0,0.0,7693,1.0,2003,2003.csv
11825,I'll Take Your Dead,7692,7692,1.0,0,0.0,2019,2019.csv
11826,With All Deliberate Speed,7690,7690,1.0,0,0.0,2004,2004.csv
11827,Running Shaadi,7674,0,0.0,7674,1.0,2017,2017.csv
11828,El sueño del regreso,7668,7668,1.0,0,0.0,2006,2006.csv
11829,The Whore's Son,7656,7656,1.0,0,0.0,2006,2006.csv
11830,Masai: The Rain Warriors 2006 Re-release,7650,7650,1.0,0,0.0,2006,2006.csv
11831,Last Days Here,7643,7643,1.0,0,0.0,2012,2012.csv
11832,Legend of the Mountain,7640,7640,1.0,0,0.0,2018,2018.csv
11833,Jazz in the Diamond District,7634,7634,1.0,0,0.0,2009,2009.csv
11834,Wasabi Tuna,7631,7631,1.0,0,0.0,2004,2004.csv
11835,Psycho Raman,7612,0,0.0,7612,1.0,2016,2016.csv
11836,Area 51,7556,7556,1.0,0,0.0,2015,2015.csv
11837,The Wrong Light,7553,7553,1.0,0,0.0,2017,2017.csv
11838,Controlled Chaos,7549,7549,1.0,0,0.0,2003,2003.csv
11839,Tales from the Script,7535,7535,1.0,0,0.0,2010,2010.csv
11840,Girls Against Boys,7529,7529,1.0,0,0.0,2013,2013.csv
11841,Birthright: A War Story,7519,7519,1.0,0,0.0,2017,2017.csv
11842,loudQUIETloud: A Film About the Pixies,7506,7506,1.0,0,0.0,2006,2006.csv
11843,Disappearances,7506,7506,1.0,0,0.0,2007,2007.csv
11844,Udaan,7461,7461,1.0,0,0.0,2010,2010.csv
11845,The Cult of the Suicide Bomber,7451,7451,1.0,0,0.0,2006,2006.csv
11846,The Little Bedroom 2014 Re-release,7440,7440,1.0,0,0.0,2014,2014.csv
11847,Raze,7429,7429,1.0,0,0.0,2014,2014.csv
11848,Bel Borba Aqui,7426,7426,1.0,0,0.0,2012,2012.csv
11849,The Dogwalker,7420,7420,1.0,0,0.0,2002,2002.csv
11850,Rubble Kings,7416,7416,1.0,0,0.0,2015,2015.csv
11851,Price Check,7413,7413,1.0,0,0.0,2012,2012.csv
11852,The Giant Mechanical Man,7396,7396,1.0,0,0.0,2012,2012.csv
11853,Silent Waters,7384,7384,1.0,0,0.0,2004,2004.csv
11854,Desperate Acts of Magic,7373,7373,1.0,0,0.0,2013,2013.csv
11855,Gendernauts: A Journey Through Shifting Identities,7358,7358,1.0,0,0.0,2000,2000.csv
11856,Big Time,7347,7347,1.0,0,0.0,2017,2017.csv
11857,The Amazing Truth About Queen Raquela,7328,5597,0.763782751091703,1731,0.23621724890829696,2008,2008.csv
11858,Shoah: Four Sisters,7323,7323,1.0,0,0.0,2018,2018.csv
11859,Beloved Beast,7301,7301,1.0,0,0.0,2019,2019.csv
11860,Dangerous Ishq,7298,0,0.0,7298,1.0,2012,2012.csv
11861,A Piece of Eden,7296,7296,1.0,0,0.0,2000,2000.csv
11862,Gangster's Paradise: Jerusalema 2010 Re-release,7294,7294,1.0,0,0.0,2010,2010.csv
11863,Another WolfCop,7285,7285,1.0,0,0.0,2017,2017.csv
11864,Group,7281,7281,1.0,0,0.0,2002,2002.csv
11865,Casting About,7279,7279,1.0,0,0.0,2007,2007.csv
11866,Indian Point,7251,7251,1.0,0,0.0,2016,2016.csv
11867,Outside Satan,7226,0,0.0,7226,1.0,2013,2013.csv
11868,Tall: The American Skyscraper and Louis Sullivan,7216,7216,1.0,0,0.0,2018,2018.csv
11869,Wake,7212,7212,1.0,0,0.0,2004,2004.csv
11870,I Am Ali,7205,7205,1.0,0,0.0,2014,2014.csv
11871,Special 2008 Re-release,7202,7202,1.0,0,0.0,2008,2008.csv
11872,London River 2011 Re-release,7200,7200,1.0,0,0.0,2011,2011.csv
11873,Happiness Runs,7199,7199,1.0,0,0.0,2010,2010.csv
11874,Kettle of Fish,7196,7196,1.0,0,0.0,2006,2006.csv
11875,Antarctic Edge: 70° South,7193,7193,1.0,0,0.0,2015,2015.csv
11876,The Strange Color of Your Body's Tears,7182,7182,1.0,0,0.0,2014,2014.csv
11877,ABCs of Death 2,7171,7171,1.0,0,0.0,2014,2014.csv
11878,It Had to Be You,7162,7162,1.0,0,0.0,2016,2016.csv
11879,"Brutti, sporchi e cattivi",7144,7144,1.0,0,0.0,2016,2016.csv
11880,Logan,7137,7137,1.0,0,0.0,2010,2010.csv
11881,Saint of 9/11,7137,7137,1.0,0,0.0,2006,2006.csv
11882,"Sorry, Haters",7129,7129,1.0,0,0.0,2006,2006.csv
11883,Mendy,7123,7123,1.0,0,0.0,2006,2006.csv
11884,The Reagan Show,7109,5500,0.7736671824447883,1609,0.2263328175552117,2017,2017.csv
11885,Domain 2012 Re-release,7105,7105,1.0,0,0.0,2012,2012.csv
11886,The Jazz Funeral,7103,7103,1.0,0,0.0,2017,2017.csv
11887,The Dark Below,7095,7095,1.0,0,0.0,2017,2017.csv
11888,Painless,7082,7082,1.0,0,0.0,2018,2018.csv
11889,Stage Fright,7078,7078,1.0,0,0.0,2014,2014.csv
11890,Quantum Hoops,7075,7075,1.0,0,0.0,2007,2007.csv
11891,In Echo Park,7072,7072,1.0,0,0.0,2018,2018.csv
11892,Good Neighbours,7072,7072,1.0,0,0.0,2011,2011.csv
11893,The Brainwashing of My Dad,7028,7028,1.0,0,0.0,2016,2016.csv
11894,In the Land of Pomegranates,7014,7014,1.0,0,0.0,2018,2018.csv
11895,Corman's World: Exploits of a Hollywood Rebel,7000,7000,1.0,0,0.0,2011,2011.csv
11896,Aristide and the Endless Revolution,6998,6998,1.0,0,0.0,2005,2005.csv
11897,The Brass Teapot,6997,6997,1.0,0,0.0,2013,2013.csv
11898,The Camden 28,6983,6983,1.0,0,0.0,2007,2007.csv
11899,Gabriel,6959,6959,1.0,0,0.0,2015,2015.csv
11900,"Love, Marilyn",6950,6950,1.0,0,0.0,2012,2012.csv
11901,Los Angeles Plays Itself,6945,6945,1.0,0,0.0,2004,2004.csv
11902,A Kind of Loving,6912,6912,1.0,0,0.0,2017,2017.csv
11903,Assaulted: Civil Rights Under Fire,6905,6905,1.0,0,0.0,2013,2013.csv
11904,Black Irish,6900,6900,1.0,0,0.0,2007,2007.csv
11905,Boom Bust Boom,6896,6896,1.0,0,0.0,2016,2016.csv
11906,Misconceptions,6892,6892,1.0,0,0.0,2010,2010.csv
11907,Sal,6883,6883,1.0,0,0.0,2013,2013.csv
11908,The Human Scale,6878,6878,1.0,0,0.0,2013,2013.csv
11909,Duck Butter,6877,6877,1.0,0,0.0,2018,2018.csv
11910,The Sisterhood of Night,6870,6870,1.0,0,0.0,2015,2015.csv
11911,Last Ride 2012 Re-release,6853,6853,1.0,0,0.0,2012,2012.csv
11912,Pursuit of Happiness,6850,6850,1.0,0,0.0,2003,2003.csv
11913,Janie Jones,6840,6840,1.0,0,0.0,2011,2011.csv
11914,Farce of the Penguins,6832,0,0.0,6832,1.0,2007,2007.csv
11915,Mad Tiger,6823,6823,1.0,0,0.0,2016,2016.csv
11916,"No God, No Master",6796,6796,1.0,0,0.0,2014,2014.csv
11917,Operation Homecoming: Writing the Wartime Experience,6795,6795,1.0,0,0.0,2007,2007.csv
11918,Finding Bliss,6783,6783,1.0,0,0.0,2010,2010.csv
11919,Mercy,6780,6780,1.0,0,0.0,2010,2010.csv
11920,Going Attractions: The Definitive Story of the Movie Palace,6763,6763,1.0,0,0.0,2019,2019.csv
11921,Calling All Earthlings,6756,6756,1.0,0,0.0,2018,2018.csv
11922,Dying to Survive 2019 Re-release,6752,6752,1.0,0,0.0,2019,2019.csv
11923,A Whale of a Tale,6747,6747,1.0,0,0.0,2018,2018.csv
11924,Buddha Heads,6739,6739,1.0,0,0.0,2002,2002.csv
11925,Iceman,6719,2138,0.3182021134097336,4581,0.6817978865902664,2018,2018.csv
11926,Before You Know It,6717,6717,1.0,0,0.0,2014,2014.csv
11927,Regina Spektor Live in London,6684,6684,1.0,0,0.0,2010,2010.csv
11928,"Arabian Nights - Volume 3, The Enchanted One",6681,4502,0.6738512198772639,2179,0.3261487801227361,2015,2015.csv
11929,Footnotes 2017 Re-release,6660,6660,1.0,0,0.0,2017,2017.csv
11930,Ghost Team,6639,6639,1.0,0,0.0,2016,2016.csv
11931,The Persian Connection,6634,6634,1.0,0,0.0,2017,2017.csv
11932,Breakfast with Curtis,6629,6629,1.0,0,0.0,2013,2013.csv
11933,The Dying of the Light,6627,6627,1.0,0,0.0,2016,2016.csv
11934,Skid Row,6627,6627,1.0,0,0.0,2007,2007.csv
11935,Take,6627,6627,1.0,0,0.0,2008,2008.csv
11936,Aatsinki: The Story of Arctic Cowboys,6601,6601,1.0,0,0.0,2014,2014.csv
11937,Brief Reunion,6601,6601,1.0,0,0.0,2013,2013.csv
11938,Human Capital,6596,6596,1.0,0,0.0,2020,2020.csv
11939,Down the Shore,6558,6558,1.0,0,0.0,2013,2013.csv
11940,Master of the Game,6554,6554,1.0,0,0.0,2004,2004.csv
11941,In Our Nature,6543,6543,1.0,0,0.0,2012,2012.csv
11942,Elizabeth Blue,6542,6542,1.0,0,0.0,2017,2017.csv
11943,Pretty Ugly People,6537,6537,1.0,0,0.0,2009,2009.csv
11944,Dream Boy,6534,6534,1.0,0,0.0,2010,2010.csv
11945,The Aggressives,6533,6533,1.0,0,0.0,2005,2005.csv
11946,We Go Way Back,6529,6529,1.0,0,0.0,2006,2006.csv
11947,Spiral Farm,6517,6517,1.0,0,0.0,2019,2019.csv
11948,Bloody Angels,6509,6509,1.0,0,0.0,2001,2001.csv
11949,Horse Money,6508,6508,1.0,0,0.0,2015,2015.csv
11950,Jews of Egypt,6505,6505,1.0,0,0.0,2014,2014.csv
11951,The Last Place on Earth,6505,6505,1.0,0,0.0,2004,2004.csv
11952,Windfall,6504,6504,1.0,0,0.0,2012,2012.csv
11953,Ride,6489,0,0.0,6489,1.0,2015,2015.csv
11954,The Beat Hotel,6480,6480,1.0,0,0.0,2012,2012.csv
11955,Afterward,6477,6477,1.0,0,0.0,2020,2020.csv
11956,Santa santita,6470,6470,1.0,0,0.0,2005,2005.csv
11957,Scum,6461,6461,1.0,0,0.0,2017,2017.csv
11958,"White King, Red Rubber, Black Death",6458,6458,1.0,0,0.0,2005,2005.csv
11959,McLibel,6450,4337,0.6724031007751938,2113,0.3275968992248062,2005,2005.csv
11960,Tu Dors Nicole,6445,5662,0.8785104732350659,783,0.12148952676493406,2015,2015.csv
11961,Beyond Honor,6437,6437,1.0,0,0.0,2006,2006.csv
11962,The Suicide Theory,6434,6434,1.0,0,0.0,2015,2015.csv
11963,Some Velvet Morning,6420,6420,1.0,0,0.0,2013,2013.csv
11964,Ten 'til Noon,6404,6404,1.0,0,0.0,2007,2007.csv
11965,100 Bloody Acres,6388,6388,1.0,0,0.0,2013,2013.csv
11966,Dreamland,6383,6383,1.0,0,0.0,2006,2006.csv
11967,Forty Guns,6344,0,0.0,6344,1.0,2002,2002.csv
11968,Inescapable,6334,6334,1.0,0,0.0,2013,2013.csv
11969,The Charnel House,6332,6332,1.0,0,0.0,2016,2016.csv
11970,Zardoz,6320,0,0.0,6320,1.0,2008,2008.csv
11971,Juvenile Delinquents,6312,6312,1.0,0,0.0,2020,2020.csv
11972,Watercolors,6305,6305,1.0,0,0.0,2010,2010.csv
11973,Manuscripts Don't Burn,6295,6295,1.0,0,0.0,2014,2014.csv
11974,Under the Eiffel Tower,6291,6291,1.0,0,0.0,2019,2019.csv
11975,Solitude,6260,6260,1.0,0,0.0,2005,2005.csv
11976,The Skyjacker's Tale,6253,6253,1.0,0,0.0,2017,2017.csv
11977,All My Loved Ones,6237,6237,1.0,0,0.0,2002,2002.csv
11978,One Last Thing,6232,6232,1.0,0,0.0,2018,2018.csv
11979,In the Steps of Trisha Brown,6230,6230,1.0,0,0.0,2017,2017.csv
11980,The Bad Kids,6226,6226,1.0,0,0.0,2016,2016.csv
11981,A Man Vanishes 2012 Re-release,6201,6201,1.0,0,0.0,2012,2012.csv
11982,Heavy Metal in Baghdad,6197,4070,0.656769404550589,2127,0.343230595449411,2008,2008.csv
11983,The Red Chapel,6196,6196,1.0,0,0.0,2010,2010.csv
11984,The Night of the Shooting Stars 2015 Re-release,6186,6186,1.0,0,0.0,2015,2015.csv
11985,To Be of Service,6173,6173,1.0,0,0.0,2019,2019.csv
11986,Forget Baghdad: Jews and Arabs - The Iraqi Connection,6151,3741,0.6081937896277028,2410,0.3918062103722972,2003,2003.csv
11987,Sweetwater,6147,6147,1.0,0,0.0,2013,2013.csv
11988,Crazy Eyes,6141,6141,1.0,0,0.0,2012,2012.csv
11989,Relaxer,6133,6133,1.0,0,0.0,2019,2019.csv
11990,Guitar Innovators: John Fahey & Nels Cline,6132,6132,1.0,0,0.0,2013,2013.csv
11991,Scottsboro: An American Tragedy,6123,6123,1.0,0,0.0,2001,2001.csv
11992,"El Sicario, Room 164",6123,6123,1.0,0,0.0,2011,2011.csv
11993,Welcome to Pine Hill,6115,6115,1.0,0,0.0,2013,2013.csv
11994,Arise from Darkness,6112,6112,1.0,0,0.0,2017,2017.csv
11995,Rangrezz,6108,6108,1.0,0,0.0,2013,2013.csv
11996,The Last Fall,6100,6100,1.0,0,0.0,2012,2012.csv
11997,The Last Time I Saw Macao,6095,6095,1.0,0,0.0,2013,2013.csv
11998,The Calling 2003 Re-release,6092,6092,1.0,0,0.0,2003,2003.csv
11999,The Fuzz,6067,6067,1.0,0,0.0,2017,2017.csv
12000,The Miners' Hymns,6051,6051,1.0,0,0.0,2012,2012.csv
12001,The Marquise of O,6048,6048,1.0,0,0.0,2015,2015.csv
12002,Blood Widow,6047,6047,1.0,0,0.0,2019,2019.csv
12003,Love & Air Sex,6047,6047,1.0,0,0.0,2014,2014.csv
12004,The Family Tree,6035,6035,1.0,0,0.0,2011,2011.csv
12005,Love Object,6028,6028,1.0,0,0.0,2004,2004.csv
12006,The Other Lamb,6024,6024,1.0,0,0.0,2020,2020.csv
12007,On the Rumba River,6021,1698,0.2820129546586946,4323,0.7179870453413054,2008,2008.csv
12008,BearCity,6000,6000,1.0,0,0.0,2010,2010.csv
12009,The Bride & The Grooms,5995,5995,1.0,0,0.0,2009,2009.csv
12010,Rat,5980,2630,0.4397993311036789,3350,0.560200668896321,2001,2001.csv
12011,On Wings of Eagles 2017 Re-release,5975,5975,1.0,0,0.0,2017,2017.csv
12012,"Sex, Death and Bowling",5972,5972,1.0,0,0.0,2015,2015.csv
12013,The Playroom,5964,5964,1.0,0,0.0,2013,2013.csv
12014,Cavemen,5948,5948,1.0,0,0.0,2014,2014.csv
12015,Starless Dreams,5937,5937,1.0,0,0.0,2017,2017.csv
12016,American Animal,5928,5928,1.0,0,0.0,2012,2012.csv
12017,Waiting for Dublin,5925,5925,1.0,0,0.0,2009,2009.csv
12018,Sweethearts of the Prison Rodeo,5922,5922,1.0,0,0.0,2010,2010.csv
12019,I Am MLK Jr.,5918,5918,1.0,0,0.0,2018,2018.csv
12020,Gang of Ghosts,5906,5906,1.0,0,0.0,2014,2014.csv
12021,Slash,5902,5902,1.0,0,0.0,2016,2016.csv
12022,Medeas,5895,5895,1.0,0,0.0,2015,2015.csv
12023,An Actor Prepares,5891,1743,0.2958750636564251,4148,0.704124936343575,2018,2018.csv
12024,Infliction,5875,5875,1.0,0,0.0,2014,2014.csv
12025,The Imperialists Are Still Alive!,5874,5874,1.0,0,0.0,2011,2011.csv
12026,Empire of Silver 2011 Re-release,5867,0,0.0,5867,1.0,2011,2011.csv
12027,BuzzKill,5860,5860,1.0,0,0.0,2012,2012.csv
12028,Top Spin,5858,5858,1.0,0,0.0,2015,2015.csv
12029,Bourek,5844,5844,1.0,0,0.0,2016,2016.csv
12030,Shout Gladi Gladi,5839,5839,1.0,0,0.0,2015,2015.csv
12031,Strike! 2000 Re-release,5838,5838,1.0,0,0.0,2000,2000.csv
12032,Human Nature,5834,5487,0.9405210833047651,347,0.05947891669523483,2019,2019.csv
12033,Bad Blood,5812,5812,1.0,0,0.0,2001,2001.csv
12034,Emile,5799,5799,1.0,0,0.0,2005,2005.csv
12035,Five Dances,5788,5788,1.0,0,0.0,2013,2013.csv
12036,Choose Connor,5788,5788,1.0,0,0.0,2008,2008.csv
12037,Black November,5782,5782,1.0,0,0.0,2015,2015.csv
12038,Undrafted,5777,5777,1.0,0,0.0,2016,2016.csv
12039,Sushi: The Global Catch,5757,5757,1.0,0,0.0,2012,2012.csv
12040,A Dark Truth,5750,5750,1.0,0,0.0,2013,2013.csv
12041,Jailbait,5741,5741,1.0,0,0.0,2006,2006.csv
12042,The Overture 2005 Re-release,5740,2254,0.3926829268292683,3486,0.6073170731707317,2005,2005.csv
12043,Dream,5729,5729,1.0,0,0.0,2005,2005.csv
12044,Klezmer on Fish Street,5724,5724,1.0,0,0.0,2004,2004.csv
12045,Save the Date,5719,5719,1.0,0,0.0,2012,2012.csv
12046,Pizza,5716,5716,1.0,0,0.0,2006,2006.csv
12047,Fraulein,5715,5715,1.0,0,0.0,2008,2008.csv
12048,Mr. Blue Sky,5713,5713,1.0,0,0.0,2007,2007.csv
12049,Love Goes Public,5700,5700,1.0,0,0.0,2019,2019.csv
12050,The Wanted 18,5680,5680,1.0,0,0.0,2015,2015.csv
12051,People of a Feather,5677,5677,1.0,0,0.0,2013,2013.csv
12052,The Fall of Night,5673,5673,1.0,0,0.0,2010,2010.csv
12053,Fired!,5661,5661,1.0,0,0.0,2007,2007.csv
12054,Knife Fight,5661,5661,1.0,0,0.0,2013,2013.csv
12055,Papirosen,5658,5658,1.0,0,0.0,2014,2014.csv
12056,This Isn't Funny,5654,5654,1.0,0,0.0,2015,2015.csv
12057,The Roost,5642,5642,1.0,0,0.0,2005,2005.csv
12058,Série noire,5633,5633,1.0,0,0.0,2019,2019.csv
12059,La Chinoise 2017 Re-release,5631,5631,1.0,0,0.0,2017,2017.csv
12060,Elevate,5580,5580,1.0,0,0.0,2011,2011.csv
12061,Our Man in Tehran,5573,5573,1.0,0,0.0,2015,2015.csv
12062,Kid Cannabis,5565,5565,1.0,0,0.0,2014,2014.csv
12063,The Miracle of the Little Prince,5553,5553,1.0,0,0.0,2019,2019.csv
12064,Booker's Place: A Mississippi Story,5549,5549,1.0,0,0.0,2012,2012.csv
12065,Gogol Bordello Non-Stop,5532,5532,1.0,0,0.0,2009,2009.csv
12066,American Grindhouse,5529,5529,1.0,0,0.0,2010,2010.csv
12067,Are We Not Cats,5518,5518,1.0,0,0.0,2018,2018.csv
12068,The Living,5514,5514,1.0,0,0.0,2015,2015.csv
12069,Icaros: A Vision,5510,5510,1.0,0,0.0,2017,2017.csv
12070,The First $20 Million Is Always the Hardest,5491,5491,1.0,0,0.0,2002,2002.csv
12071,The Man from Earth: Holocene,5472,5472,1.0,0,0.0,2017,2017.csv
12072,Quattro Noza,5471,5471,1.0,0,0.0,2005,2005.csv
12073,Race You to the Bottom,5468,5468,1.0,0,0.0,2007,2007.csv
12074,Coming Soon,5453,5453,1.0,0,0.0,2000,2000.csv
12075,Cuban Food Stories,5434,5434,1.0,0,0.0,2018,2018.csv
12076,Nights and Weekends,5430,5430,1.0,0,0.0,2008,2008.csv
12077,Fratricide,5428,5428,1.0,0,0.0,2007,2007.csv
12078,Unnatural & Accidental,5420,5420,1.0,0,0.0,2006,2006.csv
12079,Flex Is Kings,5418,5418,1.0,0,0.0,2014,2014.csv
12080,Whiz Kids,5386,5386,1.0,0,0.0,2010,2010.csv
12081,The Only Real Game,5384,5384,1.0,0,0.0,2014,2014.csv
12082,Dog Days of Summer,5383,5383,1.0,0,0.0,2008,2008.csv
12083,Hatsujô kateikyôshi: Sensei no aijiru,5383,5383,1.0,0,0.0,2007,2007.csv
12084,Say Uncle,5361,5361,1.0,0,0.0,2006,2006.csv
12085,Particles of Truth,5348,5348,1.0,0,0.0,2004,2004.csv
12086,Rock the Bells,5347,5347,1.0,0,0.0,2007,2007.csv
12087,Hair High,5342,5342,1.0,0,0.0,2006,2006.csv
12088,"La Commune (Paris, 1871)",5340,5340,1.0,0,0.0,2003,2003.csv
12089,She's Lost Control,5319,5319,1.0,0,0.0,2015,2015.csv
12090,Mouth to Mouth,5318,2150,0.4042873260624295,3168,0.5957126739375705,2006,2006.csv
12091,The Time Being,5274,5274,1.0,0,0.0,2013,2013.csv
12092,It's Not Yet Dark,5269,1227,0.2328715126209907,4042,0.7671284873790093,2017,2017.csv
12093,Killers,5248,0,0.0,5248,1.0,2014,2014.csv
12094,Sarajevo,5247,5247,1.0,0,0.0,2015,2015.csv
12095,Speed-Dating,5240,5240,1.0,0,0.0,2010,2010.csv
12096,Room,5228,5228,1.0,0,0.0,2006,2006.csv
12097,Home Room,5216,5216,1.0,0,0.0,2003,2003.csv
12098,The Princess of France,5212,5212,1.0,0,0.0,2015,2015.csv
12099,Death Valley,5211,5211,1.0,0,0.0,2015,2015.csv
12100,In Searching,5210,5210,1.0,0,0.0,2018,2018.csv
12101,A Lawyer Walks Into a Bar...,5202,5202,1.0,0,0.0,2008,2008.csv
12102,Chokehold,5200,5200,1.0,0,0.0,2019,2019.csv
12103,King Leopold's Ghost,5194,5194,1.0,0,0.0,2006,2006.csv
12104,The Gliksmans,5166,5166,1.0,0,0.0,2019,2019.csv
12105,"Vendetta: No Conscience, No Mercy",5161,5161,1.0,0,0.0,2003,2003.csv
12106,Lakeboat,5159,5159,1.0,0,0.0,2001,2001.csv
12107,And They're Off,5154,5154,1.0,0,0.0,2011,2011.csv
12108,100 Acres of Hell,5152,5152,1.0,0,0.0,2019,2019.csv
12109,Turn the River,5149,5149,1.0,0,0.0,2008,2008.csv
12110,To Die Is Hard,5129,5129,1.0,0,0.0,2010,2010.csv
12111,Body at Brighton Rock,5123,5123,1.0,0,0.0,2019,2019.csv
12112,Return to Nuke 'Em High Volume 1,5122,5122,1.0,0,0.0,2014,2014.csv
12113,Intersection,5116,5116,1.0,0,0.0,2018,2018.csv
12114,The Strip,5107,5107,1.0,0,0.0,2009,2009.csv
12115,God and Gays: Bridging the Gap,5095,5095,1.0,0,0.0,2008,2008.csv
12116,Bad Lucky Goat,5088,5088,1.0,0,0.0,2017,2017.csv
12117,On War 2015 Re-release,5086,5086,1.0,0,0.0,2015,2015.csv
12118,Welcome to Happiness,5083,5083,1.0,0,0.0,2016,2016.csv
12119,2307: Winter's Dream,5078,0,0.0,5078,1.0,2017,2017.csv
12120,Bidder 70,5074,5074,1.0,0,0.0,2013,2013.csv
12121,Tanner Hall,5073,5073,1.0,0,0.0,2011,2011.csv
12122,Notes on an Appearance,5065,5065,1.0,0,0.0,2018,2018.csv
12123,Chulas Fronteras,5021,5021,1.0,0,0.0,2019,2019.csv
12124,The Sleepwalker,5012,5012,1.0,0,0.0,2014,2014.csv
12125,Downtown Express,5010,5010,1.0,0,0.0,2012,2012.csv
12126,The Texture of Falling,5010,5010,1.0,0,0.0,2018,2018.csv
12127,Social Animals,5007,5007,1.0,0,0.0,2018,2018.csv
12128,The Garden,5006,5006,1.0,0,0.0,2019,2019.csv
12129,An L.A. Minute,5004,5004,1.0,0,0.0,2018,2018.csv
12130,Newlyweds,5000,5000,1.0,0,0.0,2012,2012.csv
12131,Perfect Pie,5000,5000,1.0,0,0.0,2002,2002.csv
12132,Weekend of a Champion,4976,4100,0.8239549839228296,876,0.1760450160771704,2013,2013.csv
12133,Bringing Up Bobby,4975,4975,1.0,0,0.0,2012,2012.csv
12134,sxtape,4961,0,0.0,4961,1.0,2014,2014.csv
12135,Futaba kara tooku hanarete,4960,4960,1.0,0,0.0,2013,2013.csv
12136,Herman's House,4956,4956,1.0,0,0.0,2013,2013.csv
12137,To Die Like a Man,4955,4029,0.8131180625630676,926,0.1868819374369324,2011,2011.csv
12138,SBK: The Movie,4950,4950,1.0,0,0.0,2015,2015.csv
12139,Tournament,4942,4942,1.0,0,0.0,2017,2017.csv
12140,Company Town,4934,4934,1.0,0,0.0,2017,2017.csv
12141,"Peace, Propaganda & the Promised Land",4930,4930,1.0,0,0.0,2005,2005.csv
12142,Supporting Characters,4917,4917,1.0,0,0.0,2013,2013.csv
12143,Guidance,4900,4900,1.0,0,0.0,2015,2015.csv
12144,Malek,4898,4898,1.0,0,0.0,2019,2019.csv
12145,Everything's Cool,4890,4890,1.0,0,0.0,2007,2007.csv
12146,Home of the Brave,4874,4874,1.0,0,0.0,2004,2004.csv
12147,Revelation Road 2: The Sea of Glass and Fire,4871,4871,1.0,0,0.0,2013,2013.csv
12148,Nothing Bad Can Happen,4870,4870,1.0,0,0.0,2014,2014.csv
12149,Kira's Reason: A Love Story,4847,4847,1.0,0,0.0,2003,2003.csv
12150,Crepitus,4846,4846,1.0,0,0.0,2019,2019.csv
12151,Call Her Applebroog,4842,4842,1.0,0,0.0,2016,2016.csv
12152,Ballet Blanc,4832,4832,1.0,0,0.0,2019,2019.csv
12153,High Times Potluck,4827,4827,1.0,0,0.0,2003,2003.csv
12154,Ferlinghetti: A Rebirth of Wonder,4816,4816,1.0,0,0.0,2013,2013.csv
12155,The Pusher Trilogy,4815,4815,1.0,0,0.0,2006,2006.csv
12156,50 Ways of Saying Fabulous,4800,4800,1.0,0,0.0,2006,2006.csv
12157,"Half The Road: The Passion, Pitfalls & Power of Women's Professional Cycling",4783,4783,1.0,0,0.0,2014,2014.csv
12158,Perlasca,4780,4780,1.0,0,0.0,2005,2005.csv
12159,Street Fight,4779,4779,1.0,0,0.0,2006,2006.csv
12160,Behind the White Glasses,4770,2223,0.4660377358490566,2547,0.5339622641509434,2016,2016.csv
12161,Tre,4759,4759,1.0,0,0.0,2008,2008.csv
12162,Secret Society,4725,4725,1.0,0,0.0,2002,2002.csv
12163,Miss Hill: Making Dance Matter,4706,4706,1.0,0,0.0,2015,2015.csv
12164,Shot,4701,4701,1.0,0,0.0,2017,2017.csv
12165,Marinoni: The Fire in the Frame,4696,4696,1.0,0,0.0,2016,2016.csv
12166,The Other Side of Everything,4685,4685,1.0,0,0.0,2018,2018.csv
12167,Isn't This a Time! A Tribute Concert for Harold Leventhal,4683,4683,1.0,0,0.0,2005,2005.csv
12168,Death Metal Angola,4674,4674,1.0,0,0.0,2014,2014.csv
12169,The Long Dumb Road,4667,4667,1.0,0,0.0,2018,2018.csv
12170,Blood on the Mountain,4664,4664,1.0,0,0.0,2016,2016.csv
12171,Night School,4663,4663,1.0,0,0.0,2017,2017.csv
12172,I Love You Both,4661,4661,1.0,0,0.0,2017,2017.csv
12173,How to Draw a Bunny,4658,4658,1.0,0,0.0,2004,2004.csv
12174,Shakespeare-Wallah,4650,4650,1.0,0,0.0,2017,2017.csv
12175,Against the Sun,4646,4646,1.0,0,0.0,2015,2015.csv
12176,The Death Factory Bloodletting,4638,4638,1.0,0,0.0,2009,2009.csv
12177,Seeds of Time,4630,4630,1.0,0,0.0,2015,2015.csv
12178,The Fall of Fujimori,4630,4630,1.0,0,0.0,2006,2006.csv
12179,Miss Stevens,4611,4611,1.0,0,0.0,2016,2016.csv
12180,Chaos,4608,4608,1.0,0,0.0,2003,2003.csv
12181,The Dogwalker 2006 Re-release,4604,4604,1.0,0,0.0,2006,2006.csv
12182,The Automatic Hate,4603,4603,1.0,0,0.0,2016,2016.csv
12183,Protector 2010 Re-release,4576,2968,0.6486013986013986,1608,0.3513986013986014,2010,2010.csv
12184,Search Party 2016 Re-release,4571,4571,1.0,0,0.0,2016,2016.csv
12185,Smiling Through the Apocalypse,4560,4560,1.0,0,0.0,2014,2014.csv
12186,Laura Smiles,4558,4558,1.0,0,0.0,2007,2007.csv
12187,All Is Bright,4556,4556,1.0,0,0.0,2013,2013.csv
12188,A Boy Called Po,4550,4550,1.0,0,0.0,2017,2017.csv
12189,The Tollbooth,4546,4546,1.0,0,0.0,2006,2006.csv
12190,Promised Lands,4546,4546,1.0,0,0.0,2010,2010.csv
12191,Here Comes the Devil,4534,4534,1.0,0,0.0,2013,2013.csv
12192,Weightless,4530,4461,0.9847682119205298,69,0.015231788079470199,2018,2018.csv
12193,Unrelated 2014 Re-release,4529,4529,1.0,0,0.0,2014,2014.csv
12194,House of the Sleeping Beauties,4509,4509,1.0,0,0.0,2008,2008.csv
12195,Synchronicity,4505,4505,1.0,0,0.0,2016,2016.csv
12196,The Pulitzer at 100,4489,4489,1.0,0,0.0,2017,2017.csv
12197,I'm Leaving Now,4488,4488,1.0,0,0.0,2019,2019.csv
12198,Looking for Kitty,4480,4480,1.0,0,0.0,2006,2006.csv
12199,German Concentration Camps Factual Survey,4468,4468,1.0,0,0.0,2017,2017.csv
12200,The Ministers,4447,4447,1.0,0,0.0,2009,2009.csv
12201,"Farewell, Herr Schwarz",4445,4445,1.0,0,0.0,2015,2015.csv
12202,Generation Iron 2,4439,4439,1.0,0,0.0,2017,2017.csv
12203,Cowboy del Amor,4438,4438,1.0,0,0.0,2006,2006.csv
12204,Coffee Date,4412,4412,1.0,0,0.0,2006,2006.csv
12205,Sacred Stage: The Mariinsky Theater,4410,4410,1.0,0,0.0,2005,2005.csv
12206,SGT. Will Gardner,4405,4405,1.0,0,0.0,2019,2019.csv
12207,The Truth About Emanuel,4404,4404,1.0,0,0.0,2014,2014.csv
12208,The Peacemaker,4400,4400,1.0,0,0.0,2018,2018.csv
12209,30-LOVE,4392,4392,1.0,0,0.0,2017,2017.csv
12210,Open My Heart,4381,4381,1.0,0,0.0,2004,2004.csv
12211,Between Us,4380,4380,1.0,0,0.0,2013,2013.csv
12212,The End of Time,4375,4375,1.0,0,0.0,2013,2013.csv
12213,The Woman Who Left,4373,3974,0.9087582895037731,399,0.09124171049622684,2017,2017.csv
12214,The Catechism Cataclysm,4373,4373,1.0,0,0.0,2011,2011.csv
12215,The Party's Just Beginning,4371,4145,0.9482955845344315,226,0.05170441546556852,2018,2018.csv
12216,Blood & Tears,4364,4364,1.0,0,0.0,2007,2007.csv
12217,The Flower of Kim Jong II,4362,4362,1.0,0,0.0,2010,2010.csv
12218,Tito and the Birds,4332,4332,1.0,0,0.0,2019,2019.csv
12219,On Meditation,4322,4322,1.0,0,0.0,2016,2016.csv
12220,Days of Grace 2015 Re-release,4308,4308,1.0,0,0.0,2015,2015.csv
12221,The Tower,4305,1117,0.259465737514518,3188,0.740534262485482,2014,2014.csv
12222,Auto Shop of Horrors,4300,4300,1.0,0,0.0,2016,2016.csv
12223,Beauty Remains,4298,4298,1.0,0,0.0,2007,2007.csv
12224,My Kingdom,4296,4296,1.0,0,0.0,2002,2002.csv
12225,The Fate of Lee Khan,4295,4295,1.0,0,0.0,2019,2019.csv
12226,Art Is... The Permanent Revolution,4291,4291,1.0,0,0.0,2012,2012.csv
12227,Brown's Requiem,4287,4287,1.0,0,0.0,2000,2000.csv
12228,State Like Sleep,4282,4282,1.0,0,0.0,2019,2019.csv
12229,Set Fire to the Stars,4280,4280,1.0,0,0.0,2015,2015.csv
12230,Jersey Guy,4268,4268,1.0,0,0.0,2003,2003.csv
12231,This Divided State,4255,4255,1.0,0,0.0,2005,2005.csv
12232,Corked,4254,4254,1.0,0,0.0,2009,2009.csv
12233,The Knife of Don Juan,4254,4254,1.0,0,0.0,2015,2015.csv
12234,My Father Die,4252,4252,1.0,0,0.0,2017,2017.csv
12235,Cocote,4224,3815,0.9031723484848485,409,0.09682765151515152,2018,2018.csv
12236,Stella Does Tricks,4224,4224,1.0,0,0.0,2000,2000.csv
12237,Maximum Ride,4218,4218,1.0,0,0.0,2016,2016.csv
12238,Twisted: A Balloonamentary,4218,4218,1.0,0,0.0,2008,2008.csv
12239,Stella's Last Weekend,4215,4215,1.0,0,0.0,2018,2018.csv
12240,Breaking a Monster,4212,4212,1.0,0,0.0,2016,2016.csv
12241,Free the Nipple,4198,4198,1.0,0,0.0,2014,2014.csv
12242,Helena from the Wedding,4190,4190,1.0,0,0.0,2010,2010.csv
12243,Among the Believers,4189,4189,1.0,0,0.0,2016,2016.csv
12244,3 Geezers!,4175,4175,1.0,0,0.0,2013,2013.csv
12245,Daylight,4171,4171,1.0,0,0.0,2011,2011.csv
12246,Melvin Goes to Dinner,4168,4168,1.0,0,0.0,2003,2003.csv
12247,Badsville,4153,4153,1.0,0,0.0,2017,2017.csv
12248,The Hillside Strangler,4143,4143,1.0,0,0.0,2004,2004.csv
12249,Pawn,4141,4141,1.0,0,0.0,2013,2013.csv
12250,Chinese Portrait,4140,4140,1.0,0,0.0,2019,2019.csv
12251,Hera Purple,4123,4123,1.0,0,0.0,2002,2002.csv
12252,Stella Street,4119,4119,1.0,0,0.0,2004,2004.csv
12253,The Painting,4115,4115,1.0,0,0.0,2005,2005.csv
12254,Contracted,4105,4105,1.0,0,0.0,2013,2013.csv
12255,Solar Flare,4098,4098,1.0,0,0.0,2008,2008.csv
12256,Ordinary Sinner,4083,4083,1.0,0,0.0,2003,2003.csv
12257,Jason Becker: Not Dead Yet,4080,1294,0.317156862745098,2786,0.682843137254902,2012,2012.csv
12258,Silver Circle,4080,4080,1.0,0,0.0,2013,2013.csv
12259,Three Night Stand,4076,4076,1.0,0,0.0,2015,2015.csv
12260,Bandido,4064,4064,1.0,0,0.0,2004,2004.csv
12261,Simon 2006 Re-release,4055,4055,1.0,0,0.0,2006,2006.csv
12262,The Kitchen,4054,4054,1.0,0,0.0,2013,2013.csv
12263,La Flor,4032,4032,1.0,0,0.0,2019,2019.csv
12264,Morning,4029,4029,1.0,0,0.0,2013,2013.csv
12265,Approved for Adoption 2013 Re-release,4015,4015,1.0,0,0.0,2013,2013.csv
12266,Psychopathia Sexualis,4012,4012,1.0,0,0.0,2006,2006.csv
12267,Guest Artist,4011,4011,1.0,0,0.0,2020,2020.csv
12268,Yangsi,4008,4008,1.0,0,0.0,2012,2012.csv
12269,Building Hope,4000,4000,1.0,0,0.0,2011,2011.csv
12270,Pickin' & Grinnin',4000,4000,1.0,0,0.0,2012,2012.csv
12271,Campus Radio,4000,4000,1.0,0,0.0,2011,2011.csv
12272,Emily,3982,3982,1.0,0,0.0,2017,2017.csv
12273,Dream Boat,3981,3981,1.0,0,0.0,2017,2017.csv
12274,Armed,3948,3948,1.0,0,0.0,2018,2018.csv
12275,Just Say Love,3944,3944,1.0,0,0.0,2010,2010.csv
12276,"C'est pas moi, c'est l'autre",3935,3935,1.0,0,0.0,2007,2007.csv
12277,"Blood, Friends and Money",3930,3930,1.0,0,0.0,2000,2000.csv
12278,Mother of a Day,3919,3919,1.0,0,0.0,2019,2019.csv
12279,Going Under,3917,3917,1.0,0,0.0,2006,2006.csv
12280,Where God Left His Shoes,3911,3911,1.0,0,0.0,2008,2008.csv
12281,Maidan,3909,3909,1.0,0,0.0,2014,2014.csv
12282,American Dresser,3895,3895,1.0,0,0.0,2018,2018.csv
12283,The Iron Ministry,3885,3340,0.8597168597168597,545,0.1402831402831403,2015,2015.csv
12284,Crown Vic,3868,3868,1.0,0,0.0,2019,2019.csv
12285,Hollidaysburg,3861,3861,1.0,0,0.0,2014,2014.csv
12286,The Second Time Around,3837,3837,1.0,0,0.0,2018,2018.csv
12287,Aashayein,3836,0,0.0,3836,1.0,2010,2010.csv
12288,"High Tech, Low Life",3836,3836,1.0,0,0.0,2013,2013.csv
12289,Saints and Sinners,3826,3826,1.0,0,0.0,2004,2004.csv
12290,King's Gambit,3816,3816,1.0,0,0.0,2020,2020.csv
12291,Free Radicals: A History of Experimental Film,3804,3804,1.0,0,0.0,2012,2012.csv
12292,My Wife Maurice 2004 Re-release,3803,3803,1.0,0,0.0,2004,2004.csv
12293,Wallflower,3801,3801,1.0,0,0.0,2019,2019.csv
12294,A Hole in My Heart,3784,3784,1.0,0,0.0,2005,2005.csv
12295,The Green Butchers,3783,3783,1.0,0,0.0,2004,2004.csv
12296,Bawandar,3779,3779,1.0,0,0.0,2003,2003.csv
12297,Unfreedom,3778,3778,1.0,0,0.0,2015,2015.csv
12298,They Come to America,3775,3775,1.0,0,0.0,2012,2012.csv
12299,Caravaggio,3774,3774,1.0,0,0.0,2002,2002.csv
12300,The Gender Card Flip,3774,3774,1.0,0,0.0,2017,2017.csv
12301,Berkeley,3770,3770,1.0,0,0.0,2007,2007.csv
12302,Shock to the System,3768,3768,1.0,0,0.0,2006,2006.csv
12303,In/Significant Others,3763,3763,1.0,0,0.0,2010,2010.csv
12304,The Hollow,3755,3755,1.0,0,0.0,2016,2016.csv
12305,Nelly,3751,3751,1.0,0,0.0,2018,2018.csv
12306,Bugs,3742,3742,1.0,0,0.0,2017,2017.csv
12307,Big Animal,3733,3733,1.0,0,0.0,2004,2004.csv
12308,Bad Blood,3731,3731,1.0,0,0.0,2012,2012.csv
12309,The Free Speech Apocalypse,3726,3726,1.0,0,0.0,2015,2015.csv
12310,The Condemned,3718,3718,1.0,0,0.0,2013,2013.csv
12311,The Harvest/La Cosecha,3709,3709,1.0,0,0.0,2011,2011.csv
12312,The Helix... Loaded,3700,3700,1.0,0,0.0,2005,2005.csv
12313,Heartless,3697,3697,1.0,0,0.0,2010,2010.csv
12314,The Family,3696,3696,1.0,0,0.0,2018,2018.csv
12315,"Still, the Children Are Here",3685,3685,1.0,0,0.0,2004,2004.csv
12316,Brothers in Arms,3664,3664,1.0,0,0.0,2004,2004.csv
12317,Dr. Benny,3657,3657,1.0,0,0.0,2003,2003.csv
12318,The Word,3648,3648,1.0,0,0.0,2014,2014.csv
12319,Smash His Camera,3644,3644,1.0,0,0.0,2010,2010.csv
12320,Stop The Pounding Heart,3642,3642,1.0,0,0.0,2014,2014.csv
12321,The Wandering Soap Opera,3624,3624,1.0,0,0.0,2019,2019.csv
12322,Mr. Nobody 2013 Re-release,3622,3622,1.0,0,0.0,2013,2013.csv
12323,Warrior of Light,3617,3617,1.0,0,0.0,2003,2003.csv
12324,Moog,3604,3604,1.0,0,0.0,2004,2004.csv
12325,Cockfight,3600,3600,1.0,0,0.0,2004,2004.csv
12326,Journeys with George,3588,3588,1.0,0,0.0,2003,2003.csv
12327,Hyena,3586,3401,0.9484104852203011,185,0.05158951477969883,2015,2015.csv
12328,Hide Your Smiling Faces,3576,3576,1.0,0,0.0,2014,2014.csv
12329,Happy Here and Now,3574,3574,1.0,0,0.0,2005,2005.csv
12330,Evolution of a Criminal,3568,3568,1.0,0,0.0,2014,2014.csv
12331,I'm Reed Fish,3567,3567,1.0,0,0.0,2007,2007.csv
12332,The Last Film Festival,3558,3558,1.0,0,0.0,2016,2016.csv
12333,Antonia,3550,3550,1.0,0,0.0,2007,2007.csv
12334,Fourplay,3550,3550,1.0,0,0.0,2018,2018.csv
12335,Sister Helen,3541,3541,1.0,0,0.0,2003,2003.csv
12336,The Beautiful Troublemaker 2017 Re-release,3540,3540,1.0,0,0.0,2017,2017.csv
12337,Tricked,3533,3533,1.0,0,0.0,2013,2013.csv
12338,A Bloody Aria 2008 Re-release,3532,518,0.14665911664779163,3014,0.8533408833522084,2008,2008.csv
12339,The Roads Not Taken,3518,3518,1.0,0,0.0,2020,2020.csv
12340,The Loving Story 2016 Re-release,3518,3518,1.0,0,0.0,2016,2016.csv
12341,Sex and the Future,3502,3502,1.0,0,0.0,2020,2020.csv
12342,Revolution OS,3500,3500,1.0,0,0.0,2002,2002.csv
12343,Who's Crazy?,3497,3497,1.0,0,0.0,2017,2017.csv
12344,Locker 13,3496,3496,1.0,0,0.0,2014,2014.csv
12345,The Citizen 2018 Re-release,3495,3495,1.0,0,0.0,2018,2018.csv
12346,Death of a Ghost Hunter,3490,3490,1.0,0,0.0,2009,2009.csv
12347,Dead Awake,3484,0,0.0,3484,1.0,2010,2010.csv
12348,"Love, Sweat and Tears",3482,3482,1.0,0,0.0,2017,2017.csv
12349,Metal Messiah,3476,3476,1.0,0,0.0,2010,2010.csv
12350,The Hacker Wars,3470,3470,1.0,0,0.0,2014,2014.csv
12351,The Full Picture,3467,3467,1.0,0,0.0,2010,2010.csv
12352,Short Eyes,3456,3456,1.0,0,0.0,2003,2003.csv
12353,Aftermath,3451,3451,1.0,0,0.0,2014,2014.csv
12354,Life's a Breeze 2014 Re-release,3450,3450,1.0,0,0.0,2014,2014.csv
12355,Grand Theft Parsons,3438,0,0.0,3438,1.0,2004,2004.csv
12356,Scenic Route,3434,3434,1.0,0,0.0,2013,2013.csv
12357,Mahogany Sunrise,3432,3432,1.0,0,0.0,2014,2014.csv
12358,Restored Me 2016 Re-release,3428,3428,1.0,0,0.0,2016,2016.csv
12359,Speed Sisters,3423,3423,1.0,0,0.0,2017,2017.csv
12360,The Happy Poet,3400,3400,1.0,0,0.0,2013,2013.csv
12361,The Cage Fighter,3392,3392,1.0,0,0.0,2018,2018.csv
12362,Tamala 2010: A Punk Cat in Space,3386,3386,1.0,0,0.0,2004,2004.csv
12363,The Price of Sugar,3384,3384,1.0,0,0.0,2007,2007.csv
12364,Rottentail,3383,3383,1.0,0,0.0,2019,2019.csv
12365,Blossoms of Fire,3365,3365,1.0,0,0.0,2006,2006.csv
12366,American Fork,3359,3359,1.0,0,0.0,2009,2009.csv
12367,Amanda & Jack Go Glamping,3352,3352,1.0,0,0.0,2017,2017.csv
12368,Bad Match,3351,3351,1.0,0,0.0,2017,2017.csv
12369,Followers,3350,3350,1.0,0,0.0,2018,2018.csv
12370,'Tis Autumn: The Search for Jackie Paris,3347,1476,0.440991933074395,1871,0.559008066925605,2007,2007.csv
12371,Fashion Victim,3346,3346,1.0,0,0.0,2010,2010.csv
12372,Swerve,3338,3338,1.0,0,0.0,2013,2013.csv
12373,Mi America,3330,3330,1.0,0,0.0,2015,2015.csv
12374,Know How,3323,3323,1.0,0,0.0,2015,2015.csv
12375,Drunk Wedding,3301,3301,1.0,0,0.0,2015,2015.csv
12376,Looking Through Lillian,3300,3300,1.0,0,0.0,2002,2002.csv
12377,Burning Bodhi,3289,3289,1.0,0,0.0,2016,2016.csv
12378,Axe Giant: The Wrath of Paul Bunyan,3287,3287,1.0,0,0.0,2013,2013.csv
12379,El Superstar: The Unlikely Rise of Juan Frances,3271,3271,1.0,0,0.0,2010,2010.csv
12380,I Love Your Work,3264,3264,1.0,0,0.0,2005,2005.csv
12381,Calvaire,3260,3260,1.0,0,0.0,2006,2006.csv
12382,Justice,3259,3259,1.0,0,0.0,2017,2017.csv
12383,Windsor Drive,3256,3256,1.0,0,0.0,2015,2015.csv
12384,Sex Sells: The Making of 'Touché',3252,3252,1.0,0,0.0,2005,2005.csv
12385,Devil Girl,3244,3244,1.0,0,0.0,2009,2009.csv
12386,Over the Limit,3243,3243,1.0,0,0.0,2018,2018.csv
12387,The Sons of Tennessee Williams,3242,3242,1.0,0,0.0,2011,2011.csv
12388,As Cool as I Am,3234,3234,1.0,0,0.0,2013,2013.csv
12389,Gooby,3234,3234,1.0,0,0.0,2009,2009.csv
12390,The Work and the Story,3233,3233,1.0,0,0.0,2003,2003.csv
12391,Blackhats,3216,3216,1.0,0,0.0,2015,2015.csv
12392,A Cuban Legend,3212,3212,1.0,0,0.0,2002,2002.csv
12393,The Backyard,3200,3200,1.0,0,0.0,2003,2003.csv
12394,95 Miles to Go,3195,3195,1.0,0,0.0,2006,2006.csv
12395,After the Wizard,3184,3184,1.0,0,0.0,2012,2012.csv
12396,Apart,3161,3161,1.0,0,0.0,2012,2012.csv
12397,Game Changers,3142,3142,1.0,0,0.0,2018,2018.csv
12398,Balls to the Wall,3140,3140,1.0,0,0.0,2011,2011.csv
12399,Four Eyed Monsters,3135,3135,1.0,0,0.0,2006,2006.csv
12400,Hot to Trot,3133,3133,1.0,0,0.0,2018,2018.csv
12401,American Zombie,3126,3126,1.0,0,0.0,2008,2008.csv
12402,The Girl on the Train,3124,3124,1.0,0,0.0,2014,2014.csv
12403,Nowhere Man,3105,3105,1.0,0,0.0,2005,2005.csv
12404,The Prisoner or: How I Planned to Kill Tony Blair,3103,3103,1.0,0,0.0,2007,2007.csv
12405,Showrunners: The Art of Running a TV Show,3100,3100,1.0,0,0.0,2014,2014.csv
12406,What Now? Remind Me,3089,3089,1.0,0,0.0,2014,2014.csv
12407,Who Does She Think She Is?,3081,3081,1.0,0,0.0,2008,2008.csv
12408,Valley Girl,3080,0,0.0,3080,1.0,2020,2020.csv
12409,Drew: The Man Behind the Poster,3078,3078,1.0,0,0.0,2013,2013.csv
12410,Chasing Portraits,3076,3076,1.0,0,0.0,2019,2019.csv
12411,Spiral,3072,3072,1.0,0,0.0,2008,2008.csv
12412,The Weird World of Blowfly,3062,3062,1.0,0,0.0,2011,2011.csv
12413,The Afterlight,3059,3059,1.0,0,0.0,2010,2010.csv
12414,Los Muertos 2007 Re-release,3027,3027,1.0,0,0.0,2007,2007.csv
12415,Unveiled,3025,3025,1.0,0,0.0,2005,2005.csv
12416,A French Gigolo 2014 Re-release,3021,3021,1.0,0,0.0,2014,2014.csv
12417,A Girl and a Gun,3018,3018,1.0,0,0.0,2013,2013.csv
12418,Best and Most Beautiful Things,3016,3016,1.0,0,0.0,2016,2016.csv
12419,15,3013,3013,1.0,0,0.0,2005,2005.csv
12420,Fatal Assistance,3000,3000,1.0,0,0.0,2014,2014.csv
12421,Zokkomon,3000,3000,1.0,0,0.0,2011,2011.csv
12422,The Lie,3000,3000,1.0,0,0.0,2011,2011.csv
12423,The Ghosts of Johnson Woods,3000,3000,1.0,0,0.0,2016,2016.csv
12424,Stolen Childhoods,2996,2996,1.0,0,0.0,2005,2005.csv
12425,Moana,2993,2993,1.0,0,0.0,2015,2015.csv
12426,Run for Your Life,2992,2992,1.0,0,0.0,2008,2008.csv
12427,Intervention,2980,279,0.0936241610738255,2701,0.9063758389261745,2007,2007.csv
12428,Wetlands Preserved: The Story of an Activist Nightclub,2970,2970,1.0,0,0.0,2008,2008.csv
12429,Dog Lover's Symphony,2968,2968,1.0,0,0.0,2006,2006.csv
12430,Tattoo Bar,2964,2964,1.0,0,0.0,2002,2002.csv
12431,Ash Wednesday,2942,2942,1.0,0,0.0,2002,2002.csv
12432,Kepler's Dream,2923,2923,1.0,0,0.0,2017,2017.csv
12433,Demons,2900,2900,1.0,0,0.0,2017,2017.csv
12434,"On the Other Hand, Death",2892,2892,1.0,0,0.0,2008,2008.csv
12435,The Professor: Tai Chi's Journey West,2852,2852,1.0,0,0.0,2016,2016.csv
12436,Three Days of Rain,2841,2841,1.0,0,0.0,2005,2005.csv
12437,Lower Learning,2804,2804,1.0,0,0.0,2008,2008.csv
12438,Okraina,2797,2797,1.0,0,0.0,2004,2004.csv
12439,Approaching Midnight,2795,2795,1.0,0,0.0,2013,2013.csv
12440,Nana,2784,2784,1.0,0,0.0,2018,2018.csv
12441,Lush,2763,2763,1.0,0,0.0,2001,2001.csv
12442,The Blue Tooth Virgin,2762,2762,1.0,0,0.0,2009,2009.csv
12443,Blood Ties,2760,2760,1.0,0,0.0,2011,2011.csv
12444,White Lies 2016 Re-release,2760,2760,1.0,0,0.0,2016,2016.csv
12445,I Dream in Another Language,2739,2739,1.0,0,0.0,2017,2017.csv
12446,Black Out 2014 Re-release,2734,2734,1.0,0,0.0,2014,2014.csv
12447,The Lesser Blessed,2732,2732,1.0,0,0.0,2013,2013.csv
12448,Agnes and His Brothers 2006 Re-release,2731,2731,1.0,0,0.0,2006,2006.csv
12449,Julia,2710,2710,1.0,0,0.0,2015,2015.csv
12450,Chocolat 2015 Re-release,2710,2710,1.0,0,0.0,2015,2015.csv
12451,Adolf Eichmann,2706,2706,1.0,0,0.0,2010,2010.csv
12452,Back to the Fatherland,2697,2697,1.0,0,0.0,2019,2019.csv
12453,The Boys in the Band 2000 Re-release,2695,2695,1.0,0,0.0,2000,2000.csv
12454,Santoalla,2684,2684,1.0,0,0.0,2017,2017.csv
12455,Straight Into a Storm,2684,2684,1.0,0,0.0,2018,2018.csv
12456,Division 19,2680,1699,0.633955223880597,981,0.366044776119403,2019,2019.csv
12457,Restitution,2664,2664,1.0,0,0.0,2011,2011.csv
12458,United Red Army 2011 Re-release,2659,2659,1.0,0,0.0,2011,2011.csv
12459,Daughter of the Nile,2640,2640,1.0,0,0.0,2017,2017.csv
12460,Body,2634,2634,1.0,0,0.0,2015,2015.csv
12461,Refuge,2631,2631,1.0,0,0.0,2014,2014.csv
12462,ACORN and the Firestorm,2621,2621,1.0,0,0.0,2018,2018.csv
12463,Indigo Children,2621,2621,1.0,0,0.0,2014,2014.csv
12464,The Child I Never Was,2609,2609,1.0,0,0.0,2004,2004.csv
12465,Sparrows Dance,2602,2602,1.0,0,0.0,2013,2013.csv
12466,Conspiracy of Silence,2598,2598,1.0,0,0.0,2004,2004.csv
12467,Last Flight of the Champion,2597,2597,1.0,0,0.0,2013,2013.csv
12468,Carl,2592,2592,1.0,0,0.0,2012,2012.csv
12469,Jake Squared,2592,2592,1.0,0,0.0,2014,2014.csv
12470,Dead or Alive: Final,2591,2591,1.0,0,0.0,2002,2002.csv
12471,Hammer of the Gods,2590,641,0.24749034749034748,1949,0.7525096525096525,2013,2013.csv
12472,Take Me,2583,2583,1.0,0,0.0,2017,2017.csv
12473,McCanick,2572,2572,1.0,0,0.0,2014,2014.csv
12474,Hayride 2,2571,2571,1.0,0,0.0,2015,2015.csv
12475,Joan the Maid 1: The Battles,2562,2562,1.0,0,0.0,2019,2019.csv
12476,Ginger Snaps,2554,2554,1.0,0,0.0,2001,2001.csv
12477,Out of Place: Memories of Edward Said,2547,2547,1.0,0,0.0,2006,2006.csv
12478,Cassadaga,2544,2544,1.0,0,0.0,2013,2013.csv
12479,Whatever Happened to Harold Smith?,2543,2543,1.0,0,0.0,2001,2001.csv
12480,Two-Bit Waltz,2540,2540,1.0,0,0.0,2014,2014.csv
12481,Miles,2537,2537,1.0,0,0.0,2017,2017.csv
12482,Risk/Reward,2517,2517,1.0,0,0.0,2004,2004.csv
12483,Almost in Love,2510,2510,1.0,0,0.0,2013,2013.csv
12484,Swing,2509,2509,1.0,0,0.0,2004,2004.csv
12485,Mekong Hotel,2502,2502,1.0,0,0.0,2016,2016.csv
12486,Standing by Yourself,2500,2500,1.0,0,0.0,2002,2002.csv
12487,L'autre monde 2004 Re-release,2494,2494,1.0,0,0.0,2004,2004.csv
12488,Herbie Hancock: Possibilities,2493,2493,1.0,0,0.0,2006,2006.csv
12489,The Last Day of August,2492,2492,1.0,0,0.0,2013,2013.csv
12490,Homeland (Iraq Year Zero),2491,2491,1.0,0,0.0,2016,2016.csv
12491,Rank,2485,2485,1.0,0,0.0,2006,2006.csv
12492,Men at Lunch,2483,2483,1.0,0,0.0,2013,2013.csv
12493,The Wait,2480,2480,1.0,0,0.0,2014,2014.csv
12494,TINY: The Life of Erin Blackwell,2465,2465,1.0,0,0.0,2019,2019.csv
12495,Motocross Kids,2462,2462,1.0,0,0.0,2004,2004.csv
12496,The Ghastly Love of Johnny X,2436,2436,1.0,0,0.0,2012,2012.csv
12497,Why Stop Now?,2432,2432,1.0,0,0.0,2012,2012.csv
12498,The Reflektor Tapes,2424,0,0.0,2424,1.0,2015,2015.csv
12499,Firedancer,2422,2422,1.0,0,0.0,2004,2004.csv
12500,L.A. Slasher,2421,2421,1.0,0,0.0,2015,2015.csv
12501,Zig Zag,2418,2418,1.0,0,0.0,2002,2002.csv
12502,Ek Hazarachi Note,2404,2404,1.0,0,0.0,2016,2016.csv
12503,Looking for an Icon,2393,2393,1.0,0,0.0,2007,2007.csv
12504,Polar Opposites,2377,2377,1.0,0,0.0,2008,2008.csv
12505,The Optimists,2377,2377,1.0,0,0.0,2005,2005.csv
12506,Daniel and Ana,2372,2372,1.0,0,0.0,2010,2010.csv
12507,Moondance,2371,2371,1.0,0,0.0,2020,2020.csv
12508,Evergreen: The Road to Legalization,2363,2363,1.0,0,0.0,2014,2014.csv
12509,The Village Barbershop,2359,2359,1.0,0,0.0,2009,2009.csv
12510,I Lost Albert 2019 Re-release,2354,2354,1.0,0,0.0,2019,2019.csv
12511,A German Youth,2343,2343,1.0,0,0.0,2019,2019.csv
12512,Detective Chinatown 3,2342,0,0.0,2342,1.0,2020,2020.csv
12513,13 Months of Sunshine,2337,2337,1.0,0,0.0,2008,2008.csv
12514,Lotus Eaters,2325,2325,1.0,0,0.0,2013,2013.csv
12515,You're Gonna Miss Me,2324,2324,1.0,0,0.0,2007,2007.csv
12516,The Happy House,2311,2311,1.0,0,0.0,2013,2013.csv
12517,Goldie,2302,2302,1.0,0,0.0,2020,2020.csv
12518,Serendipity,2298,2298,1.0,0,0.0,2019,2019.csv
12519,The Girl 2010 Re-release,2273,2201,0.9683238011438627,72,0.03167619885613726,2010,2010.csv
12520,The Pool Boys,2269,2269,1.0,0,0.0,2011,2011.csv
12521,Red Christmas,2255,2255,1.0,0,0.0,2017,2017.csv
12522,Anita Ho,2250,2250,1.0,0,0.0,2015,2015.csv
12523,The Big Question,2248,2248,1.0,0,0.0,2006,2006.csv
12524,Memoria,2242,2242,1.0,0,0.0,2016,2016.csv
12525,Mirage,2241,2241,1.0,0,0.0,2006,2006.csv
12526,You Wont Miss Me,2240,2240,1.0,0,0.0,2010,2010.csv
12527,Virgil Bliss,2219,2219,1.0,0,0.0,2002,2002.csv
12528,The Night Watchman,2219,2219,1.0,0,0.0,2012,2012.csv
12529,Side Effects,2216,2216,1.0,0,0.0,2005,2005.csv
12530,Workingman's Death,2214,2214,1.0,0,0.0,2006,2006.csv
12531,7 from Etheria,2208,2208,1.0,0,0.0,2017,2017.csv
12532,InSpectres,2207,2207,1.0,0,0.0,2013,2013.csv
12533,Scorn,2206,2206,1.0,0,0.0,2012,2012.csv
12534,Dischord,2199,2199,1.0,0,0.0,2003,2003.csv
12535,George Bush Goes to Heaven,2192,2192,1.0,0,0.0,2006,2006.csv
12536,Hell's Highway: The True Story of Highway Safety Films,2171,2171,1.0,0,0.0,2003,2003.csv
12537,The 4th Tenor,2152,2152,1.0,0,0.0,2002,2002.csv
12538,Stripped,2151,2151,1.0,0,0.0,2002,2002.csv
12539,Better Living,2147,2147,1.0,0,0.0,2000,2000.csv
12540,Stealing the Fire,2139,2139,1.0,0,0.0,2002,2002.csv
12541,NoBody's Perfect 2010 Re-release,2122,2122,1.0,0,0.0,2010,2010.csv
12542,Missionary,2120,2120,1.0,0,0.0,2014,2014.csv
12543,Running with Arnold,2119,2119,1.0,0,0.0,2008,2008.csv
12544,Me You and Five Bucks,2105,2105,1.0,0,0.0,2015,2015.csv
12545,Jihadists,2104,2104,1.0,0,0.0,2019,2019.csv
12546,Dayveon,2077,2077,1.0,0,0.0,2017,2017.csv
12547,Rubberneck,2075,2075,1.0,0,0.0,2013,2013.csv
12548,Red Flag,2075,2075,1.0,0,0.0,2013,2013.csv
12549,Murder Dot Com,2070,2070,1.0,0,0.0,2008,2008.csv
12550,Patagonia Rising,2064,2064,1.0,0,0.0,2012,2012.csv
12551,Some Body,2042,2042,1.0,0,0.0,2002,2002.csv
12552,Gul Makai,2035,0,0.0,2035,1.0,2020,2020.csv
12553,Choice of Weapons,2032,2032,1.0,0,0.0,2002,2002.csv
12554,The Bad and the Beautiful,2025,0,0.0,2025,1.0,2009,2009.csv
12555,Algorithms,2021,2021,1.0,0,0.0,2014,2014.csv
12556,The Tenants,2010,2010,1.0,0,0.0,2006,2006.csv
12557,Beyond Hatred,2003,949,0.4737893160259611,1054,0.5262106839740389,2007,2007.csv
12558,Enemies of Laughter,2000,2000,1.0,0,0.0,2003,2003.csv
12559,Split: A Deeper Divide,2000,2000,1.0,0,0.0,2012,2012.csv
12560,The Surfer King,1990,1990,1.0,0,0.0,2006,2006.csv
12561,The Watermelon Woman,1989,1989,1.0,0,0.0,2016,2016.csv
12562,Falling Awake,1978,1978,1.0,0,0.0,2010,2010.csv
12563,Steal Me,1967,1967,1.0,0,0.0,2005,2005.csv
12564,FAQs,1967,1967,1.0,0,0.0,2006,2006.csv
12565,The Temptation of St. Tony,1963,1963,1.0,0,0.0,2010,2010.csv
12566,Sikandar,1954,1954,1.0,0,0.0,2009,2009.csv
12567,"Accidental Courtesy: Daryl Davis, Race & America",1940,1940,1.0,0,0.0,2017,2017.csv
12568,Best Man Down,1938,1938,1.0,0,0.0,2013,2013.csv
12569,West Of The Jordan River,1926,1926,1.0,0,0.0,2018,2018.csv
12570,Shuttle,1925,1925,1.0,0,0.0,2009,2009.csv
12571,A Mother's Courage: Talking Back to Autism 2010 Re-release,1916,1916,1.0,0,0.0,2010,2010.csv
12572,Mr. Smith Gets a Hustler,1915,1915,1.0,0,0.0,2002,2002.csv
12573,Greg & Gentillon,1913,1913,1.0,0,0.0,2007,2007.csv
12574,Sneakerheadz,1903,1903,1.0,0,0.0,2015,2015.csv
12575,With God on Our Side: George W. Bush and the Rise of the Religious Right in America,1884,1884,1.0,0,0.0,2005,2005.csv
12576,We Were Here,1873,0,0.0,1873,1.0,2011,2011.csv
12577,She's One of Us 2005 Re-release,1870,1870,1.0,0,0.0,2005,2005.csv
12578,Finding Happiness,1841,1841,1.0,0,0.0,2018,2018.csv
12579,Jimi Hendrix Electric Church,1818,0,0.0,1818,1.0,2019,2019.csv
12580,Abominable,1810,1810,1.0,0,0.0,2006,2006.csv
12581,Now & Later,1808,1808,1.0,0,0.0,2011,2011.csv
12582,By Hook or by Crook,1802,1802,1.0,0,0.0,2002,2002.csv
12583,The Opera Lover,1798,1798,1.0,0,0.0,2002,2002.csv
12584,Oswald's Ghost,1796,1796,1.0,0,0.0,2007,2007.csv
12585,I Kissed a Vampire,1794,1794,1.0,0,0.0,2012,2012.csv
12586,Detour,1788,1788,1.0,0,0.0,2017,2017.csv
12587,The Canyon,1785,1785,1.0,0,0.0,2009,2009.csv
12588,Ghosted,1780,1780,1.0,0,0.0,2009,2009.csv
12589,The Lost Village,1780,1780,1.0,0,0.0,2018,2018.csv
12590,Detention of the Dead,1777,1777,1.0,0,0.0,2013,2013.csv
12591,The Other Man: F.W. de Klerk and the End of Apartheid,1747,1747,1.0,0,0.0,2015,2015.csv
12592,Dark Forest,1739,1739,1.0,0,0.0,2015,2015.csv
12593,You Don't Need Feet to Dance,1719,1719,1.0,0,0.0,2013,2013.csv
12594,Das Boot ist voll 2005 Re-release,1718,1718,1.0,0,0.0,2005,2005.csv
12595,The Road to Love,1714,1714,1.0,0,0.0,2004,2004.csv
12596,A Beautiful Now,1714,1714,1.0,0,0.0,2016,2016.csv
12597,The Looking Glass,1711,1711,1.0,0,0.0,2015,2015.csv
12598,Dystopia: 2013,1708,1708,1.0,0,0.0,2012,2012.csv
12599,Power and Terror: Noam Chomsky in Our Times 2006 Re-release,1703,1703,1.0,0,0.0,2006,2006.csv
12600,Marathon,1703,1703,1.0,0,0.0,2004,2004.csv
12601,House of Usher,1677,1677,1.0,0,0.0,2008,2008.csv
12602,More Than the Rainbow,1677,1677,1.0,0,0.0,2014,2014.csv
12603,Persons of Interest,1672,1672,1.0,0,0.0,2004,2004.csv
12604,They're Out of the Business,1655,1655,1.0,0,0.0,2011,2011.csv
12605,Headspace,1650,1650,1.0,0,0.0,2006,2006.csv
12606,Drown,1631,1631,1.0,0,0.0,2015,2015.csv
12607,Cut Snake,1625,1625,1.0,0,0.0,2015,2015.csv
12608,Game Day,1624,1624,1.0,0,0.0,2019,2019.csv
12609,Rockets Redglare!,1605,1605,1.0,0,0.0,2004,2004.csv
12610,Blindness,1602,1602,1.0,0,0.0,2003,2003.csv
12611,Forever,1598,1598,1.0,0,0.0,2015,2015.csv
12612,Miss India America,1598,1598,1.0,0,0.0,2016,2016.csv
12613,Pups,1590,1590,1.0,0,0.0,2000,2000.csv
12614,American Playhouse: The Killing Floor,1583,1583,1.0,0,0.0,2019,2019.csv
12615,Manuela and Manuel,1582,1582,1.0,0,0.0,2010,2010.csv
12616,Mama Africa,1581,1581,1.0,0,0.0,2002,2002.csv
12617,The Fox Hunter,1577,1577,1.0,0,0.0,2020,2020.csv
12618,Wash Dry and Spin Out,1570,1570,1.0,0,0.0,2003,2003.csv
12619,What Boys Like,1554,1554,1.0,0,0.0,2004,2004.csv
12620,Independent Spirits: Faith Hubley/John Hubley,1551,1551,1.0,0,0.0,2003,2003.csv
12621,The Tunnel,1532,1532,1.0,0,0.0,2011,2011.csv
12622,Rhymes for Young Ghouls,1529,1529,1.0,0,0.0,2014,2014.csv
12623,"Carmo, Hit the Road 2010 Re-release",1512,1512,1.0,0,0.0,2010,2010.csv
12624,Souldier,1500,1500,1.0,0,0.0,2014,2014.csv
12625,Blackwoods,1500,1500,1.0,0,0.0,2002,2002.csv
12626,Making Grace,1496,1496,1.0,0,0.0,2005,2005.csv
12627,Where Are You Taking Me?,1492,1492,1.0,0,0.0,2012,2012.csv
12628,Divine Intervention,1485,1485,1.0,0,0.0,2007,2007.csv
12629,Making Rounds,1484,1484,1.0,0,0.0,2015,2015.csv
12630,Heartbreak Hospital,1480,1480,1.0,0,0.0,2002,2002.csv
12631,The Letter: An American Town and the 'Somali Invasion',1479,1479,1.0,0,0.0,2005,2005.csv
12632,Unborn in the USA: Inside the War on Abortion,1475,1475,1.0,0,0.0,2007,2007.csv
12633,Henchmen,1469,1469,1.0,0,0.0,2018,2018.csv
12634,The Package,1469,1469,1.0,0,0.0,2013,2013.csv
12635,That Way Madness Lies...,1447,1447,1.0,0,0.0,2018,2018.csv
12636,The Ballad of Bering Strait,1440,1440,1.0,0,0.0,2003,2003.csv
12637,Kalyug,1435,1435,1.0,0,0.0,2005,2005.csv
12638,Monumental: David Brower's Fight for Wild America,1430,1430,1.0,0,0.0,2005,2005.csv
12639,Bestiaire,1428,1428,1.0,0,0.0,2012,2012.csv
12640,The Silence of Mark Rothko,1422,1422,1.0,0,0.0,2016,2016.csv
12641,Shwaas,1416,1416,1.0,0,0.0,2004,2004.csv
12642,The Forest for the Trees,1410,1410,1.0,0,0.0,2017,2017.csv
12643,Drool,1403,1403,1.0,0,0.0,2010,2010.csv
12644,"Love, Honor and Obey",1400,1400,1.0,0,0.0,2001,2001.csv
12645,Four Lane Highway,1393,1393,1.0,0,0.0,2007,2007.csv
12646,The Execution of Wanda Jean,1386,1386,1.0,0,0.0,2002,2002.csv
12647,Besotted,1379,1379,1.0,0,0.0,2002,2002.csv
12648,Ice Blues,1377,1377,1.0,0,0.0,2008,2008.csv
12649,Beauty and the Beholder,1368,1368,1.0,0,0.0,2018,2018.csv
12650,Along the Roadside 2015 Re-release,1352,1352,1.0,0,0.0,2015,2015.csv
12651,The Dog Problem,1344,1344,1.0,0,0.0,2007,2007.csv
12652,Return to the Land of Wonders,1338,1338,1.0,0,0.0,2005,2005.csv
12653,El Leyton,1332,1332,1.0,0,0.0,2003,2003.csv
12654,America Betrayed,1311,1311,1.0,0,0.0,2009,2009.csv
12655,Exorcism,1303,1303,1.0,0,0.0,2003,2003.csv
12656,3 Nights in the Desert,1297,1297,1.0,0,0.0,2015,2015.csv
12657,The Hours and Times,1273,1273,1.0,0,0.0,2019,2019.csv
12658,Altered Perception,1259,1259,1.0,0,0.0,2018,2018.csv
12659,The Wolf Hour,1255,0,0.0,1255,1.0,2019,2019.csv
12660,Proteus: A Nineteenth Century Vision,1246,1246,1.0,0,0.0,2005,2005.csv
12661,A Fish in the Bathtub 2019 re-release,1237,1237,1.0,0,0.0,2019,2019.csv
12662,Two Men Went to War 2018 Re-release,1227,1227,1.0,0,0.0,2018,2018.csv
12663,The Trials of Darryl Hunt,1217,1217,1.0,0,0.0,2007,2007.csv
12664,A Small Good Thing,1196,1196,1.0,0,0.0,2016,2016.csv
12665,Snowman's Land,1190,1190,1.0,0,0.0,2012,2012.csv
12666,Under the Turban,1190,1190,1.0,0,0.0,2018,2018.csv
12667,Above and Below,1189,0,0.0,1189,1.0,2016,2016.csv
12668,A Different American Dream,1172,1172,1.0,0,0.0,2017,2017.csv
12669,A Zombie Invasion,1170,1170,1.0,0,0.0,2013,2013.csv
12670,The Colour of Olives,1169,1169,1.0,0,0.0,2006,2006.csv
12671,Jack & Diane,1142,1142,1.0,0,0.0,2012,2012.csv
12672,Veer!,1132,1132,1.0,0,0.0,2013,2013.csv
12673,The Ister,1124,1124,1.0,0,0.0,2006,2006.csv
12674,Hai Tang Hong,1107,1107,1.0,0,0.0,2020,2020.csv
12675,Half Brothers,1100,1100,1.0,0,0.0,2018,2018.csv
12676,Fall of Hyperion,1093,1093,1.0,0,0.0,2008,2008.csv
12677,The Transcendents,1090,1090,1.0,0,0.0,2020,2020.csv
12678,The Empire in Africa,1088,1088,1.0,0,0.0,2006,2006.csv
12679,We Are the Giant,1088,1088,1.0,0,0.0,2014,2014.csv
12680,Kiss Me Deadly,1085,1085,1.0,0,0.0,2008,2008.csv
12681,The Butterfly Room,1081,1081,1.0,0,0.0,2014,2014.csv
12682,Childless,1036,1036,1.0,0,0.0,2015,2015.csv
12683,Invisible Hands,1034,1034,1.0,0,0.0,2018,2018.csv
12684,Absence,1031,1031,1.0,0,0.0,2013,2013.csv
12685,Remnants,1022,1022,1.0,0,0.0,2013,2013.csv
12686,Confessionsofa Ex-Doofus-ItchyFooted Mutha,1013,1013,1.0,0,0.0,2009,2009.csv
12687,How to Rob a Bank (and 10 Tips to Actually Get Away with It),1006,1006,1.0,0,0.0,2008,2008.csv
12688,The Jimmy Show,1000,1000,1.0,0,0.0,2002,2002.csv
12689,A House on a Hill,984,984,1.0,0,0.0,2003,2003.csv
12690,The Penguin Counters,976,976,1.0,0,0.0,2017,2017.csv
12691,Looking for Cheyenne,973,973,1.0,0,0.0,2007,2007.csv
12692,Strangers Online,968,968,1.0,0,0.0,2011,2011.csv
12693,The Trouble with Men and Women,967,967,1.0,0,0.0,2006,2006.csv
12694,The Last Wave 2001 Re-release,957,957,1.0,0,0.0,2001,2001.csv
12695,The Lonely Affair of the Heart,932,932,1.0,0,0.0,2002,2002.csv
12696,A People Uncounted,930,930,1.0,0,0.0,2014,2014.csv
12697,They Are We,900,900,1.0,0,0.0,2015,2015.csv
12698,How to Be a Serial Killer,899,899,1.0,0,0.0,2009,2009.csv
12699,Beat the Drum,895,0,0.0,895,1.0,2008,2008.csv
12700,In Her Line of Fire,884,884,1.0,0,0.0,2006,2006.csv
12701,Big Muddy,881,881,1.0,0,0.0,2015,2015.csv
12702,Extraordinary Ordinary People,880,880,1.0,0,0.0,2017,2017.csv
12703,800 Bullets 2004 Re-release,866,866,1.0,0,0.0,2004,2004.csv
12704,45365,853,853,1.0,0,0.0,2010,2010.csv
12705,Officer Downe,850,850,1.0,0,0.0,2016,2016.csv
12706,PTU,849,0,0.0,849,1.0,2007,2007.csv
12707,Abandoned,832,832,1.0,0,0.0,2011,2011.csv
12708,Doing Time for Patsy Cline,831,831,1.0,0,0.0,2006,2006.csv
12709,Disfigured,829,829,1.0,0,0.0,2008,2008.csv
12710,TVTV: Video Revolutionaries,812,812,1.0,0,0.0,2018,2018.csv
12711,Jackpot 2014 Re-release,806,806,1.0,0,0.0,2014,2014.csv
12712,The Untold Story,790,790,1.0,0,0.0,2019,2019.csv
12713,Issues,783,783,1.0,0,0.0,2006,2006.csv
12714,Flakes,778,778,1.0,0,0.0,2007,2007.csv
12715,Uncut,762,762,1.0,0,0.0,2006,2006.csv
12716,A New Day in Old Sana'a,737,737,1.0,0,0.0,2006,2006.csv
12717,It's All So Quiet 2015 Re-release,724,724,1.0,0,0.0,2015,2015.csv
12718,A Girl Like Grace,713,713,1.0,0,0.0,2016,2016.csv
12719,Redneck Carnage,706,706,1.0,0,0.0,2011,2011.csv
12720,The Loving Story,700,700,1.0,0,0.0,2012,2012.csv
12721,It's Hard Being Loved by Jerks 2015 Re-release,697,697,1.0,0,0.0,2015,2015.csv
12722,The Portal,685,0,0.0,685,1.0,2019,2019.csv
12723,Syrup,663,663,1.0,0,0.0,2013,2013.csv
12724,Nature Calls,646,646,1.0,0,0.0,2012,2012.csv
12725,Spooky House 2005 Re-release,637,637,1.0,0,0.0,2005,2005.csv
12726,Citizen Gangster,625,625,1.0,0,0.0,2012,2012.csv
12727,Steve + Sky,624,624,1.0,0,0.0,2005,2005.csv
12728,Anatomy 2 2004 Re-release,623,623,1.0,0,0.0,2004,2004.csv
12729,"Jesus, You Know",604,604,1.0,0,0.0,2004,2004.csv
12730,Gottfried Helnwein and the Dreaming Child,601,601,1.0,0,0.0,2012,2012.csv
12731,Shake Hands with the Devil,594,594,1.0,0,0.0,2010,2010.csv
12732,Sorority Girls' Revenge,582,582,1.0,0,0.0,2001,2001.csv
12733,The Rise and Fall of Miss Thang,581,581,1.0,0,0.0,2008,2008.csv
12734,Notes on Marie Menken,577,577,1.0,0,0.0,2007,2007.csv
12735,A Good Day to Die,573,573,1.0,0,0.0,2011,2011.csv
12736,The Pit,560,560,1.0,0,0.0,2016,2016.csv
12737,The Comedians of Comedy,549,549,1.0,0,0.0,2005,2005.csv
12738,Obscene,549,0,0.0,549,1.0,2007,2007.csv
12739,Higher Power,528,528,1.0,0,0.0,2018,2018.csv
12740,Meeting Evil,525,525,1.0,0,0.0,2012,2012.csv
12741,The 11th Hour,510,0,0.0,510,1.0,2015,2015.csv
12742,Canary,504,504,1.0,0,0.0,2008,2008.csv
12743,The Last Door,488,488,1.0,0,0.0,2007,2007.csv
12744,Tasuma,479,479,1.0,0,0.0,2004,2004.csv
12745,Triumph of the Wall,476,476,1.0,0,0.0,2013,2013.csv
12746,Rome & Jewel,470,470,1.0,0,0.0,2008,2008.csv
12747,Green is Gold,455,455,1.0,0,0.0,2016,2016.csv
12748,Serum,440,440,1.0,0,0.0,2006,2006.csv
12749,The Dark Hours,423,423,1.0,0,0.0,2005,2005.csv
12750,The Magician 2010 Re-release,406,406,1.0,0,0.0,2010,2010.csv
12751,Skinless,400,400,1.0,0,0.0,2014,2014.csv
12752,Cinemanovels,398,398,1.0,0,0.0,2014,2014.csv
12753,Inception 10th Anniversary re-release,387,0,0.0,387,1.0,2020,2020.csv
12754,Antiporno,294,0,0.0,294,1.0,2017,2017.csv
12755,Wet Woman in the Wind,268,0,0.0,268,1.0,2017,2017.csv
12756,All That Heaven Allows,170,0,0.0,170,1.0,2009,2009.csv
12757,Spaceship Earth,168,0,0.0,168,1.0,2020,2020.csv
12758,"Mummy, I'm A Zombie",120,120,1.0,0,0.0,2014,2014.csv
12759,The Objective,95,95,1.0,0,0.0,2009,2009.csv
12760,Dog Eat Dog,80,80,1.0,0,0.0,2009,2009.csv
12761,Paranoid Girls,78,78,1.0,0,0.0,2015,2015.csv
12762,Confession of a Child of the Century 2015 Re-release,74,74,1.0,0,0.0,2015,2015.csv
12763,Zyzzyx Rd,30,30,1.0,0,0.0,2006,2006.csv
